0x1382CA98, 37353940805793352, 89121842, 89121948, 106, 640x360 
0x1382CA98, 37353940806793880, 89121949, 89121956, 7, 640x360 
0x1382CA98, 37353940807648576, 89121972, 89121984, 12, 640x360 
0x1382CA98, 37353940808021456, 89121986, 89122000, 14, 640x360 
0x1382CA98, 37353940808210056, 89122014, 89122019, 5, 640x360 
0x1382CA98, 37353940808542824, 89122053, 89122066, 13, 640x360 
0x1382CA98, 37353940808842360, 89122074, 89122076, 2, 640x360 
0x1382CA98, 37353940809149024, 89122108, 89122118, 10, 640x360 
0x1382CA98, 37353940809810024, 89122160, 89122162, 2, 640x360 
0x1382CA98, 37353940810112344, 89122187, 89122195, 8, 640x360 
0x1382CA98, 37353940810439864, 89122223, 89122225, 2, 640x360 
0x1382CA98, 37353940810755256, 89122261, 89122265, 4, 640x360 
0x1382CA98, 37353940811243312, 89122299, 89122308, 9, 640x360 
0x1382CA98, 37353940811548504, 89122333, 89122341, 8, 640x360 
0x1382CA98, 37353940811868376, 89122368, 89122377, 9, 640x360 
0x1382CA98, 37353940812190720, 89122394, 89122398, 4, 640x360 
0x1382CA98, 37353940812508984, 89122437, 89122444, 7, 640x360 
0x1382CA98, 37353940812832584, 89122461, 89122464, 3, 640x360 
0x1382CA98, 37353940813153608, 89122501, 89122508, 7, 640x360 
0x1382CA98, 37353940813471360, 89122527, 89122530, 3, 640x360 
0x1382CA98, 37353940813787360, 89122561, 89122567, 6, 640x360 
0x1382CA98, 37353940814112864, 89122589, 89122595, 6, 640x360 
0x1382CA98, 37353940814429144, 89122628, 89122630, 2, 640x360 
0x1382CA98, 37353940814751272, 89122653, 89122656, 3, 640x360 
0x1382CA98, 37353940815238544, 89122697, 89122707, 10, 640x360 
0x1382CA98, 37353940815608072, 89122755, 89122760, 5, 640x360 
0x1382CA98, 37353940815876160, 89122767, 89122770, 3, 640x360 
0x1382CA98, 37353940816191864, 89122788, 89122791, 3, 640x360 
0x1382CA98, 37353940816511696, 89122836, 89122839, 3, 640x360 
0x1382CA98, 37353940816827088, 89122857, 89122859, 2, 640x360 
0x1382CA98, 37353940817147288, 89122889, 89122891, 2, 640x360 
0x1382CA98, 37353940817474008, 89122921, 89122928, 7, 640x360 
0x1382CA98, 37353940817788632, 89122952, 89122955, 3, 640x360 
0x1382CA98, 37353940818113168, 89122979, 89122985, 6, 640x360 
0x1382CA98, 37353940818428464, 89123011, 89123014, 3, 640x360 
0x1382CA98, 37353940818756912, 89123046, 89123056, 10, 640x360 
0x1382CA98, 37353940819238512, 89123105, 89123106, 1, 640x360 
0x1382CA98, 37353940819560760, 89123136, 89123138, 2, 640x360 
0x1382CA98, 37353940819879056, 89123160, 89123164, 4, 640x360 
0x1382CA98, 37353940820190104, 89123190, 89123193, 3, 640x360 
0x1382CA98, 37353940820510688, 89123226, 89123228, 2, 640x360 
0x1382CA98, 37353940820827232, 89123256, 89123258, 2, 640x360 
0x1382CA98, 37353940821153272, 89123286, 89123294, 8, 640x360 
0x1382CA98, 37353940821471144, 89123319, 89123321, 2, 640x360 
0x1382CA98, 37353940821791200, 89123352, 89123354, 2, 640x360 
0x1382CA98, 37353940822107352, 89123383, 89123391, 8, 640x360 
0x1382CA98, 37353940822434472, 89123409, 89123411, 2, 640x360 
0x1382CA98, 37353940822754496, 89123443, 89123447, 4, 640x360 
0x1382CA98, 37353940823228296, 89123499, 89123501, 2, 640x360 
0x1382CA98, 37353940823572296, 89123528, 89123535, 7, 640x360 
0x1382CA98, 37353940823868232, 89123583, 89123589, 6, 640x360 
0x1382CA98, 37353940824206040, 89123601, 89123604, 3, 640x360 
0x1382CA98, 37353940824507024, 89123640, 89123642, 2, 640x360 
0x1382CA98, 37353940824829688, 89123655, 89123659, 4, 640x360 
0x1382CA98, 37353940825147368, 89123691, 89123693, 2, 640x360 
0x1382CA98, 37353940825469280, 89123718, 89123727, 9, 640x360 
0x1382CA98, 37353940825786992, 89123757, 89123759, 2, 640x360 
0x1382CA98, 37353940826107144, 89123780, 89123791, 11, 640x360 
0x1382CA98, 37353940826427712, 89123816, 89123823, 7, 640x360 
0x1382CA98, 37353940826752920, 89123842, 89123844, 2, 640x360 
0x1382CA98, 37353940827078336, 89123875, 89123878, 3, 640x360 
0x1382CA98, 37353940827547632, 89123924, 89123926, 2, 640x360 
0x1382CA98, 37353940827872600, 89123956, 89123959, 3, 640x360 
0x1382CA98, 37353940828187584, 89123994, 89123996, 2, 640x360 
0x1382CA98, 37353940828507520, 89124023, 89124025, 2, 640x360 
0x1382CA98, 37353940828843872, 89124068, 89124071, 3, 640x360 
0x1382CA98, 37353940829147392, 89124095, 89124101, 6, 640x360 
0x1382CA98, 37353940829477296, 89124136, 89124148, 12, 640x360 
0x1382CA98, 37353940829793384, 89124167, 89124172, 5, 640x360 
0x1382CA98, 37353940830108704, 89124185, 89124188, 3, 640x360 
0x1382CA98, 37353940830427160, 89124222, 89124227, 5, 640x360 
0x1382CA98, 37353940830751936, 89124255, 89124257, 2, 640x360 
0x1382CA98, 37353940831078760, 89124277, 89124283, 6, 640x360 
0x1382CA98, 37353940831547032, 89124330, 89124338, 8, 640x360 
0x1382CA98, 37353940831866576, 89124367, 89124375, 8, 640x360 
0x1382CA98, 37353940832186624, 89124396, 89124401, 5, 640x360 
0x1382CA98, 37353940832510984, 89124433, 89124435, 2, 640x360 
0x1382CA98, 37353940832829064, 89124453, 89124456, 3, 640x360 
0x1382CA98, 37353940833149504, 89124496, 89124500, 4, 640x360 
0x1382CA98, 37353940833472272, 89124516, 89124519, 3, 640x360 
0x1382CA98, 37353940833787728, 89124555, 89124559, 4, 640x360 
0x1382CA98, 37353940834122344, 89124595, 89124601, 6, 640x360 
0x1382CA98, 37353940834444904, 89124614, 89124622, 8, 640x360 
0x1382CA98, 37353940834763984, 89124660, 89124663, 3, 640x360 
0x1382CA98, 37353940835073928, 89124699, 89124702, 3, 640x360 
0x1382CA98, 37353940835562000, 89124740, 89124742, 2, 640x360 
0x1382CA98, 37353940835871512, 89124766, 89124773, 7, 640x360 
0x1382CA98, 37353940836193888, 89124803, 89124806, 3, 640x360 
0x1382CA98, 37353940836507448, 89124826, 89124830, 4, 640x360 
0x1382CA98, 37353940836826912, 89124855, 89124858, 3, 640x360 
0x1382CA98, 37353940837155360, 89124886, 89124894, 8, 640x360 
0x1382CA98, 37353940837468016, 89124921, 89124928, 7, 640x360 
0x1382CA98, 37353940837791136, 89124955, 89124959, 4, 640x360 
0x1382CA98, 37353940838107224, 89124987, 89124991, 4, 640x360 
0x1382CA98, 37353940838431264, 89125015, 89125019, 4, 640x360 
0x1382CA98, 37353940838747080, 89125045, 89125054, 9, 640x360 
0x1382CA98, 37353940839068464, 89125076, 89125084, 8, 640x360 
0x1382CA98, 37353940839560744, 89125137, 89125139, 2, 640x360 
0x1382CA98, 37353940839866384, 89125164, 89125167, 3, 640x360 
0x1382CA98, 37353940840191248, 89125188, 89125190, 2, 640x360 
0x1382CA98, 37353940840517336, 89125220, 89125226, 6, 640x360 
0x1382CA98, 37353940840827216, 89125253, 89125258, 5, 640x360 
0x1382CA98, 37353940841147232, 89125288, 89125290, 2, 640x360 
0x1382CA98, 37353940841467232, 89125318, 89125321, 3, 640x360 
0x1382CA98, 37353940841790648, 89125350, 89125353, 3, 640x360 
0x1382CA98, 37353940842107864, 89125381, 89125388, 7, 640x360 
0x1382CA98, 37353940842427616, 89125422, 89125424, 2, 640x360 
0x1382CA98, 37353940842747248, 89125452, 89125455, 3, 640x360 
0x1382CA98, 37353940843070160, 89125485, 89125487, 2, 640x360 
0x1382CA98, 37353940843558600, 89125525, 89125530, 5, 640x360 
0x1382CA98, 37353940843866824, 89125557, 89125560, 3, 640x360 
0x1382CA98, 37353940844192264, 89125591, 89125593, 2, 640x360 
0x1382CA98, 37353940844511384, 89125622, 89125625, 3, 640x360 
0x1382CA98, 37353940844826544, 89125667, 89125670, 3, 640x360 
0x1382CA98, 37353940845147808, 89125694, 89125698, 4, 640x360 
0x1382CA98, 37353940845466584, 89125720, 89125727, 7, 640x360 
0x1382CA98, 37353940845786816, 89125752, 89125754, 2, 640x360 
0x1382CA98, 37353940846106520, 89125788, 89125790, 2, 640x360 
0x1382CA98, 37353940846427928, 89125820, 89125822, 2, 640x360 
0x1382CA98, 37353940846748792, 89125853, 89125855, 2, 640x360 
0x1382CA98, 37353940847072864, 89125877, 89125882, 5, 640x360 
0x1382CA98, 37353940847552728, 89125932, 89125935, 3, 640x360 
0x1382CA98, 37353940847867000, 89125958, 89125961, 3, 640x360 
0x1382CA98, 37353940848195136, 89125990, 89125992, 2, 640x360 
0x1382CA98, 37353940848510120, 89126022, 89126025, 3, 640x360 
0x1382CA98, 37353940848832216, 89126061, 89126065, 4, 640x360 
0x1382CA98, 37353940849146832, 89126091, 89126093, 2, 640x360 
0x1382CA98, 37353940849471464, 89126119, 89126121, 2, 640x360 
0x1382CA98, 37353940849787184, 89126145, 89126149, 4, 640x360 
0x1382CA98, 37353940850107368, 89126177, 89126181, 4, 640x360 
0x1382CA98, 37353940850427344, 89126214, 89126221, 7, 640x360 
0x1382CA98, 37353940850753704, 89126245, 89126258, 13, 640x360 
0x1382CA98, 37353940851071856, 89126283, 89126306, 23, 640x360 
0x1382CA98, 37353940851479928, 89126339, 89126343, 4, 640x360 
0x1382CA98, 37353940851868728, 89126372, 89126380, 8, 640x360 
0x1382CA98, 37353940852192272, 89126394, 89126398, 4, 640x360 
0x1382CA98, 37353940852505920, 89126421, 89126424, 3, 640x360 
0x1382CA98, 37353940852826072, 89126454, 89126460, 6, 640x360 
0x1382CA98, 37353940853149840, 89126486, 89126493, 7, 640x360 
0x1382CA98, 37353940853470248, 89126520, 89126523, 3, 640x360 
0x1382CA98, 37353940853786728, 89126555, 89126557, 2, 640x360 
0x1382CA98, 37353940854106824, 89126579, 89126585, 6, 640x360 
0x1382CA98, 37353940854431224, 89126610, 89126615, 5, 640x360 
0x1382CA98, 37353940854747416, 89126649, 89126653, 4, 640x360 
0x1382CA98, 37353940855067328, 89126678, 89126684, 6, 640x360 
0x1382CA98, 37353940855386944, 89126715, 89126720, 5, 640x360 
0x1382CA98, 37353940855870024, 89126763, 89126769, 6, 640x360 
0x1382CA98, 37353940856186688, 89126795, 89126798, 3, 640x360 
0x1382CA98, 37353940856508304, 89126833, 89126835, 2, 640x360 
0x1382CA98, 37353940856828832, 89126855, 89126856, 1, 640x360 
0x1382CA98, 37353940857149768, 89126895, 89126898, 3, 640x360 
0x1382CA98, 37353940857471448, 89126919, 89126926, 7, 640x360 
0x1382CA98, 37353940857788984, 89126951, 89126953, 2, 640x360 
0x1382CA98, 37353940858111664, 89126980, 89126985, 5, 640x360 
0x1382CA98, 37353940858427352, 89127011, 89127018, 7, 640x360 
0x1382CA98, 37353940858757624, 89127047, 89127055, 8, 640x360 
0x1382CA98, 37353940859072672, 89127074, 89127076, 2, 640x360 
0x1382CA98, 37353940859387528, 89127107, 89127109, 2, 640x360 
0x1382CA98, 37353940859871320, 89127157, 89127160, 3, 640x360 
0x1382CA98, 37353940860190160, 89127190, 89127193, 3, 640x360 
0x1382CA98, 37353940860505920, 89127221, 89127227, 6, 640x360 
0x1382CA98, 37353940860830000, 89127251, 89127259, 8, 640x360 
0x1382CA98, 37353940861146216, 89127288, 89127291, 3, 640x360 
0x1382CA98, 37353940861466744, 89127323, 89127325, 2, 640x360 
0x1382CA98, 37353940861786920, 89127355, 89127357, 2, 640x360 
0x1382CA98, 37353940862109864, 89127388, 89127398, 10, 640x360 
0x1382CA98, 37353940862438760, 89127417, 89127419, 2, 640x360 
0x1382CA98, 37353940862753064, 89127449, 89127451, 2, 640x360 
0x1382CA98, 37353940863067608, 89127485, 89127489, 4, 640x360 
0x1382CA98, 37353940863391064, 89127516, 89127520, 4, 640x360 
0x1382CA98, 37353940863870952, 89127561, 89127564, 3, 640x360 
0x1382CA98, 37353940864185960, 89127600, 89127603, 3, 640x360 
0x1382CA98, 37353940864506440, 89127622, 89127626, 4, 640x360 
0x1382CA98, 37353940864828984, 89127662, 89127667, 5, 640x360 
0x1382CA98, 37353940865147512, 89127692, 89127698, 6, 640x360 
0x1382CA98, 37353940865465808, 89127714, 89127720, 6, 640x360 
0x1382CA98, 37353940865802800, 89127762, 89127774, 12, 640x360 
0x1382CA98, 37353940866109760, 89127795, 89127801, 6, 640x360 
0x1382CA98, 37353940866430384, 89127823, 89127824, 1, 640x360 
0x1382CA98, 37353940866752456, 89127851, 89127859, 8, 640x360 
0x1382CA98, 37353940867085216, 89127885, 89127893, 8, 640x360 
0x1382CA98, 37353940867393672, 89127911, 89127914, 3, 640x360 
0x1382CA98, 37353940867865720, 89127960, 89127963, 3, 640x360 
0x1382CA98, 37353940868185560, 89127995, 89128000, 5, 640x360 
0x1382CA98, 37353940868511128, 89128022, 89128025, 3, 640x360 
0x1382CA98, 37353940868830960, 89128053, 89128056, 3, 640x360 
0x1382CA98, 37353940869146312, 89128089, 89128091, 2, 640x360 
0x1382CA98, 37353940869466352, 89128130, 89128143, 13, 640x360 
0x1382CA98, 37353940869787432, 89128166, 89128177, 11, 640x360 
0x1382CA98, 37353940870168672, 89128188, 89128198, 10, 640x360 
0x1382CA98, 37353940870437160, 89128220, 89128223, 3, 640x360 
0x1382CA98, 37353940870757968, 89128251, 89128253, 2, 640x360 
0x1382CA98, 37353940871072328, 89128277, 89128281, 4, 640x360 
0x1382CA98, 37353940871386104, 89128320, 89128327, 7, 640x360 
0x1382CA98, 37353940871865416, 89128359, 89128368, 9, 640x360 
0x1382CA98, 37353940872186088, 89128402, 89128407, 5, 640x360 
0x1382CA98, 37353940872506856, 89128434, 89128437, 3, 640x360 
0x1382CA98, 37353940872830504, 89128469, 89128477, 8, 640x360 
0x1382CA98, 37353940873149432, 89128501, 89128504, 3, 640x360 
0x1382CA98, 37353940873467120, 89128538, 89128541, 3, 640x360 
0x1382CA98, 37353940873798272, 89128566, 89128575, 9, 640x360 
0x1382CA98, 37353940874123664, 89128603, 89128610, 7, 640x360 
0x1382CA98, 37353940874456656, 89128625, 89128628, 3, 640x360 
0x1382CA98, 37353940874760448, 89128665, 89128677, 12, 640x360 
0x1382CA98, 37353940875068216, 89128694, 89128701, 7, 640x360 
0x1382CA98, 37353940875410800, 89128726, 89128728, 2, 640x360 
0x1382CA98, 37353940875870912, 89128775, 89128782, 7, 640x360 
0x1382CA98, 37353940876188752, 89128801, 89128809, 8, 640x360 
0x1382CA98, 37353940876508944, 89128832, 89128839, 7, 640x360 
0x1382CA98, 37353940876826288, 89128868, 89128871, 3, 640x360 
0x1382CA98, 37353940877149984, 89128897, 89128901, 4, 640x360 
0x1382CA98, 37353940877469408, 89128933, 89128936, 3, 640x360 
0x1382CA98, 37353940877786328, 89128957, 89128959, 2, 640x360 
0x1382CA98, 37353940878105608, 89128988, 89128993, 5, 640x360 
0x1382CA98, 37353940878438416, 89129012, 89129018, 6, 640x360 
0x1382CA98, 37353940878748616, 89129045, 89129051, 6, 640x360 
0x1382CA98, 37353940879072808, 89129079, 89129085, 6, 640x360 
0x1382CA98, 37353940879391016, 89129111, 89129115, 4, 640x360 
0x1382CA98, 37353940879713832, 89129142, 89129144, 2, 640x360 
0x1382CA98, 37353940880185432, 89129204, 89129207, 3, 640x360 
0x1382CA98, 37353940880509696, 89129237, 89129240, 3, 640x360 
0x1382CA98, 37353940880835576, 89129267, 89129271, 4, 640x360 
0x1382CA98, 37353940881155264, 89129294, 89129295, 1, 640x360 
0x1382CA98, 37353940881471424, 89129325, 89129327, 2, 640x360 
0x1382CA98, 37353940881790664, 89129352, 89129360, 8, 640x360 
0x1382CA98, 37353940882122256, 89129391, 89129393, 2, 640x360 
0x1382CA98, 37353940882453552, 89129422, 89129424, 2, 640x360 
0x1382CA98, 37353940882751592, 89129445, 89129448, 3, 640x360 
0x1382CA98, 37353940883071896, 89129485, 89129493, 8, 640x360 
0x1382CA98, 37353940883412304, 89129516, 89129524, 8, 640x360 
0x1382CA98, 37353940883705344, 89129543, 89129550, 7, 640x360 
0x1382CA98, 37353940884190400, 89129601, 89129611, 10, 640x360 
0x1382CA98, 37353940884520904, 89129636, 89129645, 9, 640x360 
0x1382CA98, 37353940884843120, 89129666, 89129676, 10, 640x360 
0x1382CA98, 37353940885163152, 89129698, 89129711, 13, 640x360 
0x1382CA98, 37353940885475296, 89129722, 89129725, 3, 640x360 
0x1382CA98, 37353940885790240, 89129757, 89129759, 2, 640x360 
0x1382CA98, 37353940886109664, 89129783, 89129794, 11, 640x360 
0x1382CA98, 37353940886437528, 89129812, 89129815, 3, 640x360 
0x1382CA98, 37353940886750104, 89129854, 89129858, 4, 640x360 
0x1382CA98, 37353940887073360, 89129886, 89129892, 6, 640x360 
0x1382CA98, 37353940887385360, 89129910, 89129913, 3, 640x360 
0x1382CA98, 37353940887705400, 89129940, 89129942, 2, 640x360 
0x1382CA98, 37353940888190448, 89130002, 89130004, 2, 640x360 
0x1382CA98, 37353940888504792, 89130024, 89130027, 3, 640x360 
0x1382CA98, 37353940888825632, 89130065, 89130075, 10, 640x360 
0x1382CA98, 37353940889150080, 89130097, 89130102, 5, 640x360 
0x1382CA98, 37353940889475360, 89130124, 89130126, 2, 640x360 
0x1382CA98, 37353940889809128, 89130160, 89130163, 3, 640x360 
0x1382CA98, 37353940890134592, 89130191, 89130195, 4, 640x360 
0x1382CA98, 37353940890427960, 89130216, 89130225, 9, 640x360 
0x1382CA98, 37353940890754576, 89130253, 89130261, 8, 640x360 
0x1382CA98, 37353940891075752, 89130289, 89130295, 6, 640x360 
0x1382CA98, 37353940891389432, 89130319, 89130322, 3, 640x360 
0x1382CA98, 37353940891709016, 89130344, 89130347, 3, 640x360 
0x1382CA98, 37353940892189256, 89130401, 89130403, 2, 640x360 
0x1382CA98, 37353940892509232, 89130426, 89130428, 2, 640x360 
0x1382CA98, 37353940892825656, 89130467, 89130469, 2, 640x360 
0x1382CA98, 37353940893150928, 89130488, 89130497, 9, 640x360 
0x1382CA98, 37353940893471408, 89130523, 89130525, 2, 640x360 
0x1382CA98, 37353940893785672, 89130566, 89130570, 4, 640x360 
0x1382CA98, 37353940894106008, 89130602, 89130604, 2, 640x360 
0x1382CA98, 37353940894436912, 89130624, 89130626, 2, 640x360 
0x1382CA98, 37353940894752184, 89130645, 89130648, 3, 640x360 
0x1382CA98, 37353940895070528, 89130677, 89130680, 3, 640x360 
0x1382CA98, 37353940895390592, 89130713, 89130725, 12, 640x360 
0x1382CA98, 37353940895753480, 89130756, 89130762, 6, 640x360 
0x1382CA98, 37353940896184784, 89130805, 89130807, 2, 640x360 
0x1382CA98, 37353940896505736, 89130826, 89130828, 2, 640x360 
0x1382CA98, 37353940896845344, 89130866, 89130875, 9, 640x360 
0x1382CA98, 37353940897166400, 89130897, 89130904, 7, 640x360 
0x1382CA98, 37353940897474784, 89130929, 89130934, 5, 640x360 
0x1382CA98, 37353940897790688, 89130960, 89130962, 2, 640x360 
0x1382CA98, 37353940898105728, 89130989, 89130999, 10, 640x360 
0x1382CA98, 37353940898430184, 89131025, 89131027, 2, 640x360 
0x1382CA98, 37353940898752936, 89131046, 89131053, 7, 640x360 
0x1382CA98, 37353940899073544, 89131077, 89131080, 3, 640x360 
0x1382CA98, 37353940899387480, 89131122, 89131126, 4, 640x360 
0x1382CA98, 37353940899740096, 89131146, 89131153, 7, 640x360 
0x1382CA98, 37353940900188416, 89131205, 89131207, 2, 640x360 
0x1382CA98, 37353940900505272, 89131227, 89131231, 4, 640x360 
0x1382CA98, 37353940900827392, 89131272, 89131276, 4, 640x360 
0x1382CA98, 37353940901147584, 89131294, 89131297, 3, 640x360 
0x1382CA98, 37353940901481976, 89131334, 89131340, 6, 640x360 
0x1382CA98, 37353940901790792, 89131361, 89131363, 2, 640x360 
0x1382CA98, 37353940902105392, 89131408, 89131416, 8, 640x360 
0x1382CA98, 37353940902441344, 89131429, 89131455, 26, 640x360 
0x1382CA98, 37353940902774296, 89131475, 89131485, 10, 640x360 
0x1382CA98, 37353940903096912, 89131491, 89131499, 8, 640x360 
0x1382CA98, 37353940903412376, 89131536, 89131552, 16, 640x360 
0x1382CA98, 37353940903710152, 89131558, 89131571, 13, 640x360 
0x1382CA98, 37353940904186216, 89131636, 89131653, 17, 640x360 
0x1382CA98, 37353940904599336, 89131656, 89131670, 14, 640x360 
0x1382CA98, 37353940904978432, 89131705, 89131709, 4, 640x360 
0x1382CA98, 37353940905345408, 89131744, 89131750, 6, 640x360 
0x1382CA98, 37353940905798880, 89131785, 89131794, 9, 640x360 
0x1382CA98, 37353940906113648, 89131806, 89131814, 8, 640x360 
0x1382CA98, 37353940906464928, 89131829, 89131835, 6, 640x360 
0x1382CA98, 37353940906751376, 89131867, 89131869, 2, 640x360 
0x1382CA98, 37353940907070464, 89131890, 89131892, 2, 640x360 
0x1382CA98, 37353940907386568, 89131918, 89131926, 8, 640x360 
0x1382CA98, 37353940907704960, 89131954, 89131958, 4, 640x360 
0x1382CA98, 37353940908025104, 89131976, 89131978, 2, 640x360 
0x1382CA98, 37353940908508344, 89132033, 89132040, 7, 640x360 
0x1382CA98, 37353940908826784, 89132064, 89132068, 4, 640x360 
0x1382CA98, 37353940909150160, 89132089, 89132096, 7, 640x360 
0x1382CA98, 37353940909470080, 89132126, 89132128, 2, 640x360 
0x1382CA98, 37353940909786184, 89132169, 89132176, 7, 640x360 
0x1382CA98, 37353940910111176, 89132200, 89132204, 4, 640x360 
0x1382CA98, 37353940910438080, 89132229, 89132252, 23, 640x360 
0x1382CA98, 37353940910779736, 89132262, 89132271, 9, 640x360 
0x1382CA98, 37353940911067584, 89132291, 89132293, 2, 640x360 
0x1382CA98, 37353940911386600, 89132328, 89132335, 7, 640x360 
0x1382CA98, 37353940911705984, 89132344, 89132348, 4, 640x360 
0x1382CA98, 37353940912024888, 89132386, 89132393, 7, 640x360 
0x1382CA98, 37353940912504008, 89132427, 89132429, 2, 640x360 
0x1382CA98, 37353940912828416, 89132460, 89132462, 2, 640x360 
0x1382CA98, 37353940913160032, 89132489, 89132495, 6, 640x360 
0x1382CA98, 37353940913470008, 89132521, 89132524, 3, 640x360 
0x1382CA98, 37353940913784504, 89132546, 89132552, 6, 640x360 
0x1382CA98, 37353940914106848, 89132587, 89132593, 6, 640x360 
0x1382CA98, 37353940914424928, 89132619, 89132625, 6, 640x360 
0x1382CA98, 37353940914750304, 89132645, 89132650, 5, 640x360 
0x1382CA98, 37353940915065696, 89132676, 89132683, 7, 640x360 
0x1382CA98, 37353940915389648, 89132716, 89132722, 6, 640x360 
0x1382CA98, 37353940915704784, 89132753, 89132755, 2, 640x360 
0x1382CA98, 37353940916025168, 89132781, 89132784, 3, 640x360 
0x1382CA98, 37353940916507344, 89132832, 89132836, 4, 640x360 
0x1382CA98, 37353940916833632, 89132856, 89132862, 6, 640x360 
0x1382CA98, 37353940917149336, 89132888, 89132891, 3, 640x360 
0x1382CA98, 37353940917474312, 89132921, 89132927, 6, 640x360 
0x1382CA98, 37353940917785680, 89132954, 89132955, 1, 640x360 
0x1382CA98, 37353940918104792, 89132988, 89132990, 2, 640x360 
0x1382CA98, 37353940918425848, 89133016, 89133019, 3, 640x360 
0x1382CA98, 37353940918745968, 89133046, 89133053, 7, 640x360 
0x1382CA98, 37353940919064624, 89133077, 89133083, 6, 640x360 
0x1382CA98, 37353940919394552, 89133116, 89133120, 4, 640x360 
0x1382CA98, 37353940919709160, 89133146, 89133152, 6, 640x360 
0x1382CA98, 37353940920029072, 89133178, 89133192, 14, 640x360 
0x1382CA98, 37353940920503936, 89133225, 89133228, 3, 640x360 
0x1382CA98, 37353940920826600, 89133257, 89133259, 2, 640x360 
0x1382CA98, 37353940921160376, 89133295, 89133302, 7, 640x360 
0x1382CA98, 37353940921464712, 89133330, 89133335, 5, 640x360 
0x1382CA98, 37353940921784808, 89133358, 89133360, 2, 640x360 
0x1382CA98, 37353940922104736, 89133389, 89133392, 3, 640x360 
0x1382CA98, 37353940922425688, 89133423, 89133426, 3, 640x360 
0x1382CA98, 37353940922744968, 89133455, 89133458, 3, 640x360 
0x1382CA98, 37353940923094032, 89133483, 89133496, 13, 640x360 
0x1382CA98, 37353940923394384, 89133521, 89133527, 6, 640x360 
0x1382CA98, 37353940923704488, 89133554, 89133556, 2, 640x360 
0x1382CA98, 37353940924024632, 89133578, 89133580, 2, 640x360 
0x1382CA98, 37353940924504296, 89133620, 89133623, 3, 640x360 
0x1382CA98, 37353940924833192, 89133667, 89133670, 3, 640x360 
0x1382CA98, 37353940925150840, 89133692, 89133695, 3, 640x360 
0x1382CA98, 37353940925466048, 89133734, 89133742, 8, 640x360 
0x1382CA98, 37353940925785248, 89133755, 89133757, 2, 640x360 
0x1382CA98, 37353940926110624, 89133781, 89133795, 14, 640x360 
0x1382CA98, 37353940926424832, 89133812, 89133823, 11, 640x360 
0x1382CA98, 37353940926753360, 89133843, 89133845, 2, 640x360 
0x1382CA98, 37353940927070584, 89133882, 89133886, 4, 640x360 
0x1382CA98, 37353940927387216, 89133913, 89133918, 5, 640x360 
0x1382CA98, 37353940927704968, 89133945, 89133947, 2, 640x360 
0x1382CA98, 37353940928025392, 89133975, 89133977, 2, 640x360 
0x1382CA98, 37353940928504768, 89134021, 89134024, 3, 640x360 
0x1382CA98, 37353940928827800, 89134057, 89134059, 2, 640x360 
0x1382CA98, 37353940929144728, 89134088, 89134091, 3, 640x360 
0x1382CA98, 37353940929464768, 89134120, 89134123, 3, 640x360 
0x1382CA98, 37353940929784008, 89134166, 89134170, 4, 640x360 
0x1382CA98, 37353940930109976, 89134184, 89134192, 8, 640x360 
0x1382CA98, 37353940930426888, 89134215, 89134223, 8, 640x360 
0x1382CA98, 37353940930744384, 89134245, 89134251, 6, 640x360 
0x1382CA98, 37353940931064872, 89134286, 89134289, 3, 640x360 
0x1382CA98, 37353940931388360, 89134312, 89134315, 3, 640x360 
0x1382CA98, 37353940931704224, 89134348, 89134353, 5, 640x360 
0x1382CA98, 37353940932027920, 89134388, 89134395, 7, 640x360 
0x1382CA98, 37353940932831232, 89134461, 89134464, 3, 640x360 
0x1382CA98, 37353940933156896, 89134488, 89134492, 4, 640x360 
0x1382CA98, 37353940933466368, 89134528, 89134530, 2, 640x360 
0x1382CA98, 37353940933785936, 89134545, 89134550, 5, 640x360 
0x1382CA98, 37353940934103904, 89134582, 89134592, 10, 640x360 
0x1382CA98, 37353940934428192, 89134618, 89134625, 7, 640x360 
0x1382CA98, 37353940934751224, 89134644, 89134647, 3, 640x360 
0x1382CA98, 37353940935069784, 89134676, 89134680, 4, 640x360 
0x1382CA98, 37353940935392168, 89134720, 89134723, 3, 640x360 
0x1382CA98, 37353940935736728, 89134745, 89134747, 2, 640x360 
0x1382CA98, 37353940936029584, 89134776, 89134778, 2, 640x360 
0x1382CA98, 37353940936348432, 89134817, 89134820, 3, 640x360 
0x1382CA98, 37353940936834664, 89134864, 89134868, 4, 640x360 
0x1382CA98, 37353940937143656, 89134889, 89134891, 2, 640x360 
0x1382CA98, 37353940937465808, 89134915, 89134922, 7, 640x360 
0x1382CA98, 37353940937784648, 89134950, 89134956, 6, 640x360 
0x1382CA98, 37353940938104504, 89134979, 89134982, 3, 640x360 
0x1382CA98, 37353940938431784, 89135017, 89135021, 4, 640x360 
0x1382CA98, 37353940938744520, 89135055, 89135057, 2, 640x360 
0x1382CA98, 37353940939069632, 89135085, 89135093, 8, 640x360 
0x1382CA98, 37353940939397688, 89135113, 89135121, 8, 640x360 
0x1382CA98, 37353940939705576, 89135145, 89135150, 5, 640x360 
0x1382CA98, 37353940940024344, 89135186, 89135188, 2, 640x360 
0x1382CA98, 37353940940347792, 89135216, 89135219, 3, 640x360 
0x1382CA98, 37353940940824856, 89135256, 89135259, 3, 640x360 
0x1382CA98, 37353940941144248, 89135294, 89135298, 4, 640x360 
0x1382CA98, 37353940941472416, 89135322, 89135325, 3, 640x360 
0x1382CA98, 37353940941783784, 89135355, 89135357, 2, 640x360 
0x1382CA98, 37353940942104816, 89135390, 89135392, 2, 640x360 
0x1382CA98, 37353940942428048, 89135413, 89135420, 7, 640x360 
0x1382CA98, 37353940942765968, 89135446, 89135452, 6, 640x360 
0x1382CA98, 37353940943074064, 89135480, 89135484, 4, 640x360 
0x1382CA98, 37353940943405232, 89135520, 89135523, 3, 640x360 
0x1382CA98, 37353940943706816, 89135545, 89135549, 4, 640x360 
0x1382CA98, 37353940944027872, 89135585, 89135588, 3, 640x360 
0x1382CA98, 37353940944348672, 89135608, 89135611, 3, 640x360 
0x1382CA98, 37353940944824176, 89135663, 89135674, 11, 640x360 
0x1382CA98, 37353940945149896, 89135689, 89135697, 8, 640x360 
0x1382CA98, 37353940945467800, 89135725, 89135731, 6, 640x360 
0x1382CA98, 37353940945784328, 89135763, 89135770, 7, 640x360 
0x1382CA98, 37353940946109896, 89135794, 89135797, 3, 640x360 
0x1382CA98, 37353940946435992, 89135814, 89135824, 10, 640x360 
0x1382CA98, 37353940946749640, 89135852, 89135854, 2, 640x360 
0x1382CA98, 37353940947071424, 89135878, 89135880, 2, 640x360 
0x1382CA98, 37353940947385200, 89135920, 89135931, 11, 640x360 
0x1382CA98, 37353940947727008, 89135943, 89135946, 3, 640x360 
0x1382CA98, 37353940948027760, 89135977, 89135980, 3, 640x360 
0x1382CA98, 37353940948348048, 89136009, 89136015, 6, 640x360 
0x1382CA98, 37353940948823672, 89136053, 89136062, 9, 640x360 
0x1382CA98, 37353940949143272, 89136084, 89136087, 3, 640x360 
0x1382CA98, 37353940949464024, 89136123, 89136125, 2, 640x360 
0x1382CA98, 37353940949783352, 89136148, 89136160, 12, 640x360 
0x1382CA98, 37353940950104280, 89136193, 89136195, 2, 640x360 
0x1382CA98, 37353940950423664, 89136228, 89136231, 3, 640x360 
0x1382CA98, 37353940950748512, 89136255, 89136257, 2, 640x360 
0x1382CA98, 37353940951072792, 89136278, 89136285, 7, 640x360 
0x1382CA98, 37353940951384688, 89136310, 89136312, 2, 640x360 
0x1382CA98, 37353940951707504, 89136346, 89136355, 9, 640x360 
0x1382CA98, 37353940952023672, 89136379, 89136390, 11, 640x360 
0x1382CA98, 37353940952347768, 89136409, 89136411, 2, 640x360 
0x1382CA98, 37353940952827368, 89136460, 89136462, 2, 640x360 
0x1382CA98, 37353940953161544, 89136489, 89136491, 2, 640x360 
0x1382CA98, 37353940953463600, 89136516, 89136520, 4, 640x360 
0x1382CA98, 37353940953794496, 89136561, 89136566, 5, 640x360 
0x1382CA98, 37353940954127328, 89136591, 89136593, 2, 640x360 
0x1382CA98, 37353940954434808, 89136623, 89136631, 8, 640x360 
0x1382CA98, 37353940954749872, 89136657, 89136661, 4, 640x360 
0x1382CA98, 37353940955074384, 89136683, 89136695, 12, 640x360 
0x1382CA98, 37353940955404352, 89136724, 89136727, 3, 640x360 
0x1382CA98, 37353940955703536, 89136748, 89136757, 9, 640x360 
0x1382CA98, 37353940956023904, 89136779, 89136785, 6, 640x360 
0x1382CA98, 37353940956344664, 89136811, 89136814, 3, 640x360 
0x1382CA98, 37353940956827280, 89136867, 89136870, 3, 640x360 
0x1382CA98, 37353940957142984, 89136895, 89136898, 3, 640x360 
0x1382CA98, 37353940957466736, 89136916, 89136919, 3, 640x360 
0x1382CA98, 37353940957783288, 89136953, 89136956, 3, 640x360 
0x1382CA98, 37353940958103632, 89136990, 89136993, 3, 640x360 
0x1382CA98, 37353940958426704, 89137024, 89137026, 2, 640x360 
0x1382CA98, 37353940958753552, 89137058, 89137060, 2, 640x360 
0x1382CA98, 37353940959072776, 89137088, 89137090, 2, 640x360 
0x1382CA98, 37353940959383824, 89137111, 89137124, 13, 640x360 
0x1382CA98, 37353940959704320, 89137149, 89137157, 8, 640x360 
0x1382CA98, 37353940960027264, 89137178, 89137181, 3, 640x360 
0x1382CA98, 37353940960346432, 89137210, 89137216, 6, 640x360 
0x1382CA98, 37353940960670032, 89137244, 89137247, 3, 640x360 
0x1382CA98, 37353940961143664, 89137297, 89137308, 11, 640x360 
0x1382CA98, 37353940961471424, 89137344, 89137353, 9, 640x360 
0x1382CA98, 37353940961796264, 89137364, 89137368, 4, 640x360 
0x1382CA98, 37353940962106344, 89137390, 89137392, 2, 640x360 
0x1382CA98, 37353940962428856, 89137419, 89137425, 6, 640x360 
0x1382CA98, 37353940962749176, 89137445, 89137449, 4, 640x360 
0x1382CA98, 37353940963070208, 89137482, 89137485, 3, 640x360 
0x1382CA98, 37353940963400272, 89137521, 89137532, 11, 640x360 
0x1382CA98, 37353940963752072, 89137554, 89137556, 2, 640x360 
0x1382CA98, 37353940964023560, 89137578, 89137580, 2, 640x360 
0x1382CA98, 37353940964356872, 89137614, 89137619, 5, 640x360 
0x1382CA98, 37353940964664088, 89137636, 89137642, 6, 640x360 
0x1382CA98, 37353940965145352, 89137685, 89137693, 8, 640x360 
0x1382CA98, 37353940965464072, 89137716, 89137720, 4, 640x360 
0x1382CA98, 37353940965785064, 89137756, 89137766, 10, 640x360 
0x1382CA98, 37353940966103720, 89137785, 89137788, 3, 640x360 
0x1382CA98, 37353940966424088, 89137811, 89137814, 3, 640x360 
0x1382CA98, 37353940966743856, 89137844, 89137847, 3, 640x360 
0x1382CA98, 37353940967064432, 89137879, 89137882, 3, 640x360 
0x1382CA98, 37353940967384024, 89137912, 89137915, 3, 640x360 
0x1382CA98, 37353940967711696, 89137939, 89137942, 3, 640x360 
0x1382CA98, 37353940968028448, 89137978, 89137980, 2, 640x360 
0x1382CA98, 37353940968349544, 89138013, 89138018, 5, 640x360 
0x1382CA98, 37353940968667784, 89138038, 89138043, 5, 640x360 
0x1382CA98, 37353940969146264, 89138090, 89138092, 2, 640x360 
0x1382CA98, 37353940969468600, 89138123, 89138125, 2, 640x360 
0x1382CA98, 37353940969783688, 89138153, 89138156, 3, 640x360 
0x1382CA98, 37353940970107664, 89138187, 89138190, 3, 640x360 
0x1382CA98, 37353940970427888, 89138214, 89138219, 5, 640x360 
0x1382CA98, 37353940970749784, 89138246, 89138251, 5, 640x360 
0x1382CA98, 37353940971067944, 89138278, 89138282, 4, 640x360 
0x1382CA98, 37353940971399232, 89138310, 89138314, 4, 640x360 
0x1382CA98, 37353940971719896, 89138341, 89138343, 2, 640x360 
0x1382CA98, 37353940972027296, 89138372, 89138375, 3, 640x360 
0x1382CA98, 37353940972348000, 89138408, 89138411, 3, 640x360 
0x1382CA98, 37353940972671016, 89138440, 89138442, 2, 640x360 
0x1382CA98, 37353940973145224, 89138487, 89138491, 4, 640x360 
0x1382CA98, 37353940973463800, 89138518, 89138521, 3, 640x360 
0x1382CA98, 37353940973783504, 89138551, 89138556, 5, 640x360 
0x1382CA98, 37353940974103440, 89138580, 89138589, 9, 640x360 
0x1382CA98, 37353940974425040, 89138611, 89138621, 10, 640x360 
0x1382CA98, 37353940974743592, 89138651, 89138654, 3, 640x360 
0x1382CA98, 37353940975064024, 89138682, 89138685, 3, 640x360 
0x1382CA98, 37353940975397736, 89138708, 89138711, 3, 640x360 
0x1382CA98, 37353940975726488, 89138744, 89138751, 7, 640x360 
0x1382CA98, 37353940976023560, 89138778, 89138784, 6, 640x360 
0x1382CA98, 37353940976347088, 89138806, 89138822, 16, 640x360 
0x1382CA98, 37353940976667488, 89138837, 89138843, 6, 640x360 
0x1382CA98, 37353940977147848, 89138904, 89138920, 16, 640x360 
0x1382CA98, 37353940977498016, 89138935, 89138940, 5, 640x360 
0x1382CA98, 37353940977785024, 89138966, 89138970, 4, 640x360 
0x1382CA98, 37353940978104528, 89138990, 89138993, 3, 640x360 
0x1382CA98, 37353940978427768, 89139022, 89139035, 13, 640x360 
0x1382CA98, 37353940978757136, 89139055, 89139069, 14, 640x360 
0x1382CA98, 37353940979088576, 89139103, 89139106, 3, 640x360 
0x1382CA98, 37353940979389280, 89139121, 89139124, 3, 640x360 
0x1382CA98, 37353940979706976, 89139146, 89139152, 6, 640x360 
0x1382CA98, 37353940980023544, 89139174, 89139177, 3, 640x360 
0x1382CA98, 37353940980343064, 89139218, 89139227, 9, 640x360 
0x1382CA98, 37353940980668904, 89139251, 89139260, 9, 640x360 
0x1382CA98, 37353940981143464, 89139294, 89139298, 4, 640x360 
0x1382CA98, 37353940981466936, 89139316, 89139319, 3, 640x360 
0x1382CA98, 37353940981790968, 89139351, 89139364, 13, 640x360 
0x1382CA98, 37353940982104624, 89139379, 89139383, 4, 640x360 
0x1382CA98, 37353940982428328, 89139421, 89139425, 4, 640x360 
0x1382CA98, 37353940982756464, 89139445, 89139452, 7, 640x360 
0x1382CA98, 37353940983066256, 89139478, 89139484, 6, 640x360 
0x1382CA98, 37353940983383608, 89139510, 89139514, 4, 640x360 
0x1382CA98, 37353940983703272, 89139543, 89139546, 3, 640x360 
0x1382CA98, 37353940984023712, 89139577, 89139579, 2, 640x360 
0x1382CA98, 37353940984343864, 89139603, 89139612, 9, 640x360 
0x1382CA98, 37353940984684024, 89139640, 89139646, 6, 640x360 
0x1382CA98, 37353940984983736, 89139673, 89139676, 3, 640x360 
0x1382CA98, 37353940985462904, 89139725, 89139727, 2, 640x360 
0x1382CA98, 37353940985782760, 89139753, 89139759, 6, 640x360 
0x1382CA98, 37353940986104920, 89139779, 89139791, 12, 640x360 
0x1382CA98, 37353940986428448, 89139811, 89139815, 4, 640x360 
0x1382CA98, 37353940986747416, 89139844, 89139848, 4, 640x360 
0x1382CA98, 37353940987069328, 89139877, 89139882, 5, 640x360 
0x1382CA98, 37353940987383168, 89139919, 89139922, 3, 640x360 
0x1382CA98, 37353940987703960, 89139953, 89139955, 2, 640x360 
0x1382CA98, 37353940988023736, 89139982, 89139986, 4, 640x360 
0x1382CA98, 37353940988343160, 89140018, 89140021, 3, 640x360 
0x1382CA98, 37353940988666904, 89140045, 89140049, 4, 640x360 
0x1382CA98, 37353940988987088, 89140073, 89140075, 2, 640x360 
0x1382CA98, 37353940989465952, 89140131, 89140137, 6, 640x360 
0x1382CA98, 37353940989785056, 89140154, 89140156, 2, 640x360 
0x1382CA98, 37353940990106608, 89140180, 89140185, 5, 640x360 
0x1382CA98, 37353940990422960, 89140213, 89140220, 7, 640x360 
0x1382CA98, 37353940990743032, 89140245, 89140248, 3, 640x360 
0x1382CA98, 37353940991066296, 89140276, 89140279, 3, 640x360 
0x1382CA98, 37353940991396344, 89140320, 89140322, 2, 640x360 
0x1382CA98, 37353940991728272, 89140342, 89140344, 2, 640x360 
0x1382CA98, 37353940992029008, 89140387, 89140405, 18, 640x360 
0x1382CA98, 37353940992346664, 89140416, 89140418, 2, 640x360 
0x1382CA98, 37353940992680056, 89140452, 89140455, 3, 640x360 
0x1382CA98, 37353940992987896, 89140474, 89140480, 6, 640x360 
0x1382CA98, 37353940993462128, 89140516, 89140527, 11, 640x360 
0x1382CA98, 37353940993782040, 89140549, 89140560, 11, 640x360 
0x1382CA98, 37353940994103672, 89140594, 89140597, 3, 640x360 
0x1382CA98, 37353940994430952, 89140627, 89140629, 2, 640x360 
0x1382CA98, 37353940994782232, 89140656, 89140659, 3, 640x360 
0x1382CA98, 37353940995073064, 89140691, 89140693, 2, 640x360 
0x1382CA98, 37353940995408736, 89140726, 89140728, 2, 640x360 
0x1382CA98, 37353940995702912, 89140757, 89140777, 20, 640x360 
0x1382CA98, 37353940996066160, 89140791, 89140793, 2, 640x360 
0x1382CA98, 37353940996343376, 89140810, 89140814, 4, 640x360 
0x1382CA98, 37353940996668544, 89140844, 89140854, 10, 640x360 
0x1382CA98, 37353940997013128, 89140879, 89140886, 7, 640x360 
0x1382CA98, 37353940997467320, 89140927, 89140928, 1, 640x360 
0x1382CA98, 37353940997782056, 89140963, 89140970, 7, 640x360 
0x1382CA98, 37353940998103416, 89140993, 89140995, 2, 640x360 
0x1382CA98, 37353940998434416, 89141023, 89141028, 5, 640x360 
0x1382CA98, 37353940998749072, 89141044, 89141050, 6, 640x360 
0x1382CA98, 37353940999078464, 89141076, 89141078, 2, 640x360 
0x1382CA98, 37353940999387424, 89141110, 89141114, 4, 640x360 
0x1382CA98, 37353940999702440, 89141155, 89141161, 6, 640x360 
0x1382CA98, 37353941000023512, 89141184, 89141186, 2, 640x360 
0x1382CA98, 37353941000342472, 89141209, 89141211, 2, 640x360 
0x1382CA98, 37353941000665880, 89141245, 89141249, 4, 640x360 
0x1382CA98, 37353941000986952, 89141268, 89141272, 4, 640x360 
0x1382CA98, 37353941001462512, 89141314, 89141321, 7, 640x360 
0x1382CA98, 37353941001787096, 89141353, 89141362, 9, 640x360 
0x1382CA98, 37353941002103800, 89141380, 89141403, 23, 640x360 
0x1382CA98, 37353941002491760, 89141426, 89141451, 25, 640x360 
0x1382CA98, 37353941002775520, 89141477, 89141480, 3, 640x360 
0x1382CA98, 37353941003117960, 89141496, 89141513, 17, 640x360 
0x1382CA98, 37353941003399064, 89141523, 89141537, 14, 640x360 
0x1382CA98, 37353941003716704, 89141553, 89141556, 3, 640x360 
0x1382CA98, 37353941004025536, 89141587, 89141590, 3, 640x360 
0x1382CA98, 37353941004343424, 89141610, 89141614, 4, 640x360 
0x1382CA98, 37353941004669952, 89141647, 89141653, 6, 640x360 
0x1382CA98, 37353941004989216, 89141695, 89141697, 2, 640x360 
0x1382CA98, 37353941005464560, 89141731, 89141750, 19, 640x360 
0x1382CA98, 37353941005782280, 89141768, 89141781, 13, 640x360 
0x1382CA98, 37353941006124824, 89141805, 89141811, 6, 640x360 
0x1382CA98, 37353941006448112, 89141826, 89141828, 2, 640x360 
0x1382CA98, 37353941006749080, 89141862, 89141869, 7, 640x360 
0x1382CA98, 37353941007067832, 89141890, 89141892, 2, 640x360 
0x1382CA98, 37353941007383872, 89141928, 89141935, 7, 640x360 
0x1382CA98, 37353941007711288, 89141947, 89141957, 10, 640x360 
0x1382CA98, 37353941008029592, 89141977, 89141982, 5, 640x360 
0x1382CA98, 37353941008343192, 89142016, 89142020, 4, 640x360 
0x1382CA98, 37353941008663520, 89142044, 89142047, 3, 640x360 
0x1382CA98, 37353941008986176, 89142086, 89142094, 8, 640x360 
0x1382CA98, 37353941009463408, 89142119, 89142122, 3, 640x360 
0x1382CA98, 37353941009782312, 89142166, 89142170, 4, 640x360 
0x1382CA98, 37353941010106080, 89142187, 89142202, 15, 640x360 
0x1382CA98, 37353941010439584, 89142223, 89142226, 3, 640x360 
0x1382CA98, 37353941010747584, 89142263, 89142265, 2, 640x360 
0x1382CA98, 37353941011063456, 89142287, 89142290, 3, 640x360 
0x1382CA98, 37353941011383368, 89142322, 89142329, 7, 640x360 
0x1382CA98, 37353941011708952, 89142350, 89142353, 3, 640x360 
0x1382CA98, 37353941012022144, 89142378, 89142383, 5, 640x360 
0x1382CA98, 37353941012342712, 89142426, 89142434, 8, 640x360 
0x1382CA98, 37353941012669800, 89142444, 89142453, 9, 640x360 
0x1382CA98, 37353941012985328, 89142484, 89142492, 8, 640x360 
0x1382CA98, 37353941013313936, 89142516, 89142518, 2, 640x360 
0x1382CA98, 37353941013782216, 89142558, 89142560, 2, 640x360 
0x1382CA98, 37353941014103184, 89142596, 89142603, 7, 640x360 
0x1382CA98, 37353941014429512, 89142623, 89142628, 5, 640x360 
0x1382CA98, 37353941014767080, 89142661, 89142663, 2, 640x360 
0x1382CA98, 37353941015074832, 89142695, 89142699, 4, 640x360 
0x1382CA98, 37353941015385120, 89142723, 89142725, 2, 640x360 
0x1382CA98, 37353941015702392, 89142751, 89142768, 17, 640x360 
0x1382CA98, 37353941016080008, 89142794, 89142802, 8, 640x360 
0x1382CA98, 37353941016349280, 89142815, 89142820, 5, 640x360 
0x1382CA98, 37353941016675688, 89142857, 89142860, 3, 640x360 
0x1382CA98, 37353941016992440, 89142879, 89142895, 16, 640x360 
0x1382CA98, 37353941017315016, 89142919, 89142928, 9, 640x360 
0x1382CA98, 37353941017786936, 89142954, 89142956, 2, 640x360 
0x1382CA98, 37353941018102808, 89142991, 89142998, 7, 640x360 
0x1382CA98, 37353941018428104, 89143028, 89143030, 2, 640x360 
0x1382CA98, 37353941018758288, 89143064, 89143070, 6, 640x360 
0x1382CA98, 37353941019065120, 89143090, 89143093, 3, 640x360 
0x1382CA98, 37353941019384792, 89143122, 89143126, 4, 640x360 
0x1382CA98, 37353941019709496, 89143155, 89143158, 3, 640x360 
0x1382CA98, 37353941020025048, 89143200, 89143203, 3, 640x360 
0x1382CA98, 37353941020346168, 89143222, 89143242, 20, 640x360 
0x1382CA98, 37353941020675784, 89143249, 89143261, 12, 640x360 
0x1382CA98, 37353941020986000, 89143285, 89143289, 4, 640x360 
0x1382CA98, 37353941021317584, 89143310, 89143314, 4, 640x360 
0x1382CA98, 37353941021786112, 89143369, 89143372, 3, 640x360 
0x1382CA98, 37353941022109152, 89143392, 89143394, 2, 640x360 
0x1382CA98, 37353941022429224, 89143428, 89143434, 6, 640x360 
0x1382CA98, 37353941022748056, 89143454, 89143456, 2, 640x360 
0x1382CA98, 37353941023061976, 89143487, 89143494, 7, 640x360 
0x1382CA98, 37353941023408936, 89143525, 89143527, 2, 640x360 
0x1382CA98, 37353941023701408, 89143552, 89143562, 10, 640x360 
0x1382CA98, 37353941024022848, 89143588, 89143591, 3, 640x360 
0x1382CA98, 37353941024341760, 89143616, 89143621, 5, 640x360 
0x1382CA98, 37353941024671656, 89143638, 89143649, 11, 640x360 
0x1382CA98, 37353941024985664, 89143669, 89143678, 9, 640x360 
0x1382CA98, 37353941025306048, 89143700, 89143703, 3, 640x360 
0x1382CA98, 37353941025804984, 89143756, 89143758, 2, 640x360 
0x1382CA98, 37353941026107960, 89143778, 89143782, 4, 640x360 
0x1382CA98, 37353941026431184, 89143820, 89143826, 6, 640x360 
0x1382CA98, 37353941026770280, 89143850, 89143859, 9, 640x360 
0x1382CA98, 37353941027068232, 89143884, 89143890, 6, 640x360 
0x1382CA98, 37353941027382360, 89143911, 89143915, 4, 640x360 
0x1382CA98, 37353941027701416, 89143951, 89143955, 4, 640x360 
0x1382CA98, 37353941028030728, 89143984, 89143986, 2, 640x360 
0x1382CA98, 37353941028341560, 89144008, 89144011, 3, 640x360 
0x1382CA98, 37353941028662072, 89144037, 89144044, 7, 640x360 
0x1382CA98, 37353941028982512, 89144069, 89144078, 9, 640x360 
0x1382CA98, 37353941029307776, 89144105, 89144108, 3, 640x360 
0x1382CA98, 37353941029782728, 89144161, 89144164, 3, 640x360 
0x1382CA98, 37353941030101480, 89144179, 89144192, 13, 640x360 
0x1382CA98, 37353941030431704, 89144212, 89144216, 4, 640x360 
0x1382CA98, 37353941030748736, 89144245, 89144257, 12, 640x360 
0x1382CA98, 37353941031069672, 89144276, 89144278, 2, 640x360 
0x1382CA98, 37353941031381784, 89144318, 89144324, 6, 640x360 
0x1382CA98, 37353941031702176, 89144348, 89144358, 10, 640x360 
0x1382CA98, 37353941032038208, 89144386, 89144389, 3, 640x360 
0x1382CA98, 37353941032346216, 89144417, 89144433, 16, 640x360 
0x1382CA98, 37353941032667808, 89144456, 89144464, 8, 640x360 
0x1382CA98, 37353941033009552, 89144477, 89144480, 3, 640x360 
0x1382CA98, 37353941033337696, 89144517, 89144525, 8, 640x360 
0x1382CA98, 37353941033786176, 89144550, 89144558, 8, 640x360 
0x1382CA98, 37353941034101280, 89144577, 89144579, 2, 640x360 
0x1382CA98, 37353941034425560, 89144627, 89144629, 2, 640x360 
0x1382CA98, 37353941034760040, 89144661, 89144667, 6, 640x360 
0x1382CA98, 37353941035065416, 89144686, 89144690, 4, 640x360 
0x1382CA98, 37353941035387192, 89144722, 89144724, 2, 640x360 
0x1382CA98, 37353941035701096, 89144747, 89144751, 4, 640x360 
0x1382CA98, 37353941036031400, 89144772, 89144774, 2, 640x360 
0x1382CA98, 37353941036350696, 89144813, 89144817, 4, 640x360 
0x1382CA98, 37353941036664752, 89144842, 89144844, 2, 640x360 
0x1382CA98, 37353941036985968, 89144876, 89144878, 2, 640x360 
0x1382CA98, 37353941037316208, 89144910, 89144912, 2, 640x360 
0x1382CA98, 37353941037781008, 89144955, 89144966, 11, 640x360 
0x1382CA98, 37353941038101832, 89145001, 89145006, 5, 640x360 
0x1382CA98, 37353941038452152, 89145024, 89145035, 11, 640x360 
0x1382CA98, 37353941038751840, 89145070, 89145077, 7, 640x360 
0x1382CA98, 37353941039075032, 89145082, 89145094, 12, 640x360 
0x1382CA98, 37353941039425832, 89145129, 89145147, 18, 640x360 
0x1382CA98, 37353941039707144, 89145158, 89145160, 2, 640x360 
0x1382CA98, 37353941040021664, 89145186, 89145188, 2, 640x360 
0x1382CA98, 37353941040341160, 89145208, 89145211, 3, 640x360 
0x1382CA98, 37353941040665312, 89145242, 89145245, 3, 640x360 
0x1382CA98, 37353941040982552, 89145279, 89145286, 7, 640x360 
0x1382CA98, 37353941041312096, 89145317, 89145321, 4, 640x360 
0x1382CA98, 37353941041627360, 89145342, 89145343, 1, 640x360 
0x1382CA98, 37353941042101336, 89145392, 89145398, 6, 640x360 
0x1382CA98, 37353941042429368, 89145430, 89145435, 5, 640x360 
0x1382CA98, 37353941042761616, 89145458, 89145461, 3, 640x360 
0x1382CA98, 37353941043081960, 89145501, 89145504, 3, 640x360 
0x1382CA98, 37353941043382648, 89145519, 89145533, 14, 640x360 
0x1382CA98, 37353941043740696, 89145555, 89145558, 3, 640x360 
0x1382CA98, 37353941044021776, 89145588, 89145602, 14, 640x360 
0x1382CA98, 37353941044360144, 89145628, 89145632, 4, 640x360 
0x1382CA98, 37353941044680080, 89145657, 89145663, 6, 640x360 
0x1382CA98, 37353941044984168, 89145681, 89145686, 5, 640x360 
0x1382CA98, 37353941045304048, 89145712, 89145714, 2, 640x360 
0x1382CA98, 37353941045624712, 89145737, 89145745, 8, 640x360 
0x1382CA98, 37353941046100552, 89145782, 89145789, 7, 640x360 
0x1382CA98, 37353941046421088, 89145815, 89145818, 3, 640x360 
0x1382CA98, 37353941046748616, 89145854, 89145856, 2, 640x360 
0x1382CA98, 37353941047065320, 89145887, 89145893, 6, 640x360 
0x1382CA98, 37353941047385360, 89145920, 89145922, 2, 640x360 
0x1382CA98, 37353941047701072, 89145947, 89145951, 4, 640x360 
0x1382CA98, 37353941048025696, 89145975, 89145978, 3, 640x360 
0x1382CA98, 37353941048341152, 89146006, 89146008, 2, 640x360 
0x1382CA98, 37353941048666632, 89146042, 89146045, 3, 640x360 
0x1382CA98, 37353941048981496, 89146084, 89146087, 3, 640x360 
0x1382CA98, 37353941049324160, 89146115, 89146123, 8, 640x360 
0x1382CA98, 37353941049625736, 89146151, 89146155, 4, 640x360 
0x1382CA98, 37353941050100632, 89146196, 89146199, 3, 640x360 
0x1382CA98, 37353941050425208, 89146229, 89146234, 5, 640x360 
0x1382CA98, 37353941050748376, 89146260, 89146262, 2, 640x360 
0x1382CA98, 37353941051065168, 89146282, 89146285, 3, 640x360 
0x1382CA98, 37353941051388112, 89146309, 89146312, 3, 640x360 
0x1382CA98, 37353941051704704, 89146340, 89146343, 3, 640x360 
0x1382CA98, 37353941052022080, 89146372, 89146374, 2, 640x360 
0x1382CA98, 37353941052341576, 89146408, 89146410, 2, 640x360 
0x1382CA98, 37353941052665784, 89146440, 89146442, 2, 640x360 
0x1382CA98, 37353941052981616, 89146470, 89146474, 4, 640x360 
0x1382CA98, 37353941053306560, 89146517, 89146520, 3, 640x360 
0x1382CA98, 37353941053627976, 89146540, 89146555, 15, 640x360 
0x1382CA98, 37353941054115552, 89146598, 89146625, 27, 640x360 
0x1382CA98, 37353941054507952, 89146638, 89146650, 12, 640x360 
0x1382CA98, 37353941054762928, 89146664, 89146677, 13, 640x360 
0x1382CA98, 37353941055064736, 89146692, 89146697, 5, 640x360 
0x1382CA98, 37353941055383608, 89146717, 89146719, 2, 640x360 
0x1382CA98, 37353941055700664, 89146744, 89146748, 4, 640x360 
0x1382CA98, 37353941056031112, 89146787, 89146790, 3, 640x360 
0x1382CA98, 37353941056342984, 89146813, 89146823, 10, 640x360 
0x1382CA98, 37353941056662032, 89146845, 89146853, 8, 640x360 
0x1382CA98, 37353941056986344, 89146876, 89146878, 2, 640x360 
0x1382CA98, 37353941057320976, 89146916, 89146928, 12, 640x360 
0x1382CA98, 37353941057621960, 89146952, 89146960, 8, 640x360 
0x1382CA98, 37353941058100352, 89146999, 89147003, 4, 640x360 
0x1382CA98, 37353941058435208, 89147019, 89147022, 3, 640x360 
0x1382CA98, 37353941058748224, 89147056, 89147068, 12, 640x360 
0x1382CA98, 37353941059062272, 89147089, 89147092, 3, 640x360 
0x1382CA98, 37353941059396784, 89147116, 89147130, 14, 640x360 
0x1382CA98, 37353941059703712, 89147156, 89147159, 3, 640x360 
0x1382CA98, 37353941060020552, 89147185, 89147188, 3, 640x360 
0x1382CA98, 37353941060340656, 89147213, 89147216, 3, 640x360 
0x1382CA98, 37353941060660808, 89147236, 89147242, 6, 640x360 
0x1382CA98, 37353941060984704, 89147275, 89147280, 5, 640x360 
0x1382CA98, 37353941061306160, 89147301, 89147304, 3, 640x360 
0x1382CA98, 37353941061623480, 89147334, 89147345, 11, 640x360 
0x1382CA98, 37353941062103816, 89147380, 89147394, 14, 640x360 
0x1382CA98, 37353941062425304, 89147412, 89147416, 4, 640x360 
0x1382CA98, 37353941062751192, 89147445, 89147449, 4, 640x360 
0x1382CA98, 37353941063076984, 89147479, 89147482, 3, 640x360 
0x1382CA98, 37353941063413528, 89147514, 89147518, 4, 640x360 
0x1382CA98, 37353941063723520, 89147546, 89147548, 2, 640x360 
0x1382CA98, 37353941064021600, 89147580, 89147582, 2, 640x360 
0x1382CA98, 37353941064341032, 89147612, 89147615, 3, 640x360 
0x1382CA98, 37353941064665688, 89147639, 89147643, 4, 640x360 
0x1382CA98, 37353941064980744, 89147671, 89147677, 6, 640x360 
0x1382CA98, 37353941065301408, 89147706, 89147708, 2, 640x360 
0x1382CA98, 37353941065621048, 89147740, 89147742, 2, 640x360 
0x1382CA98, 37353941065944720, 89147774, 89147776, 2, 640x360 
0x1382CA98, 37353941066421856, 89147812, 89147815, 3, 640x360 
0x1382CA98, 37353941066741024, 89147844, 89147848, 4, 640x360 
0x1382CA98, 37353941067075208, 89147877, 89147883, 6, 640x360 
0x1382CA98, 37353941067381792, 89147909, 89147925, 16, 640x360 
0x1382CA98, 37353941067704432, 89147951, 89147954, 3, 640x360 
0x1382CA98, 37353941068024560, 89147985, 89147988, 3, 640x360 
0x1382CA98, 37353941068344352, 89148006, 89148018, 12, 640x360 
0x1382CA98, 37353941068660488, 89148039, 89148044, 5, 640x360 
0x1382CA98, 37353941069053520, 89148089, 89148094, 5, 640x360 
0x1382CA98, 37353941069322736, 89148118, 89148123, 5, 640x360 
0x1382CA98, 37353941069636544, 89148144, 89148146, 2, 640x360 
0x1382CA98, 37353941069964016, 89148175, 89148177, 2, 640x360 
0x1382CA98, 37353941070422200, 89148214, 89148224, 10, 640x360 
0x1382CA98, 37353941070756816, 89148245, 89148249, 4, 640x360 
0x1382CA98, 37353941071065168, 89148278, 89148281, 3, 640x360 
0x1382CA98, 37353941071381664, 89148315, 89148318, 3, 640x360 
0x1382CA98, 37353941071700648, 89148346, 89148348, 2, 640x360 
0x1382CA98, 37353941072035616, 89148372, 89148374, 2, 640x360 
0x1382CA98, 37353941072346896, 89148404, 89148407, 3, 640x360 
0x1382CA98, 37353941072663168, 89148436, 89148439, 3, 640x360 
0x1382CA98, 37353941072990816, 89148472, 89148475, 3, 640x360 
0x1382CA98, 37353941073301080, 89148504, 89148511, 7, 640x360 
0x1382CA98, 37353941073621528, 89148532, 89148535, 3, 640x360 
0x1382CA98, 37353941073941792, 89148563, 89148569, 6, 640x360 
0x1382CA98, 37353941074424616, 89148616, 89148619, 3, 640x360 
0x1382CA98, 37353941074745864, 89148646, 89148649, 3, 640x360 
0x1382CA98, 37353941075061880, 89148675, 89148677, 2, 640x360 
0x1382CA98, 37353941075381688, 89148716, 89148719, 3, 640x360 
0x1382CA98, 37353941075701168, 89148742, 89148744, 2, 640x360 
0x1382CA98, 37353941076020896, 89148774, 89148776, 2, 640x360 
0x1382CA98, 37353941076341240, 89148805, 89148809, 4, 640x360 
0x1382CA98, 37353941076664248, 89148841, 89148843, 2, 640x360 
0x1382CA98, 37353941076990080, 89148873, 89148876, 3, 640x360 
0x1382CA98, 37353941077301464, 89148909, 89148912, 3, 640x360 
0x1382CA98, 37353941077625472, 89148941, 89148943, 2, 640x360 
0x1382CA98, 37353941077944216, 89148974, 89148976, 2, 640x360 
0x1382CA98, 37353941078421720, 89149013, 89149023, 10, 640x360 
0x1382CA98, 37353941078739888, 89149045, 89149048, 3, 640x360 
0x1382CA98, 37353941079060728, 89149077, 89149085, 8, 640x360 
0x1382CA98, 37353941079421264, 89149121, 89149123, 2, 640x360 
0x1382CA98, 37353941079700880, 89149163, 89149171, 8, 640x360 
0x1382CA98, 37353941080021008, 89149184, 89149200, 16, 640x360 
0x1382CA98, 37353941080353840, 89149217, 89149222, 5, 640x360 
0x1382CA98, 37353941080661184, 89149245, 89149253, 8, 640x360 
0x1382CA98, 37353941080980512, 89149273, 89149283, 10, 640x360 
0x1382CA98, 37353941081302536, 89149316, 89149319, 3, 640x360 
0x1382CA98, 37353941081620736, 89149346, 89149349, 3, 640x360 
0x1382CA98, 37353941081941352, 89149370, 89149372, 2, 640x360 
0x1382CA98, 37353941082421080, 89149413, 89149419, 6, 640x360 
0x1382CA98, 37353941082745552, 89149445, 89149448, 3, 640x360 
0x1382CA98, 37353941083067736, 89149478, 89149480, 2, 640x360 
0x1382CA98, 37353941083393400, 89149510, 89149512, 2, 640x360 
0x1382CA98, 37353941083700952, 89149540, 89149542, 2, 640x360 
0x1382CA98, 37353941084021104, 89149578, 89149582, 4, 640x360 
0x1382CA98, 37353941084340696, 89149609, 89149612, 3, 640x360 
0x1382CA98, 37353941084661800, 89149644, 89149646, 2, 640x360 
0x1382CA98, 37353941084980144, 89149672, 89149677, 5, 640x360 
0x1382CA98, 37353941085300352, 89149705, 89149715, 10, 640x360 
0x1382CA98, 37353941085623912, 89149738, 89149749, 11, 640x360 
0x1382CA98, 37353941085940560, 89149761, 89149763, 2, 640x360 
0x1382CA98, 37353941086420936, 89149812, 89149816, 4, 640x360 
0x1382CA98, 37353941086745360, 89149845, 89149848, 3, 640x360 
0x1382CA98, 37353941087069896, 89149879, 89149882, 3, 640x360 
0x1382CA98, 37353941087385528, 89149910, 89149913, 3, 640x360 
0x1382CA98, 37353941087700672, 89149939, 89149941, 2, 640x360 
0x1382CA98, 37353941088020640, 89149976, 89149979, 3, 640x360 
0x1382CA98, 37353941088347056, 89150008, 89150011, 3, 640x360 
0x1382CA98, 37353941088663816, 89150039, 89150042, 3, 640x360 
0x1382CA98, 37353941088984928, 89150072, 89150074, 2, 640x360 
0x1382CA98, 37353941089301032, 89150105, 89150112, 7, 640x360 
0x1382CA98, 37353941089630512, 89150136, 89150139, 3, 640x360 
0x1382CA98, 37353941089949168, 89150169, 89150172, 3, 640x360 
0x1382CA98, 37353941090420296, 89150214, 89150220, 6, 640x360 
0x1382CA98, 37353941090750688, 89150244, 89150247, 3, 640x360 
0x1382CA98, 37353941091062944, 89150274, 89150276, 2, 640x360 
0x1382CA98, 37353941091387448, 89150310, 89150312, 2, 640x360 
0x1382CA98, 37353941091700816, 89150344, 89150346, 2, 640x360 
0x1382CA98, 37353941092027152, 89150374, 89150377, 3, 640x360 
0x1382CA98, 37353941092347040, 89150414, 89150418, 4, 640x360 
0x1382CA98, 37353941092660576, 89150438, 89150441, 3, 640x360 
0x1382CA98, 37353941092981296, 89150476, 89150479, 3, 640x360 
0x1382CA98, 37353941093326152, 89150510, 89150512, 2, 640x360 
0x1382CA98, 37353941093628288, 89150541, 89150544, 3, 640x360 
0x1382CA98, 37353941093950624, 89150574, 89150577, 3, 640x360 
0x1382CA98, 37353941094266920, 89150604, 89150606, 2, 640x360 
0x1382CA98, 37353941094752008, 89150655, 89150657, 2, 640x360 
0x1382CA98, 37353941095060144, 89150682, 89150687, 5, 640x360 
0x1382CA98, 37353941095383600, 89150711, 89150714, 3, 640x360 
0x1382CA98, 37353941095699560, 89150744, 89150746, 2, 640x360 
0x1382CA98, 37353941096025760, 89150777, 89150779, 2, 640x360 
0x1382CA98, 37353941096350008, 89150811, 89150813, 2, 640x360 
0x1382CA98, 37353941096660632, 89150845, 89150847, 2, 640x360 
0x1382CA98, 37353941096983968, 89150877, 89150879, 2, 640x360 
0x1382CA98, 37353941097300032, 89150908, 89150910, 2, 640x360 
0x1382CA98, 37353941097620672, 89150945, 89150947, 2, 640x360 
0x1382CA98, 37353941097940600, 89150974, 89150976, 2, 640x360 
0x1382CA98, 37353941098260168, 89151005, 89151008, 3, 640x360 
0x1382CA98, 37353941098739536, 89151051, 89151053, 2, 640x360 
0x1382CA98, 37353941099067016, 89151081, 89151089, 8, 640x360 
0x1382CA98, 37353941099392472, 89151115, 89151121, 6, 640x360 
0x1382CA98, 37353941099703176, 89151146, 89151150, 4, 640x360 
0x1382CA98, 37353941100027776, 89151176, 89151179, 3, 640x360 
0x1382CA98, 37353941100342232, 89151214, 89151219, 5, 640x360 
0x1382CA98, 37353941100668344, 89151247, 89151261, 14, 640x360 
0x1382CA98, 37353941101013272, 89151285, 89151294, 9, 640x360 
0x1382CA98, 37353941101299800, 89151317, 89151320, 3, 640x360 
0x1382CA98, 37353941101626328, 89151345, 89151348, 3, 640x360 
0x1382CA98, 37353941101946456, 89151379, 89151394, 15, 640x360 
0x1382CA98, 37353941102276304, 89151407, 89151411, 4, 640x360 
0x1382CA98, 37353941102745392, 89151471, 89151474, 3, 640x360 
0x1382CA98, 37353941103114832, 89151491, 89151494, 3, 640x360 
0x1382CA98, 37353941103416696, 89151543, 89151553, 10, 640x360 
0x1382CA98, 37353941103708760, 89151558, 89151593, 35, 640x360 
0x1382CA98, 37353941104109152, 89151601, 89151616, 15, 640x360 
0x1382CA98, 37353941104354168, 89151624, 89151644, 20, 640x360 
0x1382CA98, 37353941104693288, 89151669, 89151679, 10, 640x360 
0x1382CA98, 37353941104984776, 89151680, 89151697, 17, 640x360 
0x1382CA98, 37353941105354744, 89151734, 89151753, 19, 640x360 
0x1382CA98, 37353941105630104, 89151753, 89151775, 22, 640x360 
0x1382CA98, 37353941105953200, 89151806, 89151816, 10, 640x360 
0x1382CA98, 37353941106344792, 89151829, 89151839, 10, 640x360 
0x1382CA98, 37353941106773360, 89151865, 89151880, 15, 640x360 
0x1382CA98, 37353941107116064, 89151914, 89151932, 18, 640x360 
0x1382CA98, 37353941107486712, 89151994, 89152034, 40, 640x360 
0x1382CA98, 37353941108339640, 89152034, 89152044, 10, 640x360 
0x1382CA98, 37353941108699416, 89152082, 89152093, 11, 640x360 
0x1382CA98, 37353941109181608, 89152114, 89152138, 24, 640x360 
0x1382CA98, 37353941109443512, 89152162, 89152194, 32, 640x360 
0x1382CA98, 37353941109878152, 89152194, 89152212, 18, 640x360 
0x1382CA98, 37353941110122432, 89152228, 89152236, 8, 640x360 
0x1382CA98, 37353941110539736, 89152280, 89152413, 133, 640x360 
0x1382CA98, 37353941110965432, 89152413, 89152419, 6, 640x360 
0x1382CA98, 37353941112365008, 89152437, 89152442, 5, 640x360 
0x1382CA98, 37353941112660048, 89152450, 89152462, 12, 640x360 
0x1382CA98, 37353941113014768, 89152494, 89152500, 6, 640x360 
0x1382CA98, 37353941113301896, 89152511, 89152512, 1, 640x360 
0x1382CA98, 37353941113628992, 89152551, 89152560, 9, 640x360 
0x1382CA98, 37353941113951848, 89152581, 89152588, 7, 640x360 
0x1382CA98, 37353941114274736, 89152610, 89152612, 2, 640x360 
0x1382CA98, 37353941114751960, 89152660, 89152663, 3, 640x360 
0x1382CA98, 37353941115060576, 89152689, 89152692, 3, 640x360 
0x1382CA98, 37353941115383464, 89152722, 89152724, 2, 640x360 
0x1382CA98, 37353941115704112, 89152755, 89152757, 2, 640x360 
0x1382CA98, 37353941116019400, 89152787, 89152790, 3, 640x360 
0x1382CA98, 37353941116343240, 89152817, 89152823, 6, 640x360 
0x1382CA98, 37353941116669384, 89152852, 89152855, 3, 640x360 
0x1382CA98, 37353941116979224, 89152885, 89152887, 2, 640x360 
0x1382CA98, 37353941117304184, 89152911, 89152919, 8, 640x360 
0x1382CA98, 37353941117619272, 89152938, 89152941, 3, 640x360 
0x1382CA98, 37353941117939232, 89152979, 89152988, 9, 640x360 
0x1382CA98, 37353941118276632, 89153006, 89153009, 3, 640x360 
0x1382CA98, 37353941118743912, 89153051, 89153062, 11, 640x360 
0x1382CA98, 37353941119061032, 89153091, 89153094, 3, 640x360 
0x1382CA98, 37353941119414928, 89153127, 89153134, 7, 640x360 
0x1382CA98, 37353941119699408, 89153146, 89153155, 9, 640x360 
0x1382CA98, 37353941120036128, 89153178, 89153181, 3, 640x360 
0x1382CA98, 37353941120344512, 89153218, 89153226, 8, 640x360 
0x1382CA98, 37353941120675456, 89153263, 89153268, 5, 640x360 
0x1382CA98, 37353941120988088, 89153275, 89153278, 3, 640x360 
0x1382CA98, 37353941121303992, 89153309, 89153311, 2, 640x360 
0x1382CA98, 37353941121628528, 89153346, 89153359, 13, 640x360 
0x1382CA98, 37353941121945000, 89153374, 89153381, 7, 640x360 
0x1382CA98, 37353941122281816, 89153409, 89153412, 3, 640x360 
0x1382CA98, 37353941122607696, 89153467, 89153470, 3, 640x360 
0x1382CA98, 37353941123066160, 89153490, 89153496, 6, 640x360 
0x1382CA98, 37353941123392232, 89153536, 89153542, 6, 640x360 
0x1382CA98, 37353941123704128, 89153548, 89153556, 8, 640x360 
0x1382CA98, 37353941124106416, 89153604, 89153608, 4, 640x360 
0x1382CA98, 37353941124400296, 89153623, 89153627, 4, 640x360 
0x1382CA98, 37353941124661848, 89153655, 89153672, 17, 640x360 
0x1382CA98, 37353941125032304, 89153701, 89153709, 8, 640x360 
0x1382CA98, 37353941125305864, 89153724, 89153729, 5, 640x360 
0x1382CA98, 37353941125626072, 89153754, 89153757, 3, 640x360 
0x1382CA98, 37353941125944712, 89153776, 89153779, 3, 640x360 
0x1382CA98, 37353941126285712, 89153816, 89153824, 8, 640x360 
0x1382CA98, 37353941126604960, 89153840, 89153846, 6, 640x360 
0x1382CA98, 37353941127073168, 89153878, 89153882, 4, 640x360 
0x1382CA98, 37353941127379096, 89153920, 89153925, 5, 640x360 
0x1382CA98, 37353941127703592, 89153944, 89153948, 4, 640x360 
0x1382CA98, 37353941128022720, 89153985, 89153987, 2, 640x360 
0x1382CA98, 37353941128370384, 89154016, 89154022, 6, 640x360 
0x1382CA98, 37353941128684056, 89154045, 89154055, 10, 640x360 
0x1382CA98, 37353941128984248, 89154076, 89154084, 8, 640x360 
0x1382CA98, 37353941129300568, 89154116, 89154126, 10, 640x360 
0x1382CA98, 37353941129624024, 89154146, 89154150, 4, 640x360 
0x1382CA98, 37353941129940840, 89154188, 89154194, 6, 640x360 
0x1382CA98, 37353941130260952, 89154205, 89154207, 2, 640x360 
0x1382CA98, 37353941130583232, 89154242, 89154244, 2, 640x360 
0x1382CA98, 37353941131068616, 89154304, 89154307, 3, 640x360 
0x1382CA98, 37353941131447504, 89154321, 89154332, 11, 640x360 
0x1382CA98, 37353941131705776, 89154348, 89154353, 5, 640x360 
0x1382CA98, 37353941132027632, 89154385, 89154388, 3, 640x360 
0x1382CA98, 37353941132340704, 89154410, 89154413, 3, 640x360 
0x1382CA98, 37353941132674232, 89154453, 89154456, 3, 640x360 
0x1382CA98, 37353941132980976, 89154478, 89154481, 3, 640x360 
0x1382CA98, 37353941133303656, 89154518, 89154521, 3, 640x360 
0x1382CA98, 37353941133622688, 89154539, 89154549, 10, 640x360 
0x1382CA98, 37353941133967496, 89154575, 89154583, 8, 640x360 
0x1382CA98, 37353941134278776, 89154620, 89154629, 9, 640x360 
0x1382CA98, 37353941134586656, 89154643, 89154647, 4, 640x360 
0x1382CA98, 37353941135059328, 89154689, 89154691, 2, 640x360 
0x1382CA98, 37353941135386264, 89154722, 89154731, 9, 640x360 
0x1382CA98, 37353941135707656, 89154748, 89154752, 4, 640x360 
0x1382CA98, 37353941136023008, 89154787, 89154790, 3, 640x360 
0x1382CA98, 37353941136339776, 89154812, 89154815, 3, 640x360 
0x1382CA98, 37353941136660168, 89154847, 89154852, 5, 640x360 
0x1382CA98, 37353941136981000, 89154877, 89154879, 2, 640x360 
0x1382CA98, 37353941137299440, 89154910, 89154912, 2, 640x360 
0x1382CA98, 37353941137625864, 89154940, 89154943, 3, 640x360 
0x1382CA98, 37353941137941624, 89154981, 89154986, 5, 640x360 
0x1382CA98, 37353941138259424, 89155014, 89155021, 7, 640x360 
0x1382CA98, 37353941138607392, 89155036, 89155045, 9, 640x360 
0x1382CA98, 37353941139080864, 89155101, 89155109, 8, 640x360 
0x1382CA98, 37353941139378200, 89155124, 89155136, 12, 640x360 
0x1382CA98, 37353941139754616, 89155162, 89155168, 6, 640x360 
0x1382CA98, 37353941140018344, 89155180, 89155194, 14, 640x360 
0x1382CA98, 37353941140355072, 89155222, 89155226, 4, 640x360 
0x1382CA98, 37353941140677744, 89155267, 89155271, 4, 640x360 
0x1382CA98, 37353941140984464, 89155286, 89155290, 4, 640x360 
0x1382CA98, 37353941141300304, 89155331, 89155337, 6, 640x360 
0x1382CA98, 37353941141639944, 89155345, 89155370, 25, 640x360 
0x1382CA98, 37353941141968248, 89155402, 89155405, 3, 640x360 
0x1382CA98, 37353941142284704, 89155429, 89155439, 10, 640x360 
0x1382CA98, 37353941142654208, 89155452, 89155465, 13, 640x360 
0x1382CA98, 37353941143063176, 89155485, 89155488, 3, 640x360 
0x1382CA98, 37353941143378976, 89155524, 89155526, 2, 640x360 
0x1382CA98, 37353941143699664, 89155559, 89155568, 9, 640x360 
0x1382CA98, 37353941144025736, 89155600, 89155604, 4, 640x360 
0x1382CA98, 37353941144438232, 89155634, 89155639, 5, 640x360 
0x1382CA98, 37353941144702664, 89155671, 89155681, 10, 640x360 
0x1382CA98, 37353941144997120, 89155693, 89155703, 10, 640x360 
0x1382CA98, 37353941145303624, 89155723, 89155734, 11, 640x360 
0x1382CA98, 37353941145632280, 89155758, 89155769, 11, 640x360 
0x1382CA98, 37353941145951032, 89155774, 89155777, 3, 640x360 
0x1382CA98, 37353941146273664, 89155807, 89155822, 15, 640x360 
0x1382CA98, 37353941146618008, 89155838, 89155842, 4, 640x360 
0x1382CA98, 37353941147059376, 89155893, 89155895, 2, 640x360 
0x1382CA98, 37353941147378664, 89155923, 89155926, 3, 640x360 
0x1382CA98, 37353941147702376, 89155961, 89155968, 7, 640x360 
0x1382CA98, 37353941148041968, 89155995, 89156001, 6, 640x360 
0x1382CA98, 37353941148340456, 89156021, 89156023, 2, 640x360 
0x1382CA98, 37353941148658552, 89156052, 89156055, 3, 640x360 
0x1382CA98, 37353941148983664, 89156078, 89156090, 12, 640x360 
0x1382CA98, 37353941149305392, 89156105, 89156108, 3, 640x360 
0x1382CA98, 37353941149635504, 89156143, 89156145, 2, 640x360 
0x1382CA98, 37353941149954952, 89156186, 89156194, 8, 640x360 
0x1382CA98, 37353941150294600, 89156218, 89156221, 3, 640x360 
0x1382CA98, 37353941150590568, 89156239, 89156245, 6, 640x360 
0x1382CA98, 37353941150942912, 89156268, 89156272, 4, 640x360 
0x1382CA98, 37353941151382304, 89156317, 89156324, 7, 640x360 
0x1382CA98, 37353941151698304, 89156354, 89156357, 3, 640x360 
0x1382CA98, 37353941152018080, 89156397, 89156402, 5, 640x360 
0x1382CA98, 37353941152346088, 89156425, 89156431, 6, 640x360 
0x1382CA98, 37353941152658136, 89156443, 89156447, 4, 640x360 
0x1382CA98, 37353941152986632, 89156489, 89156496, 7, 640x360 
0x1382CA98, 37353941153298736, 89156510, 89156519, 9, 640x360 
0x1382CA98, 37353941153619840, 89156537, 89156550, 13, 640x360 
0x1382CA98, 37353941153957072, 89156573, 89156576, 3, 640x360 
0x1382CA98, 37353941154275048, 89156610, 89156621, 11, 640x360 
0x1382CA98, 37353941154619976, 89156643, 89156645, 2, 640x360 
0x1382CA98, 37353941154931680, 89156683, 89156687, 4, 640x360 
0x1382CA98, 37353941155381480, 89156713, 89156721, 8, 640x360 
0x1382CA98, 37353941155700976, 89156767, 89156779, 12, 640x360 
0x1382CA98, 37353941156019296, 89156789, 89156792, 3, 640x360 
0x1382CA98, 37353941156343728, 89156816, 89156827, 11, 640x360 
0x1382CA98, 37353941156673064, 89156848, 89156857, 9, 640x360 
0x1382CA98, 37353941156979000, 89156874, 89156879, 5, 640x360 
0x1382CA98, 37353941157298120, 89156911, 89156914, 3, 640x360 
0x1382CA98, 37353941157627008, 89156949, 89156954, 5, 640x360 
0x1382CA98, 37353941157945624, 89156975, 89156977, 2, 640x360 
0x1382CA98, 37353941158310872, 89157012, 89157020, 8, 640x360 
0x1382CA98, 37353941158583648, 89157055, 89157060, 5, 640x360 
0x1382CA98, 37353941158926288, 89157074, 89157081, 7, 640x360 
0x1382CA98, 37353941159382344, 89157116, 89157126, 10, 640x360 
0x1382CA98, 37353941159699144, 89157152, 89157156, 4, 640x360 
0x1382CA98, 37353941160018040, 89157186, 89157194, 8, 640x360 
0x1382CA98, 37353941160341112, 89157223, 89157234, 11, 640x360 
0x1382CA98, 37353941160660888, 89157259, 89157262, 3, 640x360 
0x1382CA98, 37353941160980192, 89157305, 89157309, 4, 640x360 
0x1382CA98, 37353941161302968, 89157310, 89157314, 4, 640x360 
0x1382CA98, 37353941161624352, 89157346, 89157353, 7, 640x360 
0x1382CA98, 37353941161943656, 89157386, 89157390, 4, 640x360 
0x1382CA98, 37353941162267536, 89157430, 89157444, 14, 640x360 
0x1382CA98, 37353941162591976, 89157445, 89157461, 16, 640x360 
0x1382CA98, 37353941162926472, 89157479, 89157483, 4, 640x360 
0x1382CA98, 37353941163377424, 89157514, 89157521, 7, 640x360 
0x1382CA98, 37353941163697960, 89157545, 89157550, 5, 640x360 
0x1382CA98, 37353941164028344, 89157580, 89157586, 6, 640x360 
0x1382CA98, 37353941164342760, 89157613, 89157618, 5, 640x360 
0x1382CA98, 37353941164663312, 89157645, 89157648, 3, 640x360 
0x1382CA98, 37353941164981976, 89157691, 89157693, 2, 640x360 
0x1382CA98, 37353941165298784, 89157730, 89157735, 5, 640x360 
0x1382CA98, 37353941165624976, 89157751, 89157760, 9, 640x360 
0x1382CA98, 37353941165950616, 89157783, 89157794, 11, 640x360 
0x1382CA98, 37353941166264696, 89157816, 89157827, 11, 640x360 
0x1382CA98, 37353941166588056, 89157839, 89157842, 3, 640x360 
0x1382CA98, 37353941166901376, 89157872, 89157886, 14, 640x360 
0x1382CA98, 37353941167382232, 89157909, 89157912, 3, 640x360 
0x1382CA98, 37353941167697744, 89157946, 89157956, 10, 640x360 
0x1382CA98, 37353941168017800, 89157995, 89158008, 13, 640x360 
0x1382CA98, 37353941168338648, 89158018, 89158028, 10, 640x360 
0x1382CA98, 37353941168663000, 89158054, 89158057, 3, 640x360 
0x1382CA98, 37353941168979024, 89158085, 89158087, 2, 640x360 
0x1382CA98, 37353941169301024, 89158110, 89158112, 2, 640x360 
0x1382CA98, 37353941169618216, 89158144, 89158146, 2, 640x360 
0x1382CA98, 37353941169948184, 89158174, 89158176, 2, 640x360 
0x1382CA98, 37353941170260872, 89158199, 89158204, 5, 640x360 
0x1382CA98, 37353941170578656, 89158239, 89158244, 5, 640x360 
0x1382CA98, 37353941170922776, 89158277, 89158280, 3, 640x360 
0x1382CA98, 37353941171382288, 89158316, 89158321, 5, 640x360 
0x1382CA98, 37353941171697696, 89158342, 89158349, 7, 640x360 
0x1382CA98, 37353941172031440, 89158398, 89158402, 4, 640x360 
0x1382CA98, 37353941172347536, 89158424, 89158437, 13, 640x360 
0x1382CA98, 37353941172681528, 89158476, 89158479, 3, 640x360 
0x1382CA98, 37353941173014008, 89158479, 89158482, 3, 640x360 
0x1382CA98, 37353941173300512, 89158512, 89158519, 7, 640x360 
0x1382CA98, 37353941173619184, 89158543, 89158554, 11, 640x360 
0x1382CA98, 37353941173954792, 89158580, 89158585, 5, 640x360 
0x1382CA98, 37353941174259976, 89158612, 89158618, 6, 640x360 
0x1382CA98, 37353941174605616, 89158641, 89158645, 4, 640x360 
0x1382CA98, 37353941174923464, 89158675, 89158677, 2, 640x360 
0x1382CA98, 37353941175219184, 89158710, 89158715, 5, 640x360 
0x1382CA98, 37353941175711504, 89158751, 89158757, 6, 640x360 
0x1382CA98, 37353941176029136, 89158781, 89158800, 19, 640x360 
0x1382CA98, 37353941176344048, 89158814, 89158817, 3, 640x360 
0x1382CA98, 37353941176660712, 89158853, 89158869, 16, 640x360 
0x1382CA98, 37353941176980768, 89158878, 89158882, 4, 640x360 
0x1382CA98, 37353941177303840, 89158916, 89158921, 5, 640x360 
0x1382CA98, 37353941177618240, 89158945, 89158949, 4, 640x360 
0x1382CA98, 37353941177943488, 89158982, 89158989, 7, 640x360 
0x1382CA98, 37353941178284912, 89159012, 89159020, 8, 640x360 
0x1382CA98, 37353941178605816, 89159033, 89159038, 5, 640x360 
0x1382CA98, 37353941178908176, 89159075, 89159085, 10, 640x360 
0x1382CA98, 37353941179227568, 89159104, 89159107, 3, 640x360 
0x1382CA98, 37353941179699648, 89159147, 89159154, 7, 640x360 
0x1382CA98, 37353941180021688, 89159185, 89159191, 6, 640x360 
0x1382CA98, 37353941180338936, 89159211, 89159213, 2, 640x360 
0x1382CA98, 37353941180657416, 89159238, 89159245, 7, 640x360 
0x1382CA98, 37353941180977288, 89159286, 89159288, 2, 640x360 
0x1382CA98, 37353941181297936, 89159307, 89159310, 3, 640x360 
0x1382CA98, 37353941181621136, 89159350, 89159355, 5, 640x360 
0x1382CA98, 37353941181944440, 89159378, 89159380, 2, 640x360 
0x1382CA98, 37353941182262448, 89159421, 89159423, 2, 640x360 
0x1382CA98, 37353941182588624, 89159441, 89159444, 3, 640x360 
0x1382CA98, 37353941182919152, 89159473, 89159475, 2, 640x360 
0x1382CA98, 37353941183222784, 89159498, 89159504, 6, 640x360 
0x1382CA98, 37353941183701424, 89159545, 89159548, 3, 640x360 
0x1382CA98, 37353941184022136, 89159575, 89159578, 3, 640x360 
0x1382CA98, 37353941184337296, 89159606, 89159608, 2, 640x360 
0x1382CA98, 37353941184657776, 89159638, 89159646, 8, 640x360 
0x1382CA98, 37353941184983232, 89159678, 89159681, 3, 640x360 
0x1382CA98, 37353941185311096, 89159716, 89159724, 8, 640x360 
0x1382CA98, 37353941185629728, 89159745, 89159756, 11, 640x360 
0x1382CA98, 37353941185959472, 89159789, 89159792, 3, 640x360 
0x1382CA98, 37353941186296888, 89159816, 89159826, 10, 640x360 
0x1382CA98, 37353941186606432, 89159852, 89159856, 4, 640x360 
0x1382CA98, 37353941186905712, 89159871, 89159877, 6, 640x360 
0x1382CA98, 37353941187270864, 89159909, 89159912, 3, 640x360 
0x1382CA98, 37353941187703544, 89159956, 89159966, 10, 640x360 
0x1382CA98, 37353941188030552, 89159994, 89160005, 11, 640x360 
0x1382CA98, 37353941188337720, 89160026, 89160037, 11, 640x360 
0x1382CA98, 37353941188664040, 89160050, 89160064, 14, 640x360 
0x1382CA98, 37353941189032728, 89160101, 89160109, 8, 640x360 
0x1382CA98, 37353941189319504, 89160138, 89160150, 12, 640x360 
0x1382CA98, 37353941189688816, 89160174, 89160178, 4, 640x360 
0x1382CA98, 37353941189962752, 89160179, 89160195, 16, 640x360 
0x1382CA98, 37353941190304128, 89160215, 89160222, 7, 640x360 
0x1382CA98, 37353941190597472, 89160239, 89160241, 2, 640x360 
0x1382CA98, 37353941190924864, 89160285, 89160288, 3, 640x360 
0x1382CA98, 37353941191222424, 89160307, 89160318, 11, 640x360 
0x1382CA98, 37353941191696856, 89160344, 89160351, 7, 640x360 
0x1382CA98, 37353941192030416, 89160383, 89160390, 7, 640x360 
0x1382CA98, 37353941192341424, 89160416, 89160419, 3, 640x360 
0x1382CA98, 37353941192662928, 89160443, 89160445, 2, 640x360 
0x1382CA98, 37353941192980704, 89160474, 89160475, 1, 640x360 
0x1382CA98, 37353941193296944, 89160505, 89160507, 2, 640x360 
0x1382CA98, 37353941193621056, 89160535, 89160538, 3, 640x360 
0x1382CA98, 37353941193937128, 89160566, 89160569, 3, 640x360 
0x1382CA98, 37353941194261176, 89160596, 89160600, 4, 640x360 
0x1382CA98, 37353941194577344, 89160637, 89160640, 3, 640x360 
0x1382CA98, 37353941194898248, 89160674, 89160676, 2, 640x360 
0x1382CA98, 37353941195224208, 89160701, 89160704, 3, 640x360 
0x1382CA98, 37353941195696512, 89160754, 89160757, 3, 640x360 
0x1382CA98, 37353941196021640, 89160788, 89160791, 3, 640x360 
0x1382CA98, 37353941196337192, 89160819, 89160822, 3, 640x360 
0x1382CA98, 37353941196657736, 89160851, 89160853, 2, 640x360 
0x1382CA98, 37353941196977200, 89160881, 89160885, 4, 640x360 
0x1382CA98, 37353941197298704, 89160906, 89160908, 2, 640x360 
0x1382CA98, 37353941197618968, 89160941, 89160944, 3, 640x360 
0x1382CA98, 37353941197938544, 89160977, 89160980, 3, 640x360 
0x1382CA98, 37353941198271936, 89161009, 89161012, 3, 640x360 
0x1382CA98, 37353941198605192, 89161054, 89161057, 3, 640x360 
0x1382CA98, 37353941198925224, 89161079, 89161088, 9, 640x360 
0x1382CA98, 37353941199243416, 89161114, 89161121, 7, 640x360 
0x1382CA98, 37353941199697424, 89161157, 89161162, 5, 640x360 
0x1382CA98, 37353941200025400, 89161192, 89161194, 2, 640x360 
0x1382CA98, 37353941200339728, 89161217, 89161227, 10, 640x360 
0x1382CA98, 37353941200662208, 89161256, 89161259, 3, 640x360 
0x1382CA98, 37353941200984920, 89161277, 89161280, 3, 640x360 
0x1382CA98, 37353941201300904, 89161304, 89161307, 3, 640x360 
0x1382CA98, 37353941201616872, 89161338, 89161341, 3, 640x360 
0x1382CA98, 37353941201938872, 89161372, 89161374, 2, 640x360 
0x1382CA98, 37353941202266344, 89161406, 89161408, 2, 640x360 
0x1382CA98, 37353941202594480, 89161438, 89161440, 2, 640x360 
0x1382CA98, 37353941202901840, 89161474, 89161476, 2, 640x360 
0x1382CA98, 37353941203224896, 89161506, 89161518, 12, 640x360 
0x1382CA98, 37353941203542312, 89161533, 89161537, 4, 640x360 
0x1382CA98, 37353941204021240, 89161579, 89161581, 2, 640x360 
0x1382CA98, 37353941204353216, 89161610, 89161612, 2, 640x360 
0x1382CA98, 37353941204656616, 89161642, 89161644, 2, 640x360 
0x1382CA98, 37353941204976648, 89161679, 89161682, 3, 640x360 
0x1382CA98, 37353941205328984, 89161706, 89161709, 3, 640x360 
0x1382CA98, 37353941205624056, 89161739, 89161742, 3, 640x360 
0x1382CA98, 37353941205942424, 89161774, 89161776, 2, 640x360 
0x1382CA98, 37353941206258664, 89161806, 89161808, 2, 640x360 
0x1382CA98, 37353941206577176, 89161836, 89161838, 2, 640x360 
0x1382CA98, 37353941206907168, 89161873, 89161875, 2, 640x360 
0x1382CA98, 37353941207217800, 89161903, 89161905, 2, 640x360 
0x1382CA98, 37353941207542440, 89161927, 89161931, 4, 640x360 
0x1382CA98, 37353941208021104, 89161979, 89161983, 4, 640x360 
0x1382CA98, 37353941208341552, 89162018, 89162021, 3, 640x360 
0x1382CA98, 37353941208673232, 89162050, 89162053, 3, 640x360 
0x1382CA98, 37353941208981112, 89162073, 89162075, 2, 640x360 
0x1382CA98, 37353941209297112, 89162105, 89162108, 3, 640x360 
0x1382CA98, 37353941209616568, 89162143, 89162145, 2, 640x360 
0x1382CA98, 37353941209942536, 89162175, 89162177, 2, 640x360 
0x1382CA98, 37353941210257880, 89162205, 89162208, 3, 640x360 
0x1382CA98, 37353941210577216, 89162233, 89162239, 6, 640x360 
0x1382CA98, 37353941210901664, 89162262, 89162274, 12, 640x360 
0x1382CA98, 37353941211217128, 89162299, 89162306, 7, 640x360 
0x1382CA98, 37353941211536800, 89162329, 89162332, 3, 640x360 
0x1382CA98, 37353941212020392, 89162377, 89162379, 2, 640x360 
0x1382CA98, 37353941212347464, 89162408, 89162410, 2, 640x360 
0x1382CA98, 37353941212656304, 89162443, 89162445, 2, 640x360 
0x1382CA98, 37353941212981136, 89162470, 89162473, 3, 640x360 
0x1382CA98, 37353941213300336, 89162506, 89162508, 2, 640x360 
0x1382CA98, 37353941213620672, 89162540, 89162549, 9, 640x360 
0x1382CA98, 37353941213938600, 89162572, 89162579, 7, 640x360 
0x1382CA98, 37353941214262480, 89162605, 89162617, 12, 640x360 
0x1382CA98, 37353941214580216, 89162639, 89162646, 7, 640x360 
0x1382CA98, 37353941214900296, 89162673, 89162675, 2, 640x360 
0x1382CA98, 37353941215223296, 89162695, 89162700, 5, 640x360 
0x1382CA98, 37353941215537224, 89162727, 89162734, 7, 640x360 
0x1382CA98, 37353941216015944, 89162777, 89162779, 2, 640x360 
0x1382CA98, 37353941216336056, 89162807, 89162810, 3, 640x360 
0x1382CA98, 37353941216660416, 89162846, 89162849, 3, 640x360 
0x1382CA98, 37353941216976856, 89162873, 89162876, 3, 640x360 
0x1382CA98, 37353941217300608, 89162905, 89162912, 7, 640x360 
0x1382CA98, 37353941217617904, 89162937, 89162941, 4, 640x360 
0x1382CA98, 37353941217970416, 89162982, 89163005, 23, 640x360 
0x1382CA98, 37353941218282784, 89163018, 89163026, 8, 640x360 
0x1382CA98, 37353941218632456, 89163044, 89163052, 8, 640x360 
0x1382CA98, 37353941218945216, 89163094, 89163105, 11, 640x360 
0x1382CA98, 37353941219242360, 89163112, 89163115, 3, 640x360 
0x1382CA98, 37353941219536944, 89163150, 89163156, 6, 640x360 
0x1382CA98, 37353941220021296, 89163191, 89163194, 3, 640x360 
0x1382CA98, 37353941220337248, 89163221, 89163223, 2, 640x360 
0x1382CA98, 37353941220657584, 89163244, 89163246, 2, 640x360 
0x1382CA98, 37353941220982232, 89163272, 89163275, 3, 640x360 
0x1382CA98, 37353941221296128, 89163305, 89163312, 7, 640x360 
0x1382CA98, 37353941221616736, 89163336, 89163339, 3, 640x360 
0x1382CA98, 37353941221936936, 89163373, 89163381, 8, 640x360 
0x1382CA98, 37353941222260792, 89163407, 89163410, 3, 640x360 
0x1382CA98, 37353941222612560, 89163445, 89163448, 3, 640x360 
0x1382CA98, 37353941222901704, 89163480, 89163485, 5, 640x360 
0x1382CA98, 37353941223218368, 89163506, 89163515, 9, 640x360 
0x1382CA98, 37353941223576584, 89163539, 89163542, 3, 640x360 
0x1382CA98, 37353941224016240, 89163580, 89163592, 12, 640x360 
0x1382CA98, 37353941224339560, 89163612, 89163615, 3, 640x360 
0x1382CA98, 37353941224661016, 89163637, 89163644, 7, 640x360 
0x1382CA98, 37353941224982312, 89163673, 89163675, 2, 640x360 
0x1382CA98, 37353941225296360, 89163702, 89163709, 7, 640x360 
0x1382CA98, 37353941225632080, 89163751, 89163754, 3, 640x360 
0x1382CA98, 37353941225944752, 89163778, 89163785, 7, 640x360 
0x1382CA98, 37353941226279824, 89163821, 89163825, 4, 640x360 
0x1382CA98, 37353941226584312, 89163843, 89163845, 2, 640x360 
0x1382CA98, 37353941226904544, 89163872, 89163878, 6, 640x360 
0x1382CA98, 37353941227226976, 89163907, 89163909, 2, 640x360 
0x1382CA98, 37353941227545552, 89163929, 89163935, 6, 640x360 
0x1382CA98, 37353941228349704, 89164008, 89164013, 5, 640x360 
0x1382CA98, 37353941228656824, 89164040, 89164045, 5, 640x360 
0x1382CA98, 37353941228976488, 89164075, 89164080, 5, 640x360 
0x1382CA98, 37353941229302456, 89164106, 89164112, 6, 640x360 
0x1382CA98, 37353941229617000, 89164140, 89164142, 2, 640x360 
0x1382CA98, 37353941229955688, 89164175, 89164177, 2, 640x360 
0x1382CA98, 37353941230268584, 89164208, 89164210, 2, 640x360 
0x1382CA98, 37353941230592704, 89164239, 89164241, 2, 640x360 
0x1382CA98, 37353941230904536, 89164293, 89164299, 6, 640x360 
0x1382CA98, 37353941231224320, 89164308, 89164310, 2, 640x360 
0x1382CA98, 37353941231540560, 89164332, 89164333, 1, 640x360 
0x1382CA98, 37353941231856328, 89164361, 89164371, 10, 640x360 
0x1382CA98, 37353941232339664, 89164408, 89164414, 6, 640x360 
0x1382CA98, 37353941232661664, 89164450, 89164453, 3, 640x360 
0x1382CA98, 37353941232979912, 89164472, 89164475, 3, 640x360 
0x1382CA98, 37353941233298368, 89164506, 89164507, 1, 640x360 
0x1382CA98, 37353941233620520, 89164539, 89164546, 7, 640x360 
0x1382CA98, 37353941233936384, 89164566, 89164570, 4, 640x360 
0x1382CA98, 37353941234263832, 89164600, 89164602, 2, 640x360 
0x1382CA98, 37353941234586032, 89164628, 89164631, 3, 640x360 
0x1382CA98, 37353941234914336, 89164669, 89164672, 3, 640x360 
0x1382CA98, 37353941235217112, 89164700, 89164703, 3, 640x360 
0x1382CA98, 37353941235537240, 89164726, 89164729, 3, 640x360 
0x1382CA98, 37353941235862384, 89164771, 89164774, 3, 640x360 
0x1382CA98, 37353941236340176, 89164811, 89164813, 2, 640x360 
0x1382CA98, 37353941236660144, 89164839, 89164842, 3, 640x360 
0x1382CA98, 37353941236979656, 89164882, 89164886, 4, 640x360 
0x1382CA98, 37353941237297432, 89164905, 89164916, 11, 640x360 
0x1382CA98, 37353941237635296, 89164939, 89164942, 3, 640x360 
0x1382CA98, 37353941237947184, 89164984, 89164986, 2, 640x360 
0x1382CA98, 37353941238266296, 89165016, 89165024, 8, 640x360 
0x1382CA98, 37353941238580880, 89165034, 89165045, 11, 640x360 
0x1382CA98, 37353941238900944, 89165074, 89165077, 3, 640x360 
0x1382CA98, 37353941239220760, 89165099, 89165109, 10, 640x360 
0x1382CA98, 37353941239536328, 89165150, 89165153, 3, 640x360 
0x1382CA98, 37353941239860440, 89165173, 89165175, 2, 640x360 
0x1382CA98, 37353941240335528, 89165213, 89165216, 3, 640x360 
0x1382CA98, 37353941240657952, 89165239, 89165242, 3, 640x360 
0x1382CA98, 37353941240979632, 89165275, 89165276, 1, 640x360 
0x1382CA98, 37353941241304272, 89165303, 89165307, 4, 640x360 
0x1382CA98, 37353941241616784, 89165341, 89165354, 13, 640x360 
0x1382CA98, 37353941241939040, 89165380, 89165382, 2, 640x360 
0x1382CA98, 37353941242264528, 89165411, 89165413, 2, 640x360 
0x1382CA98, 37353941242591800, 89165439, 89165454, 15, 640x360 
0x1382CA98, 37353941242919728, 89165494, 89165496, 2, 640x360 
0x1382CA98, 37353941243236032, 89165505, 89165509, 4, 640x360 
0x1382CA98, 37353941243540216, 89165530, 89165534, 4, 640x360 
0x1382CA98, 37353941243869312, 89165561, 89165564, 3, 640x360 
0x1382CA98, 37353941244335280, 89165612, 89165614, 2, 640x360 
0x1382CA98, 37353941244657680, 89165639, 89165643, 4, 640x360 
0x1382CA98, 37353941244986136, 89165677, 89165679, 2, 640x360 
0x1382CA98, 37353941245305744, 89165704, 89165707, 3, 640x360 
0x1382CA98, 37353941245624296, 89165741, 89165743, 2, 640x360 
0x1382CA98, 37353941245945384, 89165778, 89165780, 2, 640x360 
0x1382CA98, 37353941246259096, 89165798, 89165811, 13, 640x360 
0x1382CA98, 37353941246585744, 89165842, 89165844, 2, 640x360 
0x1382CA98, 37353941246912112, 89165865, 89165875, 10, 640x360 
0x1382CA98, 37353941247216880, 89165896, 89165900, 4, 640x360 
0x1382CA98, 37353941247535752, 89165928, 89165933, 5, 640x360 
0x1382CA98, 37353941247856032, 89165961, 89165969, 8, 640x360 
0x1382CA98, 37353941248335296, 89166006, 89166011, 5, 640x360 
0x1382CA98, 37353941248657120, 89166047, 89166052, 5, 640x360 
0x1382CA98, 37353941248975576, 89166071, 89166073, 2, 640x360 
0x1382CA98, 37353941249299048, 89166108, 89166117, 9, 640x360 
0x1382CA98, 37353941249616376, 89166135, 89166146, 11, 640x360 
0x1382CA98, 37353941249936088, 89166166, 89166175, 9, 640x360 
0x1382CA98, 37353941250260120, 89166199, 89166207, 8, 640x360 
0x1382CA98, 37353941250579696, 89166230, 89166233, 3, 640x360 
0x1382CA98, 37353941250901896, 89166267, 89166274, 7, 640x360 
0x1382CA98, 37353941251221248, 89166299, 89166306, 7, 640x360 
0x1382CA98, 37353941251544640, 89166328, 89166336, 8, 640x360 
0x1382CA98, 37353941251862368, 89166367, 89166374, 7, 640x360 
0x1382CA98, 37353941252335224, 89166411, 89166413, 2, 640x360 
0x1382CA98, 37353941252655832, 89166439, 89166442, 3, 640x360 
0x1382CA98, 37353941252975936, 89166472, 89166478, 6, 640x360 
0x1382CA98, 37353941253298944, 89166504, 89166506, 2, 640x360 
0x1382CA98, 37353941253616272, 89166542, 89166550, 8, 640x360 
0x1382CA98, 37353941253936024, 89166583, 89166588, 5, 640x360 
0x1382CA98, 37353941254267384, 89166614, 89166622, 8, 640x360 
0x1382CA98, 37353941254580000, 89166651, 89166655, 4, 640x360 
0x1382CA98, 37353941254897296, 89166678, 89166682, 4, 640x360 
0x1382CA98, 37353941255226112, 89166712, 89166718, 6, 640x360 
0x1382CA98, 37353941255537920, 89166732, 89166738, 6, 640x360 
0x1382CA98, 37353941255862200, 89166772, 89166779, 7, 640x360 
0x1382CA98, 37353941256188640, 89166796, 89166799, 3, 640x360 
0x1382CA98, 37353941256655344, 89166853, 89166856, 3, 640x360 
0x1382CA98, 37353941256975920, 89166875, 89166878, 3, 640x360 
0x1382CA98, 37353941257301672, 89166919, 89166928, 9, 640x360 
0x1382CA98, 37353941257631600, 89166951, 89166957, 6, 640x360 
0x1382CA98, 37353941257944360, 89166973, 89166976, 3, 640x360 
0x1382CA98, 37353941258262320, 89167011, 89167013, 2, 640x360 
0x1382CA98, 37353941258619064, 89167052, 89167063, 11, 640x360 
0x1382CA98, 37353941258908552, 89167096, 89167106, 10, 640x360 
0x1382CA98, 37353941259257792, 89167146, 89167161, 15, 640x360 
0x1382CA98, 37353941259941344, 89167222, 89167236, 14, 640x360 
0x1382CA98, 37353941260288488, 89167236, 89167263, 27, 640x360 
0x1382CA98, 37353941260788472, 89167274, 89167289, 15, 640x360 
0x1382CA98, 37353941261041424, 89167299, 89167308, 9, 640x360 
0x1382CA98, 37353941261308096, 89167350, 89167364, 14, 640x360 
0x1382CA98, 37353941261957344, 89167374, 89167377, 3, 640x360 
0x1382CA98, 37353941262261488, 89167405, 89167408, 3, 640x360 
0x1382CA98, 37353941262584648, 89167439, 89167448, 9, 640x360 
0x1382CA98, 37353941262900384, 89167480, 89167492, 12, 640x360 
0x1382CA98, 37353941263231528, 89167499, 89167520, 21, 640x360 
0x1382CA98, 37353941263551792, 89167539, 89167542, 3, 640x360 
0x1382CA98, 37353941263855632, 89167578, 89167582, 4, 640x360 
0x1382CA98, 37353941264204512, 89167597, 89167603, 6, 640x360 
0x1382CA98, 37353941264670488, 89167653, 89167656, 3, 640x360 
0x1382CA98, 37353941264979040, 89167686, 89167695, 9, 640x360 
0x1382CA98, 37353941265303808, 89167707, 89167710, 3, 640x360 
0x1382CA98, 37353941265649144, 89167750, 89167755, 5, 640x360 
0x1382CA98, 37353941265955048, 89167775, 89167792, 17, 640x360 
0x1382CA98, 37353941266265864, 89167808, 89167812, 4, 640x360 
0x1382CA98, 37353941266593576, 89167853, 89167863, 10, 640x360 
0x1382CA98, 37353941266905288, 89167874, 89167877, 3, 640x360 
0x1382CA98, 37353941267215480, 89167907, 89167911, 4, 640x360 
0x1382CA98, 37353941267535272, 89167930, 89167937, 7, 640x360 
0x1382CA98, 37353941267867168, 89167969, 89167972, 3, 640x360 
0x1382CA98, 37353941268194520, 89168003, 89168005, 2, 640x360 
0x1382CA98, 37353941268654664, 89168042, 89168045, 3, 640x360 
0x1382CA98, 37353941268982912, 89168079, 89168084, 5, 640x360 
0x1382CA98, 37353941269309392, 89168112, 89168116, 4, 640x360 
0x1382CA98, 37353941269621464, 89168143, 89168146, 3, 640x360 
0x1382CA98, 37353941269943184, 89168180, 89168184, 4, 640x360 
0x1382CA98, 37353941270262216, 89168208, 89168211, 3, 640x360 
0x1382CA98, 37353941270577688, 89168237, 89168244, 7, 640x360 
0x1382CA98, 37353941270928736, 89168276, 89168277, 1, 640x360 
0x1382CA98, 37353941271216024, 89168308, 89168310, 2, 640x360 
0x1382CA98, 37353941271539520, 89168340, 89168342, 2, 640x360 
0x1382CA98, 37353941271860144, 89168366, 89168377, 11, 640x360 
0x1382CA98, 37353941272179392, 89168402, 89168405, 3, 640x360 
0x1382CA98, 37353941272654504, 89168446, 89168451, 5, 640x360 
0x1382CA98, 37353941272989128, 89168474, 89168476, 2, 640x360 
0x1382CA98, 37353941273300968, 89168509, 89168511, 2, 640x360 
0x1382CA98, 37353941273631376, 89168545, 89168550, 5, 640x360 
0x1382CA98, 37353941273939840, 89168576, 89168578, 2, 640x360 
0x1382CA98, 37353941274255408, 89168616, 89168622, 6, 640x360 
0x1382CA98, 37353941274595128, 89168640, 89168642, 2, 640x360 
0x1382CA98, 37353941274910072, 89168668, 89168677, 9, 640x360 
0x1382CA98, 37353941275223440, 89168708, 89168717, 9, 640x360 
0x1382CA98, 37353941275558952, 89168738, 89168741, 3, 640x360 
0x1382CA98, 37353941275855104, 89168769, 89168777, 8, 640x360 
0x1382CA98, 37353941276228880, 89168806, 89168809, 3, 640x360 
0x1382CA98, 37353941276655072, 89168853, 89168855, 2, 640x360 
0x1382CA98, 37353941276984600, 89168888, 89168902, 14, 640x360 
0x1382CA98, 37353941277319544, 89168919, 89168924, 5, 640x360 
0x1382CA98, 37353941277621784, 89168953, 89168962, 9, 640x360 
0x1382CA98, 37353941277943760, 89169015, 89169029, 14, 640x360 
0x1382CA98, 37353941278611560, 89169044, 89169046, 2, 640x360 
0x1382CA98, 37353941278895976, 89169070, 89169077, 7, 640x360 
0x1382CA98, 37353941279215208, 89169106, 89169108, 2, 640x360 
0x1382CA98, 37353941279537984, 89169130, 89169141, 11, 640x360 
0x1382CA98, 37353941279854920, 89169160, 89169166, 6, 640x360 
0x1382CA98, 37353941280175048, 89169193, 89169195, 2, 640x360 
0x1382CA98, 37353941280497160, 89169233, 89169237, 4, 640x360 
0x1382CA98, 37353941280985712, 89169279, 89169283, 4, 640x360 
0x1382CA98, 37353941281297576, 89169315, 89169326, 11, 640x360 
0x1382CA98, 37353941281614736, 89169347, 89169354, 7, 640x360 
0x1382CA98, 37353941281937784, 89169380, 89169385, 5, 640x360 
0x1382CA98, 37353941282264984, 89169407, 89169411, 4, 640x360 
0x1382CA98, 37353941282577272, 89169433, 89169444, 11, 640x360 
0x1382CA98, 37353941282901600, 89169482, 89169486, 4, 640x360 
0x1382CA98, 37353941283216880, 89169506, 89169509, 3, 640x360 
0x1382CA98, 37353941283539360, 89169530, 89169536, 6, 640x360 
0x1382CA98, 37353941283856720, 89169572, 89169575, 3, 640x360 
0x1382CA98, 37353941284186656, 89169602, 89169609, 7, 640x360 
0x1382CA98, 37353941284511088, 89169629, 89169635, 6, 640x360 
0x1382CA98, 37353941284978752, 89169684, 89169693, 9, 640x360 
0x1382CA98, 37353941285305568, 89169719, 89169723, 4, 640x360 
0x1382CA98, 37353941285618456, 89169741, 89169744, 3, 640x360 
0x1382CA98, 37353941285937184, 89169777, 89169779, 2, 640x360 
0x1382CA98, 37353941286255280, 89169807, 89169809, 2, 640x360 
0x1382CA98, 37353941286574424, 89169840, 89169843, 3, 640x360 
0x1382CA98, 37353941286904352, 89169863, 89169867, 4, 640x360 
0x1382CA98, 37353941287236640, 89169901, 89169907, 6, 640x360 
0x1382CA98, 37353941287539720, 89169929, 89169931, 2, 640x360 
0x1382CA98, 37353941287866400, 89169968, 89169970, 2, 640x360 
0x1382CA98, 37353941288174752, 89169993, 89169995, 2, 640x360 
0x1382CA98, 37353941288498120, 89170022, 89170025, 3, 640x360 
0x1382CA98, 37353941288974824, 89170073, 89170101, 28, 640x360 
0x1382CA98, 37353941289303904, 89170120, 89170136, 16, 640x360 
0x1382CA98, 37353941289724192, 89170157, 89170169, 12, 640x360 
0x1382CA98, 37353941289948504, 89170203, 89170215, 12, 640x360 
0x1382CA98, 37353941290274104, 89170229, 89170239, 10, 640x360 
0x1382CA98, 37353941290583696, 89170258, 89170262, 4, 640x360 
0x1382CA98, 37353941290914568, 89170276, 89170289, 13, 640x360 
0x1382CA98, 37353941291236640, 89170305, 89170310, 5, 640x360 
0x1382CA98, 37353941291548904, 89170346, 89170348, 2, 640x360 
0x1382CA98, 37353941291855288, 89170373, 89170375, 2, 640x360 
0x1382CA98, 37353941292174544, 89170405, 89170408, 3, 640x360 
0x1382CA98, 37353941292497208, 89170427, 89170434, 7, 640x360 
0x1382CA98, 37353941292978368, 89170479, 89170482, 3, 640x360 
0x1382CA98, 37353941293321560, 89170513, 89170517, 4, 640x360 
0x1382CA98, 37353941293617312, 89170545, 89170556, 11, 640x360 
0x1382CA98, 37353941293963256, 89170589, 89170593, 4, 640x360 
0x1382CA98, 37353941294267432, 89170613, 89170629, 16, 640x360 
0x1382CA98, 37353941294626696, 89170655, 89170662, 7, 640x360 
0x1382CA98, 37353941294917176, 89170694, 89170706, 12, 640x360 
0x1382CA98, 37353941295245464, 89170708, 89170714, 6, 640x360 
0x1382CA98, 37353941295554792, 89170731, 89170744, 13, 640x360 
0x1382CA98, 37353941295854984, 89170774, 89170779, 5, 640x360 
0x1382CA98, 37353941296178840, 89170795, 89170821, 26, 640x360 
0x1382CA98, 37353941296516552, 89170851, 89170854, 3, 640x360 
0x1382CA98, 37353941296987872, 89170890, 89170893, 3, 640x360 
0x1382CA98, 37353941297296752, 89170929, 89170940, 11, 640x360 
0x1382CA98, 37353941297641552, 89170940, 89170955, 15, 640x360 
0x1382CA98, 37353941297959464, 89170987, 89170995, 8, 640x360 
0x1382CA98, 37353941298284200, 89171034, 89171040, 6, 640x360 
0x1382CA98, 37353941298604200, 89171058, 89171061, 3, 640x360 
0x1382CA98, 37353941298937760, 89171074, 89171078, 4, 640x360 
0x1382CA98, 37353941299216560, 89171102, 89171107, 5, 640x360 
0x1382CA98, 37353941299568544, 89171129, 89171138, 9, 640x360 
0x1382CA98, 37353941299858192, 89171168, 89171174, 6, 640x360 
0x1382CA98, 37353941300174912, 89171194, 89171200, 6, 640x360 
0x1382CA98, 37353941300498208, 89171226, 89171228, 2, 640x360 
0x1382CA98, 37353941300978288, 89171278, 89171281, 3, 640x360 
0x1382CA98, 37353941301297272, 89171306, 89171309, 3, 640x360 
0x1382CA98, 37353941301618112, 89171342, 89171343, 1, 640x360 
0x1382CA98, 37353941301936776, 89171377, 89171379, 2, 640x360 
0x1382CA98, 37353941302276720, 89171417, 89171421, 4, 640x360 
0x1382CA98, 37353941302579824, 89171439, 89171450, 11, 640x360 
0x1382CA98, 37353941302895416, 89171464, 89171471, 7, 640x360 
0x1382CA98, 37353941303245360, 89171497, 89171509, 12, 640x360 
0x1382CA98, 37353941303534848, 89171531, 89171534, 3, 640x360 
0x1382CA98, 37353941303864032, 89171563, 89171566, 3, 640x360 
0x1382CA98, 37353941304176696, 89171594, 89171597, 3, 640x360 
0x1382CA98, 37353941304499480, 89171627, 89171629, 2, 640x360 
0x1382CA98, 37353941304978096, 89171678, 89171684, 6, 640x360 
0x1382CA98, 37353941305295048, 89171702, 89171711, 9, 640x360 
0x1382CA98, 37353941305625616, 89171747, 89171754, 7, 640x360 
0x1382CA98, 37353941305950176, 89171774, 89171780, 6, 640x360 
0x1382CA98, 37353941306266016, 89171806, 89171821, 15, 640x360 
0x1382CA98, 37353941306603872, 89171856, 89171859, 3, 640x360 
0x1382CA98, 37353941306940584, 89171888, 89171896, 8, 640x360 
0x1382CA98, 37353941307217408, 89171909, 89171927, 18, 640x360 
0x1382CA98, 37353941307545488, 89171938, 89171942, 4, 640x360 
0x1382CA98, 37353941307860912, 89171976, 89172000, 24, 640x360 
0x1382CA98, 37353941308198360, 89172006, 89172018, 12, 640x360 
0x1382CA98, 37353941308503216, 89172042, 89172051, 9, 640x360 
0x1382CA98, 37353941308820496, 89172078, 89172107, 29, 640x360 
0x1382CA98, 37353941309516200, 89172172, 89172178, 6, 640x360 
0x1382CA98, 37353941310019952, 89172203, 89172212, 9, 640x360 
0x1382CA98, 37353941310159688, 89172214, 89172233, 19, 640x360 
0x1382CA98, 37353941310432560, 89172235, 89172249, 14, 640x360 
0x1382CA98, 37353941310692112, 89172258, 89172334, 76, 640x360 
0x1382CA98, 37353941311275552, 89172334, 89172339, 5, 640x360 
0x1382CA98, 37353941311538720, 89172352, 89172380, 28, 640x360 
0x1382CA98, 37353941311884024, 89172392, 89172415, 23, 640x360 
0x1382CA98, 37353941312184080, 89172425, 89172433, 8, 640x360 
0x1382CA98, 37353941312509744, 89172445, 89172477, 32, 640x360 
0x1382CA98, 37353941312819656, 89172485, 89172490, 5, 640x360 
0x1382CA98, 37353941313329024, 89172510, 89172513, 3, 640x360 
0x1382CA98, 37353941313618832, 89172549, 89172562, 13, 640x360 
0x1382CA98, 37353941313948432, 89172574, 89172591, 17, 640x360 
0x1382CA98, 37353941314290312, 89172613, 89172622, 9, 640x360 
0x1382CA98, 37353941314585072, 89172657, 89172672, 15, 640x360 
0x1382CA98, 37353941314900312, 89172672, 89172676, 4, 640x360 
0x1382CA98, 37353941315220032, 89172721, 89172732, 11, 640x360 
0x1382CA98, 37353941315540424, 89172733, 89172738, 5, 640x360 
0x1382CA98, 37353941315854184, 89172770, 89172773, 3, 640x360 
0x1382CA98, 37353941316176608, 89172794, 89172798, 4, 640x360 
0x1382CA98, 37353941316498072, 89172827, 89172830, 3, 640x360 
0x1382CA98, 37353941316814360, 89172859, 89172861, 2, 640x360 
0x1382CA98, 37353941317296296, 89172913, 89172918, 5, 640x360 
0x1382CA98, 37353941317646080, 89172938, 89172941, 3, 640x360 
0x1382CA98, 37353941317937288, 89172974, 89172976, 2, 640x360 
0x1382CA98, 37353941318258064, 89173013, 89173017, 4, 640x360 
0x1382CA98, 37353941318588520, 89173039, 89173041, 2, 640x360 
0x1382CA98, 37353941318902392, 89173071, 89173074, 3, 640x360 
0x1382CA98, 37353941319219320, 89173106, 89173108, 2, 640x360 
0x1382CA98, 37353941319538848, 89173130, 89173141, 11, 640x360 
0x1382CA98, 37353941319853696, 89173161, 89173163, 2, 640x360 
0x1382CA98, 37353941320173968, 89173195, 89173200, 5, 640x360 
0x1382CA98, 37353941320493952, 89173238, 89173254, 16, 640x360 
0x1382CA98, 37353941320819208, 89173272, 89173275, 3, 640x360 
0x1382CA98, 37353941321298568, 89173312, 89173316, 4, 640x360 
0x1382CA98, 37353941321621976, 89173341, 89173344, 3, 640x360 
0x1382CA98, 37353941321940600, 89173375, 89173382, 7, 640x360 
0x1382CA98, 37353941322259424, 89173409, 89173413, 4, 640x360 
0x1382CA98, 37353941322637048, 89173461, 89173472, 11, 640x360 
0x1382CA98, 37353941322914064, 89173485, 89173510, 25, 640x360 
0x1382CA98, 37353941323285672, 89173518, 89173527, 9, 640x360 
0x1382CA98, 37353941323541864, 89173544, 89173574, 30, 640x360 
0x1382CA98, 37353941323876336, 89173598, 89173611, 13, 640x360 
0x1382CA98, 37353941324181440, 89173619, 89173644, 25, 640x360 
0x1382CA98, 37353941324511704, 89173658, 89173662, 4, 640x360 
0x1382CA98, 37353941324834312, 89173671, 89173683, 12, 640x360 
0x1382CA98, 37353941325294240, 89173719, 89173725, 6, 640x360 
0x1382CA98, 37353941325631952, 89173761, 89173775, 14, 640x360 
0x1382CA98, 37353941325943744, 89173775, 89173785, 10, 640x360 
0x1382CA98, 37353941326263616, 89173810, 89173824, 14, 640x360 
0x1382CA98, 37353941326594768, 89173842, 89173846, 4, 640x360 
0x1382CA98, 37353941326895384, 89173875, 89173878, 3, 640x360 
0x1382CA98, 37353941327226336, 89173895, 89173898, 3, 640x360 
0x1382CA98, 37353941327533744, 89173936, 89173938, 2, 640x360 
0x1382CA98, 37353941327863648, 89173969, 89173972, 3, 640x360 
0x1382CA98, 37353941328174320, 89173998, 89174003, 5, 640x360 
0x1382CA98, 37353941328497416, 89174021, 89174028, 7, 640x360 
0x1382CA98, 37353941328813896, 89174057, 89174064, 7, 640x360 
0x1382CA98, 37353941329297424, 89174102, 89174112, 10, 640x360 
0x1382CA98, 37353941329613768, 89174141, 89174144, 3, 640x360 
0x1382CA98, 37353941329937064, 89174169, 89174178, 9, 640x360 
0x1382CA98, 37353941330253496, 89174202, 89174206, 4, 640x360 
0x1382CA98, 37353941330581184, 89174229, 89174237, 8, 640x360 
0x1382CA98, 37353941330896856, 89174270, 89174278, 8, 640x360 
0x1382CA98, 37353941331214240, 89174304, 89174306, 2, 640x360 
0x1382CA98, 37353941331535136, 89174338, 89174340, 2, 640x360 
0x1382CA98, 37353941331853720, 89174369, 89174372, 3, 640x360 
0x1382CA98, 37353941332177784, 89174391, 89174395, 4, 640x360 
0x1382CA98, 37353941332497592, 89174422, 89174425, 3, 640x360 
0x1382CA98, 37353941332813944, 89174458, 89174460, 2, 640x360 
0x1382CA98, 37353941333312000, 89174516, 89174526, 10, 640x360 
0x1382CA98, 37353941333617136, 89174555, 89174566, 11, 640x360 
0x1382CA98, 37353941333937472, 89174572, 89174578, 6, 640x360 
0x1382CA98, 37353941334276400, 89174614, 89174619, 5, 640x360 
0x1382CA98, 37353941334580080, 89174642, 89174644, 2, 640x360 
0x1382CA98, 37353941334896064, 89174665, 89174677, 12, 640x360 
0x1382CA98, 37353941335214168, 89174701, 89174707, 6, 640x360 
0x1382CA98, 37353941335533416, 89174736, 89174743, 7, 640x360 
0x1382CA98, 37353941335857016, 89174758, 89174761, 3, 640x360 
0x1382CA98, 37353941336173344, 89174788, 89174790, 2, 640x360 
0x1382CA98, 37353941336495416, 89174828, 89174830, 2, 640x360 
0x1382CA98, 37353941336813536, 89174857, 89174859, 2, 640x360 
0x1382CA98, 37353941337140680, 89174888, 89174891, 3, 640x360 
0x1382CA98, 37353941337614112, 89174931, 89174937, 6, 640x360 
0x1382CA98, 37353941337936248, 89174973, 89174976, 3, 640x360 
0x1382CA98, 37353941338258840, 89174999, 89175011, 12, 640x360 
0x1382CA98, 37353941338579592, 89175031, 89175041, 10, 640x360 
0x1382CA98, 37353941338897888, 89175069, 89175078, 9, 640x360 
0x1382CA98, 37353941339247352, 89175100, 89175103, 3, 640x360 
0x1382CA98, 37353941339550480, 89175126, 89175129, 3, 640x360 
0x1382CA98, 37353941339853656, 89175159, 89175161, 2, 640x360 
0x1382CA98, 37353941340175864, 89175190, 89175193, 3, 640x360 
0x1382CA98, 37353941340493824, 89175222, 89175224, 2, 640x360 
0x1382CA98, 37353941340818256, 89175257, 89175259, 2, 640x360 
0x1382CA98, 37353941341140608, 89175291, 89175293, 2, 640x360 
0x1382CA98, 37353941341618560, 89175344, 89175346, 2, 640x360 
0x1382CA98, 37353941341948560, 89175369, 89175372, 3, 640x360 
0x1382CA98, 37353941342259928, 89175407, 89175409, 2, 640x360 
0x1382CA98, 37353941342576152, 89175436, 89175445, 9, 640x360 
0x1382CA98, 37353941342900704, 89175468, 89175476, 8, 640x360 
0x1382CA98, 37353941343221824, 89175494, 89175496, 2, 640x360 
0x1382CA98, 37353941343533216, 89175526, 89175529, 3, 640x360 
0x1382CA98, 37353941343853624, 89175569, 89175572, 3, 640x360 
0x1382CA98, 37353941344175192, 89175597, 89175603, 6, 640x360 
0x1382CA98, 37353941344493448, 89175625, 89175630, 5, 640x360 
0x1382CA98, 37353941344813880, 89175656, 89175663, 7, 640x360 
0x1382CA98, 37353941345134064, 89175692, 89175694, 2, 640x360 
0x1382CA98, 37353941345624936, 89175746, 89175750, 4, 640x360 
0x1382CA98, 37353941345933392, 89175779, 89175785, 6, 640x360 
0x1382CA98, 37353941346269240, 89175806, 89175813, 7, 640x360 
0x1382CA98, 37353941346587760, 89175838, 89175841, 3, 640x360 
0x1382CA98, 37353941346897296, 89175869, 89175872, 3, 640x360 
0x1382CA98, 37353941347213952, 89175902, 89175904, 2, 640x360 
0x1382CA98, 37353941347539824, 89175931, 89175935, 4, 640x360 
0x1382CA98, 37353941347858232, 89175966, 89175971, 5, 640x360 
0x1382CA98, 37353941348173984, 89175997, 89176005, 8, 640x360 
0x1382CA98, 37353941348499080, 89176041, 89176043, 2, 640x360 
0x1382CA98, 37353941348820080, 89176055, 89176065, 10, 640x360 
0x1382CA98, 37353941349137256, 89176090, 89176096, 6, 640x360 
0x1382CA98, 37353941349620112, 89176140, 89176143, 3, 640x360 
0x1382CA98, 37353941349933056, 89176172, 89176178, 6, 640x360 
0x1382CA98, 37353941350253672, 89176204, 89176210, 6, 640x360 
0x1382CA98, 37353941350595888, 89176236, 89176242, 6, 640x360 
0x1382CA98, 37353941350893376, 89176271, 89176277, 6, 640x360 
0x1382CA98, 37353941351215856, 89176296, 89176301, 5, 640x360 
0x1382CA98, 37353941351538360, 89176328, 89176330, 2, 640x360 
0x1382CA98, 37353941351856984, 89176368, 89176372, 4, 640x360 
0x1382CA98, 37353941352177744, 89176398, 89176404, 6, 640x360 
0x1382CA98, 37353941352493136, 89176420, 89176428, 8, 640x360 
0x1382CA98, 37353941352814520, 89176458, 89176463, 5, 640x360 
0x1382CA98, 37353941353136808, 89176484, 89176487, 3, 640x360 
0x1382CA98, 37353941353623472, 89176537, 89176540, 3, 640x360 
0x1382CA98, 37353941353932944, 89176564, 89176571, 7, 640x360 
0x1382CA98, 37353941354269352, 89176613, 89176620, 7, 640x360 
0x1382CA98, 37353941354588664, 89176650, 89176660, 10, 640x360 
0x1382CA98, 37353941354893152, 89176672, 89176681, 9, 640x360 
0x1382CA98, 37353941355219008, 89176694, 89176697, 3, 640x360 
0x1382CA98, 37353941355533432, 89176733, 89176741, 8, 640x360 
0x1382CA98, 37353941355853992, 89176761, 89176764, 3, 640x360 
0x1382CA98, 37353941356177488, 89176794, 89176795, 1, 640x360 
0x1382CA98, 37353941356504640, 89176827, 89176829, 2, 640x360 
0x1382CA98, 37353941356819344, 89176866, 89176870, 4, 640x360 
0x1382CA98, 37353941357133624, 89176887, 89176890, 3, 640x360 
0x1382CA98, 37353941357613088, 89176951, 89176957, 6, 640x360 
0x1382CA98, 37353941357938776, 89176971, 89176978, 7, 640x360 
0x1382CA98, 37353941358253688, 89177005, 89177008, 3, 640x360 
0x1382CA98, 37353941358594888, 89177028, 89177030, 2, 640x360 
0x1382CA98, 37353941358892768, 89177068, 89177072, 4, 640x360 
0x1382CA98, 37353941359237504, 89177095, 89177098, 3, 640x360 
0x1382CA98, 37353941359540864, 89177143, 89177146, 3, 640x360 
0x1382CA98, 37353941359853408, 89177164, 89177176, 12, 640x360 
0x1382CA98, 37353941360178888, 89177190, 89177193, 3, 640x360 
0x1382CA98, 37353941360494072, 89177221, 89177224, 3, 640x360 
0x1382CA98, 37353941360822432, 89177254, 89177257, 3, 640x360 
0x1382CA98, 37353941361148760, 89177291, 89177292, 1, 640x360 
0x1382CA98, 37353941361461968, 89177324, 89177326, 2, 640x360 
0x1382CA98, 37353941361937736, 89177363, 89177375, 12, 640x360 
0x1382CA98, 37353941362256480, 89177398, 89177409, 11, 640x360 
0x1382CA98, 37353941362579352, 89177428, 89177432, 4, 640x360 
0x1382CA98, 37353941362895344, 89177467, 89177473, 6, 640x360 
0x1382CA98, 37353941363212600, 89177500, 89177504, 4, 640x360 
0x1382CA98, 37353941363533080, 89177537, 89177545, 8, 640x360 
0x1382CA98, 37353941363864512, 89177571, 89177575, 4, 640x360 
0x1382CA98, 37353941364172704, 89177590, 89177594, 4, 640x360 
0x1382CA98, 37353941364492768, 89177625, 89177627, 2, 640x360 
0x1382CA98, 37353941364831680, 89177656, 89177658, 2, 640x360 
0x1382CA98, 37353941365144304, 89177698, 89177708, 10, 640x360 
0x1382CA98, 37353941365453792, 89177722, 89177729, 7, 640x360 
0x1382CA98, 37353941365938768, 89177774, 89177777, 3, 640x360 
0x1382CA98, 37353941366264720, 89177803, 89177812, 9, 640x360 
0x1382CA98, 37353941366596248, 89177852, 89177861, 9, 640x360 
0x1382CA98, 37353941366894456, 89177878, 89177887, 9, 640x360 
0x1382CA98, 37353941367239008, 89177904, 89177907, 3, 640x360 
0x1382CA98, 37353941367538312, 89177931, 89177937, 6, 640x360 
0x1382CA98, 37353941367853376, 89177967, 89177971, 4, 640x360 
0x1382CA98, 37353941368172672, 89177993, 89177995, 2, 640x360 
0x1382CA98, 37353941368493904, 89178024, 89178026, 2, 640x360 
0x1382CA98, 37353941368812520, 89178055, 89178056, 1, 640x360 
0x1382CA98, 37353941369138952, 89178086, 89178091, 5, 640x360 
0x1382CA98, 37353941369453792, 89178123, 89178125, 2, 640x360 
0x1382CA98, 37353941369936192, 89178167, 89178171, 4, 640x360 
0x1382CA98, 37353941370256352, 89178200, 89178202, 2, 640x360 
0x1382CA98, 37353941370576752, 89178237, 89178240, 3, 640x360 
0x1382CA98, 37353941370894528, 89178268, 89178272, 4, 640x360 
0x1382CA98, 37353941371216912, 89178300, 89178303, 3, 640x360 
0x1382CA98, 37353941371536480, 89178324, 89178327, 3, 640x360 
0x1382CA98, 37353941371852448, 89178356, 89178359, 3, 640x360 
0x1382CA98, 37353941372176488, 89178387, 89178390, 3, 640x360 
0x1382CA98, 37353941372493704, 89178424, 89178426, 2, 640x360 
0x1382CA98, 37353941372817944, 89178455, 89178461, 6, 640x360 
0x1382CA98, 37353941373133352, 89178488, 89178495, 7, 640x360 
0x1382CA98, 37353941373453552, 89178519, 89178521, 2, 640x360 
0x1382CA98, 37353941373934264, 89178564, 89178570, 6, 640x360 
0x1382CA98, 37353941374252440, 89178595, 89178598, 3, 640x360 
0x1382CA98, 37353941374577944, 89178627, 89178630, 3, 640x360 
0x1382CA98, 37353941374897096, 89178671, 89178673, 2, 640x360 
0x1382CA98, 37353941375216024, 89178696, 89178699, 3, 640x360 
0x1382CA98, 37353941375540472, 89178727, 89178730, 3, 640x360 
0x1382CA98, 37353941375852864, 89178757, 89178763, 6, 640x360 
0x1382CA98, 37353941376177808, 89178789, 89178795, 6, 640x360 
0x1382CA98, 37353941376492952, 89178836, 89178841, 5, 640x360 
0x1382CA98, 37353941376828248, 89178858, 89178865, 7, 640x360 
0x1382CA98, 37353941377133784, 89178883, 89178886, 3, 640x360 
0x1382CA98, 37353941377457864, 89178915, 89178918, 3, 640x360 
0x1382CA98, 37353941377932504, 89178966, 89178972, 6, 640x360 
0x1382CA98, 37353941378261648, 89179003, 89179011, 8, 640x360 
0x1382CA98, 37353941378590968, 89179036, 89179044, 8, 640x360 
0x1382CA98, 37353941378892328, 89179063, 89179067, 4, 640x360 
0x1382CA98, 37353941379212216, 89179107, 89179113, 6, 640x360 
0x1382CA98, 37353941379541680, 89179129, 89179134, 5, 640x360 
0x1382CA98, 37353941379856784, 89179160, 89179163, 3, 640x360 
0x1382CA98, 37353941380172288, 89179187, 89179195, 8, 640x360 
0x1382CA98, 37353941380498280, 89179224, 89179226, 2, 640x360 
0x1382CA98, 37353941380813440, 89179266, 89179271, 5, 640x360 
0x1382CA98, 37353941381146064, 89179302, 89179305, 3, 640x360 
0x1382CA98, 37353941381454328, 89179330, 89179335, 5, 640x360 
0x1382CA98, 37353941381936584, 89179382, 89179392, 10, 640x360 
0x1382CA98, 37353941382263480, 89179403, 89179412, 9, 640x360 
0x1382CA98, 37353941382616800, 89179446, 89179457, 11, 640x360 
0x1382CA98, 37353941382932048, 89179477, 89179479, 2, 640x360 
0x1382CA98, 37353941383212344, 89179509, 89179512, 3, 640x360 
0x1382CA98, 37353941383536304, 89179541, 89179544, 3, 640x360 
0x1382CA98, 37353941383856224, 89179568, 89179576, 8, 640x360 
0x1382CA98, 37353941384172576, 89179600, 89179612, 12, 640x360 
0x1382CA98, 37353941384499608, 89179623, 89179626, 3, 640x360 
0x1382CA98, 37353941384820256, 89179657, 89179659, 2, 640x360 
0x1382CA98, 37353941385148208, 89179688, 89179691, 3, 640x360 
0x1382CA98, 37353941385458176, 89179721, 89179728, 7, 640x360 
0x1382CA98, 37353941385936016, 89179777, 89179779, 2, 640x360 
0x1382CA98, 37353941386257592, 89179803, 89179811, 8, 640x360 
0x1382CA98, 37353941386585168, 89179829, 89179836, 7, 640x360 
0x1382CA98, 37353941386895344, 89179867, 89179869, 2, 640x360 
0x1382CA98, 37353941387215312, 89179899, 89179902, 3, 640x360 
0x1382CA98, 37353941387536144, 89179929, 89179932, 3, 640x360 
0x1382CA98, 37353941387853008, 89179964, 89179968, 4, 640x360 
0x1382CA98, 37353941388173992, 89179988, 89179990, 2, 640x360 
0x1382CA98, 37353941388496696, 89180029, 89180032, 3, 640x360 
0x1382CA98, 37353941388822368, 89180056, 89180062, 6, 640x360 
0x1382CA98, 37353941389164048, 89180090, 89180092, 2, 640x360 
0x1382CA98, 37353941389525360, 89180126, 89180128, 2, 640x360 
0x1382CA98, 37353941389815808, 89180156, 89180159, 3, 640x360 
0x1382CA98, 37353941390256016, 89180198, 89180210, 12, 640x360 
0x1382CA98, 37353941390581336, 89180229, 89180234, 5, 640x360 
0x1382CA98, 37353941390893560, 89180268, 89180276, 8, 640x360 
0x1382CA98, 37353941391211752, 89180293, 89180296, 3, 640x360 
0x1382CA98, 37353941391531696, 89180334, 89180342, 8, 640x360 
0x1382CA98, 37353941391851888, 89180369, 89180378, 9, 640x360 
0x1382CA98, 37353941392174384, 89180390, 89180392, 2, 640x360 
0x1382CA98, 37353941392492128, 89180424, 89180427, 3, 640x360 
0x1382CA98, 37353941392819008, 89180457, 89180459, 2, 640x360 
0x1382CA98, 37353941393138320, 89180496, 89180500, 4, 640x360 
0x1382CA98, 37353941393464152, 89180525, 89180527, 2, 640x360 
0x1382CA98, 37353941393791128, 89180558, 89180560, 2, 640x360 
0x1382CA98, 37353941394256368, 89180595, 89180601, 6, 640x360 
0x1382CA98, 37353941394577712, 89180628, 89180634, 6, 640x360 
0x1382CA98, 37353941394895288, 89180663, 89180668, 5, 640x360 
0x1382CA98, 37353941395212272, 89180703, 89180715, 12, 640x360 
0x1382CA98, 37353941395571312, 89180738, 89180741, 3, 640x360 
0x1382CA98, 37353941395854760, 89180759, 89180761, 2, 640x360 
0x1382CA98, 37353941396172256, 89180798, 89180810, 12, 640x360 
0x1382CA98, 37353941396494760, 89180835, 89180844, 9, 640x360 
0x1382CA98, 37353941396812696, 89180861, 89180869, 8, 640x360 
0x1382CA98, 37353941397137824, 89180902, 89180905, 3, 640x360 
0x1382CA98, 37353941397455384, 89180928, 89180931, 3, 640x360 
0x1382CA98, 37353941397797152, 89180957, 89180966, 9, 640x360 
0x1382CA98, 37353941398261936, 89181007, 89181011, 4, 640x360 
0x1382CA98, 37353941398605592, 89181039, 89181052, 13, 640x360 
0x1382CA98, 37353941398906712, 89181093, 89181095, 2, 640x360 
0x1382CA98, 37353941399216824, 89181117, 89181133, 16, 640x360 
0x1382CA98, 37353941399532888, 89181137, 89181145, 8, 640x360 
0x1382CA98, 37353941399858264, 89181173, 89181178, 5, 640x360 
0x1382CA98, 37353941400177960, 89181202, 89181204, 2, 640x360 
0x1382CA98, 37353941400492096, 89181222, 89181225, 3, 640x360 
0x1382CA98, 37353941400818208, 89181263, 89181266, 3, 640x360 
0x1382CA98, 37353941401134984, 89181284, 89181295, 11, 640x360 
0x1382CA98, 37353941401457328, 89181316, 89181320, 4, 640x360 
0x1382CA98, 37353941401772272, 89181347, 89181360, 13, 640x360 
0x1382CA98, 37353941402256024, 89181406, 89181415, 9, 640x360 
0x1382CA98, 37353941402577176, 89181432, 89181434, 2, 640x360 
0x1382CA98, 37353941402892528, 89181460, 89181462, 2, 640x360 
0x1382CA98, 37353941403212960, 89181502, 89181504, 2, 640x360 
0x1382CA98, 37353941403532344, 89181530, 89181535, 5, 640x360 
0x1382CA98, 37353941403852168, 89181560, 89181562, 2, 640x360 
0x1382CA98, 37353941404210632, 89181603, 89181605, 2, 640x360 
0x1382CA98, 37353941404492608, 89181625, 89181630, 5, 640x360 
0x1382CA98, 37353941404853688, 89181670, 89181672, 2, 640x360 
0x1382CA98, 37353941405131856, 89181690, 89181692, 2, 640x360 
0x1382CA98, 37353941405452704, 89181723, 89181725, 2, 640x360 
0x1382CA98, 37353941405772472, 89181762, 89181763, 1, 640x360 
0x1382CA98, 37353941406254200, 89181796, 89181810, 14, 640x360 
0x1382CA98, 37353941406578672, 89181845, 89181847, 2, 640x360 
0x1382CA98, 37353941406892592, 89181868, 89181876, 8, 640x360 
0x1382CA98, 37353941407211896, 89181893, 89181901, 8, 640x360 
0x1382CA98, 37353941407536416, 89181924, 89181929, 5, 640x360 
0x1382CA98, 37353941407851944, 89181963, 89181966, 3, 640x360 
0x1382CA98, 37353941408176480, 89181991, 89181994, 3, 640x360 
0x1382CA98, 37353941408497896, 89182024, 89182034, 10, 640x360 
0x1382CA98, 37353941408811888, 89182068, 89182077, 9, 640x360 
0x1382CA98, 37353941409141112, 89182099, 89182106, 7, 640x360 
0x1382CA98, 37353941409455152, 89182134, 89182138, 4, 640x360 
0x1382CA98, 37353941409775384, 89182163, 89182166, 3, 640x360 
0x1382CA98, 37353941410262392, 89182198, 89182203, 5, 640x360 
0x1382CA98, 37353941410574632, 89182229, 89182232, 3, 640x360 
0x1382CA98, 37353941410893504, 89182271, 89182282, 11, 640x360 
0x1382CA98, 37353941411224856, 89182298, 89182303, 5, 640x360 
0x1382CA98, 37353941411531480, 89182336, 89182339, 3, 640x360 
0x1382CA98, 37353941411855240, 89182362, 89182364, 2, 640x360 
0x1382CA98, 37353941412174952, 89182401, 89182404, 3, 640x360 
0x1382CA98, 37353941412494376, 89182423, 89182426, 3, 640x360 
0x1382CA98, 37353941412814528, 89182461, 89182466, 5, 640x360 
0x1382CA98, 37353941413131272, 89182496, 89182497, 1, 640x360 
0x1382CA98, 37353941413458832, 89182534, 89182538, 4, 640x360 
0x1382CA98, 37353941413776144, 89182558, 89182561, 3, 640x360 
0x1382CA98, 37353941414097480, 89182582, 89182593, 11, 640x360 
0x1382CA98, 37353941414585368, 89182642, 89182644, 2, 640x360 
0x1382CA98, 37353941414902432, 89182668, 89182673, 5, 640x360 
0x1382CA98, 37353941415224768, 89182698, 89182716, 18, 640x360 
0x1382CA98, 37353941415575096, 89182735, 89182739, 4, 640x360 
0x1382CA98, 37353941415861840, 89182761, 89182763, 2, 640x360 
0x1382CA98, 37353941416176320, 89182794, 89182796, 2, 640x360 
0x1382CA98, 37353941416494664, 89182825, 89182830, 5, 640x360 
0x1382CA98, 37353941416823232, 89182859, 89182862, 3, 640x360 
0x1382CA98, 37353941417135904, 89182891, 89182900, 9, 640x360 
0x1382CA98, 37353941417456016, 89182929, 89182935, 6, 640x360 
0x1382CA98, 37353941417771968, 89182950, 89182961, 11, 640x360 
0x1382CA98, 37353941418096008, 89182985, 89182995, 10, 640x360 
0x1382CA98, 37353941418592240, 89183045, 89183051, 6, 640x360 
0x1382CA98, 37353941418899848, 89183069, 89183071, 2, 640x360 
0x1382CA98, 37353941419214080, 89183103, 89183111, 8, 640x360 
0x1382CA98, 37353941419536376, 89183140, 89183147, 7, 640x360 
0x1382CA98, 37353941419856872, 89183163, 89183178, 15, 640x360 
0x1382CA98, 37353941420185640, 89183197, 89183202, 5, 640x360 
0x1382CA98, 37353941420500344, 89183237, 89183241, 4, 640x360 
0x1382CA98, 37353941420812584, 89183272, 89183278, 6, 640x360 
0x1382CA98, 37353941421137984, 89183299, 89183312, 13, 640x360 
0x1382CA98, 37353941421457776, 89183337, 89183349, 12, 640x360 
0x1382CA98, 37353941421792696, 89183361, 89183363, 2, 640x360 
0x1382CA98, 37353941422150096, 89183405, 89183408, 3, 640x360 
0x1382CA98, 37353941422571080, 89183430, 89183434, 4, 640x360 
0x1382CA98, 37353941422891784, 89183463, 89183467, 4, 640x360 
0x1382CA98, 37353941423216000, 89183495, 89183497, 2, 640x360 
0x1382CA98, 37353941423530816, 89183524, 89183526, 2, 640x360 
0x1382CA98, 37353941423850920, 89183560, 89183562, 2, 640x360 
0x1382CA98, 37353941424170904, 89183595, 89183596, 1, 640x360 
0x1382CA98, 37353941424495632, 89183636, 89183646, 10, 640x360 
0x1382CA98, 37353941424816328, 89183666, 89183671, 5, 640x360 
0x1382CA98, 37353941425138400, 89183693, 89183695, 2, 640x360 
0x1382CA98, 37353941425457544, 89183731, 89183734, 3, 640x360 
0x1382CA98, 37353941425775112, 89183758, 89183760, 2, 640x360 
0x1382CA98, 37353941426093280, 89183785, 89183789, 4, 640x360 
0x1382CA98, 37353941426577440, 89183836, 89183844, 8, 640x360 
0x1382CA98, 37353941426892016, 89183870, 89183873, 3, 640x360 
0x1382CA98, 37353941427211448, 89183904, 89183906, 2, 640x360 
0x1382CA98, 37353941427530624, 89183928, 89183932, 4, 640x360 
0x1382CA98, 37353941427851568, 89183961, 89183963, 2, 640x360 
0x1382CA98, 37353941428174368, 89183996, 89183998, 2, 640x360 
0x1382CA98, 37353941428497336, 89184022, 89184025, 3, 640x360 
0x1382CA98, 37353941428814664, 89184058, 89184065, 7, 640x360 
0x1382CA98, 37353941429133616, 89184085, 89184090, 5, 640x360 
0x1382CA98, 37353941429454496, 89184123, 89184135, 12, 640x360 
0x1382CA98, 37353941429776520, 89184164, 89184171, 7, 640x360 
0x1382CA98, 37353941430113192, 89184197, 89184200, 3, 640x360 
0x1382CA98, 37353941430581808, 89184236, 89184238, 2, 640x360 
0x1382CA98, 37353941430891640, 89184261, 89184263, 2, 640x360 
0x1382CA98, 37353941431219256, 89184294, 89184297, 3, 640x360 
0x1382CA98, 37353941431534928, 89184325, 89184328, 3, 640x360 
0x1382CA98, 37353941431851096, 89184356, 89184359, 3, 640x360 
0x1382CA98, 37353941432175320, 89184388, 89184390, 2, 640x360 
0x1382CA98, 37353941432493000, 89184426, 89184428, 2, 640x360 
0x1382CA98, 37353941432815376, 89184459, 89184463, 4, 640x360 
0x1382CA98, 37353941433131504, 89184492, 89184494, 2, 640x360 
0x1382CA98, 37353941433458160, 89184537, 89184542, 5, 640x360 
0x1382CA98, 37353941433771664, 89184559, 89184572, 13, 640x360 
0x1382CA98, 37353941434097344, 89184591, 89184593, 2, 640x360 
0x1382CA98, 37353941434577912, 89184644, 89184646, 2, 640x360 
0x1382CA98, 37353941434892560, 89184670, 89184676, 6, 640x360 
0x1382CA98, 37353941435211720, 89184697, 89184701, 4, 640x360 
0x1382CA98, 37353941435534512, 89184730, 89184733, 3, 640x360 
0x1382CA98, 37353941435853880, 89184756, 89184759, 3, 640x360 
0x1382CA98, 37353941436170648, 89184787, 89184795, 8, 640x360 
0x1382CA98, 37353941436493024, 89184823, 89184825, 2, 640x360 
0x1382CA98, 37353941436811136, 89184854, 89184861, 7, 640x360 
0x1382CA98, 37353941437132792, 89184886, 89184889, 3, 640x360 
0x1382CA98, 37353941437451072, 89184918, 89184923, 5, 640x360 
0x1382CA98, 37353941437771576, 89184948, 89184953, 5, 640x360 
0x1382CA98, 37353941438095288, 89184988, 89184991, 3, 640x360 
0x1382CA98, 37353941438588640, 89185038, 89185040, 2, 640x360 
0x1382CA98, 37353941438893584, 89185062, 89185071, 9, 640x360 
0x1382CA98, 37353941439210960, 89185095, 89185098, 3, 640x360 
0x1382CA98, 37353941439535680, 89185134, 89185138, 4, 640x360 
0x1382CA98, 37353941439850760, 89185159, 89185165, 6, 640x360 
0x1382CA98, 37353941440174496, 89185197, 89185203, 6, 640x360 
0x1382CA98, 37353941440490568, 89185226, 89185228, 2, 640x360 
0x1382CA98, 37353941440812904, 89185265, 89185270, 5, 640x360 
0x1382CA98, 37353941441139784, 89185287, 89185295, 8, 640x360 
0x1382CA98, 37353941441467232, 89185331, 89185333, 2, 640x360 
0x1382CA98, 37353941441804784, 89185354, 89185361, 7, 640x360 
0x1382CA98, 37353941442097168, 89185390, 89185394, 4, 640x360 
0x1382CA98, 37353941442443568, 89185436, 89185438, 2, 640x360 
0x1382CA98, 37353941442891776, 89185475, 89185478, 3, 640x360 
0x1382CA98, 37353941443214088, 89185506, 89185511, 5, 640x360 
0x1382CA98, 37353941443531064, 89185530, 89185533, 3, 640x360 
0x1382CA98, 37353941443853096, 89185569, 89185572, 3, 640x360 
0x1382CA98, 37353941444170544, 89185598, 89185602, 4, 640x360 
0x1382CA98, 37353941444490640, 89185624, 89185626, 2, 640x360 
0x1382CA98, 37353941444810552, 89185654, 89185660, 6, 640x360 
0x1382CA98, 37353941445136536, 89185701, 89185704, 3, 640x360 
0x1382CA98, 37353941445451400, 89185722, 89185725, 3, 640x360 
0x1382CA98, 37353941445771120, 89185755, 89185757, 2, 640x360 
0x1382CA98, 37353941446094832, 89185791, 89185793, 2, 640x360 
0x1382CA98, 37353941446416280, 89185815, 89185820, 5, 640x360 
0x1382CA98, 37353941446891104, 89185872, 89185874, 2, 640x360 
0x1382CA98, 37353941447215584, 89185898, 89185903, 5, 640x360 
0x1382CA98, 37353941447530984, 89185924, 89185926, 2, 640x360 
0x1382CA98, 37353941447869344, 89185962, 89185968, 6, 640x360 
0x1382CA98, 37353941448170816, 89185993, 89185995, 2, 640x360 
0x1382CA98, 37353941448501560, 89186029, 89186031, 2, 640x360 
0x1382CA98, 37353941448822184, 89186060, 89186062, 2, 640x360 
0x1382CA98, 37353941449135272, 89186092, 89186098, 6, 640x360 
0x1382CA98, 37353941449451840, 89186125, 89186127, 2, 640x360 
0x1382CA98, 37353941449777352, 89186156, 89186164, 8, 640x360 
0x1382CA98, 37353941450101616, 89186191, 89186196, 5, 640x360 
0x1382CA98, 37353941450421672, 89186218, 89186221, 3, 640x360 
0x1382CA98, 37353941450890376, 89186263, 89186266, 3, 640x360 
0x1382CA98, 37353941451215624, 89186294, 89186296, 2, 640x360 
0x1382CA98, 37353941451531256, 89186325, 89186327, 2, 640x360 
0x1382CA98, 37353941451853808, 89186358, 89186362, 4, 640x360 
0x1382CA98, 37353941452184000, 89186395, 89186398, 3, 640x360 
0x1382CA98, 37353941452493960, 89186423, 89186425, 2, 640x360 
0x1382CA98, 37353941452810600, 89186454, 89186460, 6, 640x360 
0x1382CA98, 37353941453131056, 89186491, 89186493, 2, 640x360 
0x1382CA98, 37353941453453528, 89186519, 89186530, 11, 640x360 
0x1382CA98, 37353941453773792, 89186553, 89186560, 7, 640x360 
0x1382CA98, 37353941454094624, 89186585, 89186593, 8, 640x360 
0x1382CA98, 37353941454421704, 89186613, 89186616, 3, 640x360 
0x1382CA98, 37353941454891184, 89186663, 89186666, 3, 640x360 
0x1382CA98, 37353941455214240, 89186702, 89186710, 8, 640x360 
0x1382CA98, 37353941455534392, 89186728, 89186731, 3, 640x360 
0x1382CA98, 37353941455856256, 89186762, 89186764, 2, 640x360 
0x1382CA98, 37353941456172856, 89186797, 89186801, 4, 640x360 
0x1382CA98, 37353941456490296, 89186821, 89186824, 3, 640x360 
0x1382CA98, 37353941456818048, 89186864, 89186870, 6, 640x360 
0x1382CA98, 37353941457130272, 89186894, 89186897, 3, 640x360 
0x1382CA98, 37353941457450520, 89186930, 89186933, 3, 640x360 
0x1382CA98, 37353941457770472, 89186956, 89186958, 2, 640x360 
0x1382CA98, 37353941458091048, 89186987, 89186992, 5, 640x360 
0x1382CA98, 37353941458420176, 89187027, 89187029, 2, 640x360 
0x1382CA98, 37353941458890384, 89187071, 89187074, 3, 640x360 
0x1382CA98, 37353941459240832, 89187097, 89187100, 3, 640x360 
0x1382CA98, 37353941459535600, 89187138, 89187140, 2, 640x360 
0x1382CA98, 37353941459849792, 89187166, 89187170, 4, 640x360 
0x1382CA98, 37353941460170176, 89187190, 89187196, 6, 640x360 
0x1382CA98, 37353941460489912, 89187222, 89187229, 7, 640x360 
0x1382CA98, 37353941460814360, 89187269, 89187295, 26, 640x360 
0x1382CA98, 37353941461136112, 89187309, 89187324, 15, 640x360 
0x1382CA98, 37353941461491120, 89187354, 89187367, 13, 640x360 
0x1382CA98, 37353941461854784, 89187373, 89187385, 12, 640x360 
0x1382CA98, 37353941462092648, 89187424, 89187436, 12, 640x360 
0x1382CA98, 37353941462504944, 89187439, 89187446, 7, 640x360 
0x1382CA98, 37353941462908448, 89187475, 89187483, 8, 640x360 
0x1382CA98, 37353941463233488, 89187508, 89187513, 5, 640x360 
0x1382CA98, 37353941463529888, 89187546, 89187554, 8, 640x360 
0x1382CA98, 37353941463855984, 89187561, 89187563, 2, 640x360 
0x1382CA98, 37353941464169840, 89187598, 89187603, 5, 640x360 
0x1382CA98, 37353941464494288, 89187624, 89187626, 2, 640x360 
0x1382CA98, 37353941464815800, 89187656, 89187659, 3, 640x360 
0x1382CA98, 37353941465132968, 89187690, 89187696, 6, 640x360 
0x1382CA98, 37353941465451320, 89187717, 89187720, 3, 640x360 
0x1382CA98, 37353941465770304, 89187746, 89187749, 3, 640x360 
0x1382CA98, 37353941466091784, 89187783, 89187792, 9, 640x360 
0x1382CA98, 37353941466421160, 89187814, 89187827, 13, 640x360 
0x1382CA98, 37353941466898432, 89187866, 89187875, 9, 640x360 
0x1382CA98, 37353941467214896, 89187892, 89187895, 3, 640x360 
0x1382CA98, 37353941467530696, 89187925, 89187929, 4, 640x360 
0x1382CA98, 37353941467861976, 89187967, 89187972, 5, 640x360 
0x1382CA98, 37353941468169824, 89187991, 89187993, 2, 640x360 
0x1382CA98, 37353941468490488, 89188022, 89188024, 2, 640x360 
0x1382CA98, 37353941468810496, 89188065, 89188069, 4, 640x360 
0x1382CA98, 37353941469130464, 89188088, 89188092, 4, 640x360 
0x1382CA98, 37353941469453072, 89188134, 89188142, 8, 640x360 
0x1382CA98, 37353941469789560, 89188165, 89188170, 5, 640x360 
0x1382CA98, 37353941470094008, 89188192, 89188198, 6, 640x360 
0x1382CA98, 37353941470419472, 89188222, 89188224, 2, 640x360 
0x1382CA98, 37353941470734784, 89188247, 89188253, 6, 640x360 
0x1382CA98, 37353941471213576, 89188295, 89188298, 3, 640x360 
0x1382CA98, 37353941471534640, 89188327, 89188329, 2, 640x360 
0x1382CA98, 37353941471850000, 89188356, 89188362, 6, 640x360 
0x1382CA98, 37353941472169568, 89188393, 89188394, 1, 640x360 
0x1382CA98, 37353941472490048, 89188431, 89188433, 2, 640x360 
0x1382CA98, 37353941472814488, 89188460, 89188467, 7, 640x360 
0x1382CA98, 37353941473129960, 89188490, 89188493, 3, 640x360 
0x1382CA98, 37353941473452272, 89188525, 89188527, 2, 640x360 
0x1382CA98, 37353941473783184, 89188563, 89188566, 3, 640x360 
0x1382CA98, 37353941474098144, 89188601, 89188612, 11, 640x360 
0x1382CA98, 37353941474427024, 89188623, 89188629, 6, 640x360 
0x1382CA98, 37353941474736752, 89188657, 89188659, 2, 640x360 
0x1382CA98, 37353941475209192, 89188701, 89188711, 10, 640x360 
0x1382CA98, 37353941475530456, 89188736, 89188744, 8, 640x360 
0x1382CA98, 37353941475849584, 89188763, 89188766, 3, 640x360 
0x1382CA98, 37353941476169392, 89188796, 89188798, 2, 640x360 
0x1382CA98, 37353941476493712, 89188823, 89188826, 3, 640x360 
0x1382CA98, 37353941476812712, 89188854, 89188857, 3, 640x360 
0x1382CA98, 37353941477129824, 89188890, 89188896, 6, 640x360 
0x1382CA98, 37353941477450600, 89188916, 89188920, 4, 640x360 
0x1382CA98, 37353941477772752, 89188947, 89188950, 3, 640x360 
0x1382CA98, 37353941478090280, 89188978, 89188981, 3, 640x360 
0x1382CA98, 37353941478420856, 89189021, 89189027, 6, 640x360 
0x1382CA98, 37353941478735064, 89189046, 89189051, 5, 640x360 
0x1382CA98, 37353941479209840, 89189103, 89189106, 3, 640x360 
0x1382CA98, 37353941479534704, 89189136, 89189138, 2, 640x360 
0x1382CA98, 37353941479911648, 89189172, 89189175, 3, 640x360 
0x1382CA98, 37353941480169480, 89189192, 89189194, 2, 640x360 
0x1382CA98, 37353941480490344, 89189225, 89189227, 2, 640x360 
0x1382CA98, 37353941480812840, 89189258, 89189260, 2, 640x360 
0x1382CA98, 37353941481145184, 89189289, 89189298, 9, 640x360 
0x1382CA98, 37353941481454336, 89189326, 89189328, 2, 640x360 
0x1382CA98, 37353941481770504, 89189358, 89189365, 7, 640x360 
0x1382CA98, 37353941482096208, 89189390, 89189392, 2, 640x360 
0x1382CA98, 37353941482417008, 89189422, 89189429, 7, 640x360 
0x1382CA98, 37353941482735376, 89189446, 89189449, 3, 640x360 
0x1382CA98, 37353941483209192, 89189495, 89189504, 9, 640x360 
0x1382CA98, 37353941483530224, 89189536, 89189540, 4, 640x360 
0x1382CA98, 37353941483857136, 89189560, 89189574, 14, 640x360 
0x1382CA98, 37353941484174856, 89189596, 89189598, 2, 640x360 
0x1382CA98, 37353941484495312, 89189635, 89189643, 8, 640x360 
0x1382CA98, 37353941484816792, 89189665, 89189668, 3, 640x360 
0x1382CA98, 37353941485130480, 89189695, 89189697, 2, 640x360 
0x1382CA98, 37353941485463288, 89189730, 89189733, 3, 640x360 
0x1382CA98, 37353941485821200, 89189761, 89189763, 2, 640x360 
0x1382CA98, 37353941486097904, 89189812, 89189817, 5, 640x360 
0x1382CA98, 37353941486442968, 89189828, 89189844, 16, 640x360 
0x1382CA98, 37353941486758136, 89189872, 89189878, 6, 640x360 
0x1382CA98, 37353941487258224, 89189910, 89189924, 14, 640x360 
0x1382CA98, 37353941487537528, 89189935, 89189940, 5, 640x360 
0x1382CA98, 37353941487852800, 89189960, 89189963, 3, 640x360 
0x1382CA98, 37353941488169576, 89189991, 89190013, 22, 640x360 
0x1382CA98, 37353941488508120, 89190029, 89190033, 4, 640x360 
0x1382CA98, 37353941488810240, 89190070, 89190073, 3, 640x360 
0x1382CA98, 37353941489139456, 89190095, 89190105, 10, 640x360 
0x1382CA98, 37353941489464712, 89190139, 89190151, 12, 640x360 
0x1382CA98, 37353941489785792, 89190156, 89190160, 4, 640x360 
0x1382CA98, 37353941490131264, 89190195, 89190197, 2, 640x360 
0x1382CA98, 37353941490416688, 89190246, 89190253, 7, 640x360 
0x1382CA98, 37353941490885736, 89190278, 89190283, 5, 640x360 
0x1382CA98, 37353941491227560, 89190309, 89190312, 3, 640x360 
0x1382CA98, 37353941491536592, 89190352, 89190361, 9, 640x360 
0x1382CA98, 37353941491850344, 89190370, 89190372, 2, 640x360 
0x1382CA98, 37353941492174296, 89190391, 89190393, 2, 640x360 
0x1382CA98, 37353941492494456, 89190435, 89190437, 2, 640x360 
0x1382CA98, 37353941492827040, 89190457, 89190460, 3, 640x360 
0x1382CA98, 37353941493148800, 89190492, 89190494, 2, 640x360 
0x1382CA98, 37353941493471304, 89190525, 89190527, 2, 640x360 
0x1382CA98, 37353941493772704, 89190569, 89190573, 4, 640x360 
0x1382CA98, 37353941494114840, 89190592, 89190595, 3, 640x360 
0x1382CA98, 37353941494423824, 89190625, 89190630, 5, 640x360 
0x1382CA98, 37353941494731504, 89190647, 89190650, 3, 640x360 
0x1382CA98, 37353941495050920, 89190685, 89190694, 9, 640x360 
0x1382CA98, 37353941495528880, 89190736, 89190738, 2, 640x360 
0x1382CA98, 37353941495854080, 89190765, 89190768, 3, 640x360 
0x1382CA98, 37353941496174704, 89190798, 89190801, 3, 640x360 
0x1382CA98, 37353941496492568, 89190827, 89190829, 2, 640x360 
0x1382CA98, 37353941496815128, 89190869, 89190871, 2, 640x360 
0x1382CA98, 37353941497128896, 89190897, 89190901, 4, 640x360 
0x1382CA98, 37353941497449720, 89190925, 89190926, 1, 640x360 
0x1382CA98, 37353941497769128, 89190950, 89190961, 11, 640x360 
0x1382CA98, 37353941498089320, 89190980, 89190985, 5, 640x360 
0x1382CA98, 37353941498425632, 89191019, 89191026, 7, 640x360 
0x1382CA98, 37353941498743984, 89191046, 89191050, 4, 640x360 
0x1382CA98, 37353941499049568, 89191086, 89191089, 3, 640x360 
0x1382CA98, 37353941499534128, 89191137, 89191144, 7, 640x360 
0x1382CA98, 37353941499849296, 89191162, 89191166, 4, 640x360 
0x1382CA98, 37353941500170256, 89191197, 89191203, 6, 640x360 
0x1382CA98, 37353941500504016, 89191233, 89191244, 11, 640x360 
0x1382CA98, 37353941500819360, 89191254, 89191261, 7, 640x360 
0x1382CA98, 37353941501135256, 89191302, 89191310, 8, 640x360 
0x1382CA98, 37353941501449776, 89191333, 89191344, 11, 640x360 
0x1382CA98, 37353941501771960, 89191366, 89191377, 11, 640x360 
0x1382CA98, 37353941502113552, 89191398, 89191411, 13, 640x360 
0x1382CA98, 37353941502439776, 89191418, 89191431, 13, 640x360 
0x1382CA98, 37353941502731832, 89191451, 89191454, 3, 640x360 
0x1382CA98, 37353941503059672, 89191478, 89191481, 3, 640x360 
0x1382CA98, 37353941503528880, 89191525, 89191529, 4, 640x360 
0x1382CA98, 37353941503849376, 89191557, 89191560, 3, 640x360 
0x1382CA98, 37353941504173048, 89191589, 89191592, 3, 640x360 
0x1382CA98, 37353941504489600, 89191627, 89191630, 3, 640x360 
0x1382CA98, 37353941504813960, 89191656, 89191659, 3, 640x360 
0x1382CA98, 37353941505129928, 89191691, 89191697, 6, 640x360 
0x1382CA98, 37353941505453944, 89191717, 89191721, 4, 640x360 
0x1382CA98, 37353941505772296, 89191754, 89191761, 7, 640x360 
0x1382CA98, 37353941506089696, 89191783, 89191795, 12, 640x360 
0x1382CA98, 37353941506433552, 89191835, 89191840, 5, 640x360 
0x1382CA98, 37353941506739904, 89191860, 89191862, 2, 640x360 
0x1382CA98, 37353941507050688, 89191883, 89191892, 9, 640x360 
0x1382CA98, 37353941507530936, 89191930, 89191933, 3, 640x360 
0x1382CA98, 37353941507874808, 89191975, 89191980, 5, 640x360 
0x1382CA98, 37353941508174152, 89191998, 89192005, 7, 640x360 
0x1382CA98, 37353941508489952, 89192030, 89192036, 6, 640x360 
0x1382CA98, 37353941508814248, 89192060, 89192066, 6, 640x360 
0x1382CA98, 37353941509141960, 89192089, 89192095, 6, 640x360 
0x1382CA98, 37353941509457312, 89192128, 89192133, 5, 640x360 
0x1382CA98, 37353941509775032, 89192163, 89192167, 4, 640x360 
0x1382CA98, 37353941510097696, 89192203, 89192212, 9, 640x360 
0x1382CA98, 37353941510416616, 89192228, 89192234, 6, 640x360 
0x1382CA98, 37353941510733488, 89192269, 89192285, 16, 640x360 
0x1382CA98, 37353941511051568, 89192298, 89192303, 5, 640x360 
0x1382CA98, 37353941511545904, 89192346, 89192363, 17, 640x360 
0x1382CA98, 37353941511859792, 89192379, 89192408, 29, 640x360 
0x1382CA98, 37353941512184552, 89192418, 89192425, 7, 640x360 
0x1382CA98, 37353941512496296, 89192436, 89192445, 9, 640x360 
0x1382CA98, 37353941512838448, 89192494, 89192506, 12, 640x360 
0x1382CA98, 37353941513138360, 89192508, 89192513, 5, 640x360 
0x1382CA98, 37353941513470088, 89192552, 89192558, 6, 640x360 
0x1382CA98, 37353941513775056, 89192568, 89192574, 6, 640x360 
0x1382CA98, 37353941514115792, 89192591, 89192595, 4, 640x360 
0x1382CA98, 37353941514438384, 89192630, 89192642, 12, 640x360 
0x1382CA98, 37353941514735336, 89192661, 89192677, 16, 640x360 
0x1382CA98, 37353941515093088, 89192709, 89192712, 3, 640x360 
0x1382CA98, 37353941515528792, 89192759, 89192769, 10, 640x360 
0x1382CA98, 37353941515853960, 89192773, 89192785, 12, 640x360 
0x1382CA98, 37353941516212256, 89192823, 89192834, 11, 640x360 
0x1382CA98, 37353941516495720, 89192859, 89192874, 15, 640x360 
0x1382CA98, 37353941516820768, 89192878, 89192903, 25, 640x360 
0x1382CA98, 37353941517166152, 89192906, 89192938, 32, 640x360 
0x1382CA98, 37353941517475496, 89192961, 89192973, 12, 640x360 
0x1382CA98, 37353941517785784, 89192993, 89193003, 10, 640x360 
0x1382CA98, 37353941518440464, 89193039, 89193048, 9, 640x360 
0x1382CA98, 37353941518790400, 89193076, 89193088, 12, 640x360 
0x1382CA98, 37353941519107488, 89193113, 89193122, 9, 640x360 
0x1382CA98, 37353941519582088, 89193162, 89193164, 2, 640x360 
0x1382CA98, 37353941519915848, 89193174, 89193185, 11, 640x360 
0x1382CA98, 37353941520189280, 89193201, 89193212, 11, 640x360 
0x1382CA98, 37353941520507688, 89193231, 89193237, 6, 640x360 
0x1382CA98, 37353941520814176, 89193257, 89193259, 2, 640x360 
0x1382CA98, 37353941521128328, 89193291, 89193297, 6, 640x360 
0x1382CA98, 37353941521450040, 89193317, 89193322, 5, 640x360 
0x1382CA98, 37353941521775296, 89193354, 89193361, 7, 640x360 
0x1382CA98, 37353941522095200, 89193392, 89193396, 4, 640x360 
0x1382CA98, 37353941522437528, 89193430, 89193432, 2, 640x360 
0x1382CA98, 37353941522735904, 89193457, 89193462, 5, 640x360 
0x1382CA98, 37353941523058440, 89193480, 89193483, 3, 640x360 
0x1382CA98, 37353941523371280, 89193514, 89193517, 3, 640x360 
0x1382CA98, 37353941523848120, 89193566, 89193577, 11, 640x360 
0x1382CA98, 37353941524173208, 89193595, 89193596, 1, 640x360 
0x1382CA98, 37353941524489112, 89193623, 89193630, 7, 640x360 
0x1382CA98, 37353941524813808, 89193658, 89193660, 2, 640x360 
0x1382CA98, 37353941525128192, 89193691, 89193692, 1, 640x360 
0x1382CA98, 37353941525461128, 89193732, 89193736, 4, 640x360 
0x1382CA98, 37353941525774264, 89193755, 89193758, 3, 640x360 
0x1382CA98, 37353941526089192, 89193781, 89193799, 18, 640x360 
0x1382CA98, 37353941526419128, 89193814, 89193820, 6, 640x360 
0x1382CA98, 37353941526733248, 89193846, 89193850, 4, 640x360 
0x1382CA98, 37353941527050360, 89193876, 89193878, 2, 640x360 
0x1382CA98, 37353941527368896, 89193911, 89193913, 2, 640x360 
0x1382CA98, 37353941527852528, 89193958, 89193971, 13, 640x360 
0x1382CA98, 37353941528172408, 89193990, 89193993, 3, 640x360 
0x1382CA98, 37353941528492576, 89194029, 89194031, 2, 640x360 
0x1382CA98, 37353941528813136, 89194050, 89194053, 3, 640x360 
0x1382CA98, 37353941529128336, 89194089, 89194092, 3, 640x360 
0x1382CA98, 37353941529452672, 89194122, 89194128, 6, 640x360 
0x1382CA98, 37353941529783416, 89194163, 89194166, 3, 640x360 
0x1382CA98, 37353941530099864, 89194189, 89194196, 7, 640x360 
0x1382CA98, 37353941530414992, 89194218, 89194227, 9, 640x360 
0x1382CA98, 37353941530761048, 89194247, 89194257, 10, 640x360 
0x1382CA98, 37353941531060336, 89194289, 89194291, 2, 640x360 
0x1382CA98, 37353941531372584, 89194310, 89194312, 2, 640x360 
0x1382CA98, 37353941531848816, 89194363, 89194366, 3, 640x360 
0x1382CA98, 37353941532168368, 89194403, 89194405, 2, 640x360 
0x1382CA98, 37353941532488384, 89194422, 89194425, 3, 640x360 
0x1382CA98, 37353941532808232, 89194458, 89194461, 3, 640x360 
0x1382CA98, 37353941533134376, 89194496, 89194503, 7, 640x360 
0x1382CA98, 37353941533448192, 89194518, 89194522, 4, 640x360 
0x1382CA98, 37353941533768112, 89194548, 89194553, 5, 640x360 
0x1382CA98, 37353941534090592, 89194588, 89194592, 4, 640x360 
0x1382CA98, 37353941534409528, 89194614, 89194620, 6, 640x360 
0x1382CA98, 37353941534729432, 89194645, 89194648, 3, 640x360 
0x1382CA98, 37353941535056224, 89194677, 89194680, 3, 640x360 
0x1382CA98, 37353941535368264, 89194719, 89194722, 3, 640x360 
0x1382CA98, 37353941535853080, 89194760, 89194763, 3, 640x360 
0x1382CA98, 37353941536171440, 89194803, 89194805, 2, 640x360 
0x1382CA98, 37353941536491768, 89194832, 89194843, 11, 640x360 
0x1382CA98, 37353941536817472, 89194862, 89194865, 3, 640x360 
0x1382CA98, 37353941537133640, 89194890, 89194898, 8, 640x360 
0x1382CA98, 37353941537448328, 89194928, 89194932, 4, 640x360 
0x1382CA98, 37353941537768192, 89194962, 89194965, 3, 640x360 
0x1382CA98, 37353941538092048, 89194987, 89194989, 2, 640x360 
0x1382CA98, 37353941538415832, 89195022, 89195024, 2, 640x360 
0x1382CA98, 37353941538729024, 89195045, 89195051, 6, 640x360 
0x1382CA98, 37353941539057192, 89195084, 89195090, 6, 640x360 
0x1382CA98, 37353941539372296, 89195112, 89195115, 3, 640x360 
0x1382CA98, 37353941539852888, 89195165, 89195169, 4, 640x360 
0x1382CA98, 37353941540168416, 89195197, 89195202, 5, 640x360 
0x1382CA98, 37353941540489864, 89195224, 89195226, 2, 640x360 
0x1382CA98, 37353941540808512, 89195262, 89195274, 12, 640x360 
0x1382CA98, 37353941541135008, 89195300, 89195302, 2, 640x360 
0x1382CA98, 37353941541448496, 89195321, 89195323, 2, 640x360 
0x1382CA98, 37353941541769808, 89195361, 89195364, 3, 640x360 
0x1382CA98, 37353941542088880, 89195386, 89195388, 2, 640x360 
0x1382CA98, 37353941542409376, 89195419, 89195421, 2, 640x360 
0x1382CA98, 37353941542728992, 89195450, 89195454, 4, 640x360 
0x1382CA98, 37353941543056016, 89195478, 89195482, 4, 640x360 
0x1382CA98, 37353941543368128, 89195511, 89195514, 3, 640x360 
0x1382CA98, 37353941543854584, 89195570, 89195572, 2, 640x360 
0x1382CA98, 37353941544167664, 89195608, 89195618, 10, 640x360 
0x1382CA98, 37353941544504824, 89195642, 89195644, 2, 640x360 
0x1382CA98, 37353941544814336, 89195657, 89195665, 8, 640x360 
0x1382CA98, 37353941545131008, 89195689, 89195691, 2, 640x360 
0x1382CA98, 37353941545447512, 89195722, 89195728, 6, 640x360 
0x1382CA98, 37353941545767992, 89195761, 89195763, 2, 640x360 
0x1382CA98, 37353941546088920, 89195782, 89195795, 13, 640x360 
0x1382CA98, 37353941546417232, 89195821, 89195828, 7, 640x360 
0x1382CA98, 37353941546732680, 89195853, 89195861, 8, 640x360 
0x1382CA98, 37353941547049216, 89195885, 89195888, 3, 640x360 
0x1382CA98, 37353941547368176, 89195918, 89195925, 7, 640x360 
0x1382CA98, 37353941547847800, 89195970, 89195973, 3, 640x360 
0x1382CA98, 37353941548167928, 89196003, 89196005, 2, 640x360 
0x1382CA98, 37353941548487496, 89196020, 89196023, 3, 640x360 
0x1382CA98, 37353941548813296, 89196056, 89196058, 2, 640x360 
0x1382CA98, 37353941549127944, 89196090, 89196093, 3, 640x360 
0x1382CA98, 37353941549447416, 89196125, 89196127, 2, 640x360 
0x1382CA98, 37353941549770672, 89196162, 89196172, 10, 640x360 
0x1382CA98, 37353941550113736, 89196189, 89196198, 9, 640x360 
0x1382CA98, 37353941550458088, 89196225, 89196245, 20, 640x360 
0x1382CA98, 37353941550767064, 89196256, 89196259, 3, 640x360 
0x1382CA98, 37353941551058632, 89196280, 89196283, 3, 640x360 
0x1382CA98, 37353941551368336, 89196311, 89196312, 1, 640x360 
0x1382CA98, 37353941551693280, 89196343, 89196345, 2, 640x360 
0x1382CA98, 37353941552172408, 89196390, 89196395, 5, 640x360 
0x1382CA98, 37353941552487696, 89196423, 89196436, 13, 640x360 
0x1382CA98, 37353941552809128, 89196455, 89196464, 9, 640x360 
0x1382CA98, 37353941553131416, 89196500, 89196504, 4, 640x360 
0x1382CA98, 37353941553448648, 89196520, 89196523, 3, 640x360 
0x1382CA98, 37353941553771768, 89196553, 89196561, 8, 640x360 
0x1382CA98, 37353941554090592, 89196586, 89196596, 10, 640x360 
0x1382CA98, 37353941554417552, 89196613, 89196617, 4, 640x360 
0x1382CA98, 37353941554736272, 89196644, 89196646, 2, 640x360 
0x1382CA98, 37353941555049104, 89196675, 89196678, 3, 640x360 
0x1382CA98, 37353941555371336, 89196710, 89196712, 2, 640x360 
0x1382CA98, 37353941555691696, 89196745, 89196746, 1, 640x360 
0x1382CA98, 37353941556168160, 89196794, 89196797, 3, 640x360 
0x1382CA98, 37353941556487672, 89196822, 89196825, 3, 640x360 
0x1382CA98, 37353941556807984, 89196859, 89196865, 6, 640x360 
0x1382CA98, 37353941557128664, 89196892, 89196895, 3, 640x360 
0x1382CA98, 37353941557453192, 89196922, 89196930, 8, 640x360 
0x1382CA98, 37353941557770472, 89196955, 89196963, 8, 640x360 
0x1382CA98, 37353941558098824, 89196998, 89197002, 4, 640x360 
0x1382CA98, 37353941558438880, 89197023, 89197026, 3, 640x360 
0x1382CA98, 37353941558735816, 89197047, 89197050, 3, 640x360 
0x1382CA98, 37353941559048928, 89197078, 89197080, 2, 640x360 
0x1382CA98, 37353941559371888, 89197110, 89197112, 2, 640x360 
0x1382CA98, 37353941559693552, 89197146, 89197148, 2, 640x360 
0x1382CA98, 37353941560167928, 89197188, 89197194, 6, 640x360 
0x1382CA98, 37353941560488192, 89197223, 89197231, 8, 640x360 
0x1382CA98, 37353941560807400, 89197255, 89197267, 12, 640x360 
0x1382CA98, 37353941561132304, 89197289, 89197292, 3, 640x360 
0x1382CA98, 37353941561447952, 89197314, 89197321, 7, 640x360 
0x1382CA98, 37353941561768520, 89197346, 89197351, 5, 640x360 
0x1382CA98, 37353941562089264, 89197377, 89197379, 2, 640x360 
0x1382CA98, 37353941562415736, 89197416, 89197423, 7, 640x360 
0x1382CA98, 37353941562739288, 89197449, 89197454, 5, 640x360 
0x1382CA98, 37353941563054000, 89197480, 89197483, 3, 640x360 
0x1382CA98, 37353941563377016, 89197513, 89197515, 2, 640x360 
0x1382CA98, 37353941563693400, 89197546, 89197550, 4, 640x360 
0x1382CA98, 37353941564191312, 89197597, 89197600, 3, 640x360 
0x1382CA98, 37353941564505008, 89197623, 89197626, 3, 640x360 
0x1382CA98, 37353941564822384, 89197654, 89197662, 8, 640x360 
0x1382CA98, 37353941565132808, 89197705, 89197712, 7, 640x360 
0x1382CA98, 37353941565448632, 89197725, 89197727, 2, 640x360 
0x1382CA98, 37353941565770944, 89197746, 89197752, 6, 640x360 
0x1382CA98, 37353941566087128, 89197780, 89197783, 3, 640x360 
0x1382CA98, 37353941566409432, 89197818, 89197826, 8, 640x360 
0x1382CA98, 37353941566727800, 89197849, 89197858, 9, 640x360 
0x1382CA98, 37353941567047576, 89197881, 89197886, 5, 640x360 
0x1382CA98, 37353941567368152, 89197908, 89197910, 2, 640x360 
0x1382CA98, 37353941567687536, 89197941, 89197943, 2, 640x360 
0x1382CA98, 37353941568174024, 89198002, 89198005, 3, 640x360 
0x1382CA98, 37353941568487792, 89198021, 89198029, 8, 640x360 
0x1382CA98, 37353941568815624, 89198054, 89198062, 8, 640x360 
0x1382CA98, 37353941569138672, 89198092, 89198101, 9, 640x360 
0x1382CA98, 37353941569448728, 89198125, 89198127, 2, 640x360 
0x1382CA98, 37353941569773064, 89198160, 89198162, 2, 640x360 
0x1382CA98, 37353941570092728, 89198193, 89198195, 2, 640x360 
0x1382CA98, 37353941570414528, 89198217, 89198223, 6, 640x360 
0x1382CA98, 37353941570741720, 89198270, 89198288, 18, 640x360 
0x1382CA98, 37353941571063432, 89198288, 89198305, 17, 640x360 
0x1382CA98, 37353941571379992, 89198324, 89198326, 2, 640x360 
0x1382CA98, 37353941571687360, 89198345, 89198348, 3, 640x360 
0x1382CA98, 37353941572180216, 89198396, 89198403, 7, 640x360 
0x1382CA98, 37353941572489816, 89198422, 89198425, 3, 640x360 
0x1382CA98, 37353941572816296, 89198463, 89198466, 3, 640x360 
0x1382CA98, 37353941573133312, 89198491, 89198492, 1, 640x360 
0x1382CA98, 37353941573447960, 89198525, 89198532, 7, 640x360 
0x1382CA98, 37353941573767056, 89198563, 89198571, 8, 640x360 
0x1382CA98, 37353941574098520, 89198585, 89198593, 8, 640x360 
0x1382CA98, 37353941574416608, 89198618, 89198627, 9, 640x360 
0x1382CA98, 37353941574733664, 89198646, 89198650, 4, 640x360 
0x1382CA98, 37353941575051128, 89198679, 89198684, 5, 640x360 
0x1382CA98, 37353941575371608, 89198711, 89198714, 3, 640x360 
0x1382CA98, 37353941575687856, 89198749, 89198760, 11, 640x360 
0x1382CA98, 37353941576008224, 89198785, 89198794, 9, 640x360 
0x1382CA98, 37353941576492080, 89198830, 89198837, 7, 640x360 
0x1382CA98, 37353941576809344, 89198868, 89198877, 9, 640x360 
0x1382CA98, 37353941577130000, 89198903, 89198912, 9, 640x360 
0x1382CA98, 37353941577455056, 89198938, 89198940, 2, 640x360 
0x1382CA98, 37353941577775160, 89198957, 89198960, 3, 640x360 
0x1382CA98, 37353941578112992, 89198996, 89199002, 6, 640x360 
0x1382CA98, 37353941578425632, 89199025, 89199036, 11, 640x360 
0x1382CA98, 37353941578746576, 89199069, 89199072, 3, 640x360 
0x1382CA98, 37353941579053800, 89199092, 89199118, 26, 640x360 
0x1382CA98, 37353941579369184, 89199128, 89199145, 17, 640x360 
0x1382CA98, 37353941579703328, 89199163, 89199168, 5, 640x360 
0x1382CA98, 37353941580041944, 89199206, 89199211, 5, 640x360 
0x1382CA98, 37353941580490544, 89199238, 89199251, 13, 640x360 
0x1382CA98, 37353941580856064, 89199278, 89199285, 7, 640x360 
0x1382CA98, 37353941581163552, 89199312, 89199314, 2, 640x360 
0x1382CA98, 37353941581450416, 89199338, 89199346, 8, 640x360 
0x1382CA98, 37353941581779480, 89199363, 89199377, 14, 640x360 
0x1382CA98, 37353941582105520, 89199392, 89199394, 2, 640x360 
0x1382CA98, 37353941582411856, 89199421, 89199424, 3, 640x360 
0x1382CA98, 37353941582755064, 89199458, 89199461, 3, 640x360 
0x1382CA98, 37353941583047280, 89199479, 89199488, 9, 640x360 
0x1382CA98, 37353941583366824, 89199511, 89199512, 1, 640x360 
0x1382CA98, 37353941583690920, 89199547, 89199550, 3, 640x360 
0x1382CA98, 37353941584013336, 89199578, 89199580, 2, 640x360 
0x1382CA98, 37353941584490720, 89199632, 89199636, 4, 640x360 
0x1382CA98, 37353941584807624, 89199660, 89199663, 3, 640x360 
0x1382CA98, 37353941585133616, 89199696, 89199699, 3, 640x360 
0x1382CA98, 37353941585447360, 89199724, 89199726, 2, 640x360 
0x1382CA98, 37353941585766648, 89199763, 89199765, 2, 640x360 
0x1382CA98, 37353941586089392, 89199790, 89199796, 6, 640x360 
0x1382CA98, 37353941586416152, 89199820, 89199822, 2, 640x360 
0x1382CA98, 37353941586733208, 89199858, 89199860, 2, 640x360 
0x1382CA98, 37353941587047056, 89199882, 89199887, 5, 640x360 
0x1382CA98, 37353941587370760, 89199913, 89199915, 2, 640x360 
0x1382CA98, 37353941587696320, 89199946, 89199952, 6, 640x360 
0x1382CA98, 37353941588012464, 89199977, 89199979, 2, 640x360 
0x1382CA98, 37353941588489912, 89200030, 89200033, 3, 640x360 
0x1382CA98, 37353941588823112, 89200063, 89200065, 2, 640x360 
0x1382CA98, 37353941589134032, 89200102, 89200105, 3, 640x360 
0x1382CA98, 37353941589448800, 89200131, 89200151, 20, 640x360 
0x1382CA98, 37353941589777736, 89200174, 89200183, 9, 640x360 
0x1382CA98, 37353941590113424, 89200196, 89200213, 17, 640x360 
0x1382CA98, 37353941590440976, 89200241, 89200255, 14, 640x360 
0x1382CA98, 37353941590772904, 89200275, 89200284, 9, 640x360 
0x1382CA98, 37353941591079992, 89200297, 89200308, 11, 640x360 
0x1382CA98, 37353941591414064, 89200339, 89200350, 11, 640x360 
0x1382CA98, 37353941591738888, 89200371, 89200376, 5, 640x360 
0x1382CA98, 37353941592011688, 89200384, 89200390, 6, 640x360 
0x1382CA98, 37353941592491168, 89200427, 89200441, 14, 640x360 
0x1382CA98, 37353941592811624, 89200460, 89200464, 4, 640x360 
0x1382CA98, 37353941593129920, 89200506, 89200515, 9, 640x360 
0x1382CA98, 37353941593454600, 89200530, 89200538, 8, 640x360 
0x1382CA98, 37353941593774504, 89200552, 89200563, 11, 640x360 
0x1382CA98, 37353941594091816, 89200597, 89200602, 5, 640x360 
0x1382CA98, 37353941594416192, 89200619, 89200622, 3, 640x360 
0x1382CA98, 37353941594729968, 89200651, 89200655, 4, 640x360 
0x1382CA98, 37353941595051200, 89200682, 89200686, 4, 640x360 
0x1382CA98, 37353941595372048, 89200714, 89200717, 3, 640x360 
0x1382CA98, 37353941595693616, 89200753, 89200765, 12, 640x360 
0x1382CA98, 37353941596016408, 89200789, 89200797, 8, 640x360 
0x1382CA98, 37353941596489928, 89200829, 89200832, 3, 640x360 
0x1382CA98, 37353941596824192, 89200858, 89200859, 1, 640x360 
0x1382CA98, 37353941597126360, 89200890, 89200892, 2, 640x360 
0x1382CA98, 37353941597446176, 89200922, 89200925, 3, 640x360 
0x1382CA98, 37353941597768456, 89200950, 89200959, 9, 640x360 
0x1382CA98, 37353941598087664, 89200983, 89200986, 3, 640x360 
0x1382CA98, 37353941598410264, 89201014, 89201019, 5, 640x360 
0x1382CA98, 37353941598731968, 89201045, 89201048, 3, 640x360 
0x1382CA98, 37353941599053208, 89201076, 89201078, 2, 640x360 
0x1382CA98, 37353941599367432, 89201114, 89201116, 2, 640x360 
0x1382CA98, 37353941599690504, 89201148, 89201151, 3, 640x360 
0x1382CA98, 37353941600007088, 89201174, 89201176, 2, 640x360 
0x1382CA98, 37353941600487200, 89201220, 89201222, 2, 640x360 
0x1382CA98, 37353941600806464, 89201251, 89201254, 3, 640x360 
0x1382CA98, 37353941601126968, 89201285, 89201289, 4, 640x360 
0x1382CA98, 37353941601446984, 89201318, 89201327, 9, 640x360 
0x1382CA98, 37353941601766640, 89201362, 89201364, 2, 640x360 
0x1382CA98, 37353941602087832, 89201380, 89201384, 4, 640x360 
0x1382CA98, 37353941602415944, 89201412, 89201415, 3, 640x360 
0x1382CA98, 37353941602732312, 89201445, 89201447, 2, 640x360 
0x1382CA98, 37353941603047856, 89201486, 89201489, 3, 640x360 
0x1382CA98, 37353941603370728, 89201509, 89201512, 3, 640x360 
0x1382CA98, 37353941603694776, 89201543, 89201545, 2, 640x360 
0x1382CA98, 37353941604006752, 89201580, 89201583, 3, 640x360 
0x1382CA98, 37353941604327176, 89201607, 89201610, 3, 640x360 
0x1382CA98, 37353941604806512, 89201654, 89201661, 7, 640x360 
0x1382CA98, 37353941605127008, 89201685, 89201689, 4, 640x360 
0x1382CA98, 37353941605446776, 89201715, 89201718, 3, 640x360 
0x1382CA98, 37353941605766704, 89201746, 89201752, 6, 640x360 
0x1382CA98, 37353941606087392, 89201791, 89201794, 3, 640x360 
0x1382CA98, 37353941606421304, 89201813, 89201817, 4, 640x360 
0x1382CA98, 37353941606751432, 89201861, 89201874, 13, 640x360 
0x1382CA98, 37353941607048152, 89201881, 89201895, 14, 640x360 
0x1382CA98, 37353941607366360, 89201916, 89201921, 5, 640x360 
0x1382CA98, 37353941607690648, 89201947, 89201950, 3, 640x360 
0x1382CA98, 37353941608021680, 89201978, 89201980, 2, 640x360 
0x1382CA98, 37353941608326848, 89202011, 89202012, 1, 640x360 
0x1382CA98, 37353941608806088, 89202061, 89202063, 2, 640x360 
0x1382CA98, 37353941609126504, 89202092, 89202094, 2, 640x360 
0x1382CA98, 37353941609446448, 89202125, 89202129, 4, 640x360 
0x1382CA98, 37353941609766312, 89202163, 89202165, 2, 640x360 
0x1382CA98, 37353941610088704, 89202189, 89202192, 3, 640x360 
0x1382CA98, 37353941610416928, 89202226, 89202227, 1, 640x360 
0x1382CA98, 37353941610731256, 89202257, 89202260, 3, 640x360 
0x1382CA98, 37353941611051304, 89202281, 89202283, 2, 640x360 
0x1382CA98, 37353941611370024, 89202317, 89202327, 10, 640x360 
0x1382CA98, 37353941611698576, 89202351, 89202362, 11, 640x360 
0x1382CA98, 37353941612013200, 89202384, 89202394, 10, 640x360 
0x1382CA98, 37353941612339824, 89202415, 89202420, 5, 640x360 
0x1382CA98, 37353941612838904, 89202470, 89202479, 9, 640x360 
0x1382CA98, 37353941613125576, 89202491, 89202500, 9, 640x360 
0x1382CA98, 37353941613445792, 89202526, 89202529, 3, 640x360 
0x1382CA98, 37353941613767064, 89202550, 89202556, 6, 640x360 
0x1382CA98, 37353941614087464, 89202582, 89202595, 13, 640x360 
0x1382CA98, 37353941614411224, 89202615, 89202622, 7, 640x360 
0x1382CA98, 37353941614745248, 89202664, 89202668, 4, 640x360 
0x1382CA98, 37353941615060984, 89202688, 89202691, 3, 640x360 
0x1382CA98, 37353941615366504, 89202713, 89202715, 2, 640x360 
0x1382CA98, 37353941615689784, 89202749, 89202759, 10, 640x360 
0x1382CA98, 37353941616007072, 89202781, 89202784, 3, 640x360 
0x1382CA98, 37353941616326592, 89202807, 89202812, 5, 640x360 
0x1382CA98, 37353941616817144, 89202867, 89202876, 9, 640x360 
0x1382CA98, 37353941617126928, 89202896, 89202898, 2, 640x360 
0x1382CA98, 37353941617450720, 89202920, 89202928, 8, 640x360 
0x1382CA98, 37353941617768984, 89202967, 89202978, 11, 640x360 
0x1382CA98, 37353941618100672, 89203002, 89203013, 11, 640x360 
0x1382CA98, 37353941618416392, 89203024, 89203029, 5, 640x360 
0x1382CA98, 37353941618727760, 89203055, 89203057, 2, 640x360 
0x1382CA98, 37353941619045888, 89203079, 89203081, 2, 640x360 
0x1382CA98, 37353941619369768, 89203119, 89203121, 2, 640x360 
0x1382CA98, 37353941619686824, 89203143, 89203146, 3, 640x360 
0x1382CA98, 37353941620018312, 89203188, 89203199, 11, 640x360 
0x1382CA98, 37353941620334248, 89203220, 89203223, 3, 640x360 
0x1382CA98, 37353941620805904, 89203258, 89203266, 8, 640x360 
0x1382CA98, 37353941621129536, 89203282, 89203295, 13, 640x360 
0x1382CA98, 37353941621445544, 89203319, 89203326, 7, 640x360 
0x1382CA98, 37353941621766056, 89203353, 89203360, 7, 640x360 
0x1382CA98, 37353941622085680, 89203386, 89203393, 7, 640x360 
0x1382CA98, 37353941622419560, 89203414, 89203418, 4, 640x360 
0x1382CA98, 37353941622733216, 89203453, 89203459, 6, 640x360 
0x1382CA98, 37353941623051248, 89203480, 89203483, 3, 640x360 
0x1382CA98, 37353941623366504, 89203509, 89203511, 2, 640x360 
0x1382CA98, 37353941623689808, 89203551, 89203555, 4, 640x360 
0x1382CA98, 37353941624022832, 89203577, 89203579, 2, 640x360 
0x1382CA98, 37353941624327208, 89203615, 89203621, 6, 640x360 
0x1382CA98, 37353941624805328, 89203662, 89203664, 2, 640x360 
0x1382CA98, 37353941625125640, 89203691, 89203693, 2, 640x360 
0x1382CA98, 37353941625448440, 89203725, 89203736, 11, 640x360 
0x1382CA98, 37353941625770024, 89203750, 89203762, 12, 640x360 
0x1382CA98, 37353941626096728, 89203789, 89203796, 7, 640x360 
0x1382CA98, 37353941626423216, 89203820, 89203827, 7, 640x360 
0x1382CA98, 37353941626731632, 89203850, 89203860, 10, 640x360 
0x1382CA98, 37353941627051104, 89203879, 89203883, 4, 640x360 
0x1382CA98, 37353941627366144, 89203911, 89203914, 3, 640x360 
0x1382CA98, 37353941627709632, 89203949, 89203955, 6, 640x360 
0x1382CA98, 37353941628008560, 89203987, 89203996, 9, 640x360 
0x1382CA98, 37353941628337288, 89204020, 89204023, 3, 640x360 
0x1382CA98, 37353941628805600, 89204060, 89204066, 6, 640x360 
0x1382CA98, 37353941629125024, 89204091, 89204096, 5, 640x360 
0x1382CA98, 37353941629445688, 89204120, 89204127, 7, 640x360 
0x1382CA98, 37353941629765272, 89204152, 89204160, 8, 640x360 
0x1382CA98, 37353941630089928, 89204179, 89204183, 4, 640x360 
0x1382CA98, 37353941630416384, 89204214, 89204221, 7, 640x360 
0x1382CA98, 37353941630738936, 89204246, 89204250, 4, 640x360 
0x1382CA98, 37353941631045408, 89204284, 89204294, 10, 640x360 
0x1382CA98, 37353941631369376, 89204314, 89204319, 5, 640x360 
0x1382CA98, 37353941631693024, 89204353, 89204355, 2, 640x360 
0x1382CA98, 37353941632009248, 89204382, 89204386, 4, 640x360 
0x1382CA98, 37353941632329736, 89204407, 89204415, 8, 640x360 
0x1382CA98, 37353941632645760, 89204441, 89204448, 7, 640x360 
0x1382CA98, 37353941633129960, 89204487, 89204490, 3, 640x360 
0x1382CA98, 37353941633446176, 89204516, 89204519, 3, 640x360 
0x1382CA98, 37353941633765568, 89204550, 89204556, 6, 640x360 
0x1382CA98, 37353941634090864, 89204581, 89204588, 7, 640x360 
0x1382CA98, 37353941634465800, 89204628, 89204634, 6, 640x360 
0x1382CA98, 37353941634744216, 89204658, 89204664, 6, 640x360 
0x1382CA98, 37353941635048200, 89204697, 89204704, 7, 640x360 
0x1382CA98, 37353941635367176, 89204722, 89204724, 2, 640x360 
0x1382CA98, 37353941635691096, 89204758, 89204769, 11, 640x360 
0x1382CA98, 37353941636037080, 89204783, 89204791, 8, 640x360 
0x1382CA98, 37353941636332024, 89204818, 89204828, 10, 640x360 
0x1382CA98, 37353941636650128, 89204841, 89204845, 4, 640x360 
0x1382CA98, 37353941637124840, 89204894, 89204896, 2, 640x360 
0x1382CA98, 37353941637445504, 89204921, 89204930, 9, 640x360 
0x1382CA98, 37353941637765264, 89204954, 89204962, 8, 640x360 
0x1382CA98, 37353941638091112, 89204987, 89204997, 10, 640x360 
0x1382CA98, 37353941638409392, 89205014, 89205018, 4, 640x360 
0x1382CA98, 37353941638747464, 89205053, 89205056, 3, 640x360 
0x1382CA98, 37353941639045296, 89205089, 89205095, 6, 640x360 
0x1382CA98, 37353941639369296, 89205112, 89205114, 2, 640x360 
0x1382CA98, 37353941639688952, 89205148, 89205151, 3, 640x360 
0x1382CA98, 37353941640007232, 89205173, 89205178, 5, 640x360 
0x1382CA98, 37353941640329968, 89205207, 89205210, 3, 640x360 
0x1382CA98, 37353941640658416, 89205240, 89205242, 2, 640x360 
0x1382CA98, 37353941641129008, 89205285, 89205295, 10, 640x360 
0x1382CA98, 37353941641444904, 89205319, 89205326, 7, 640x360 
0x1382CA98, 37353941641769624, 89205345, 89205347, 2, 640x360 
0x1382CA98, 37353941642089784, 89205378, 89205381, 3, 640x360 
0x1382CA98, 37353941642414392, 89205412, 89205415, 3, 640x360 
0x1382CA98, 37353941642729304, 89205447, 89205452, 5, 640x360 
0x1382CA98, 37353941643046432, 89205476, 89205479, 3, 640x360 
0x1382CA98, 37353941643365424, 89205510, 89205513, 3, 640x360 
0x1382CA98, 37353941643686056, 89205553, 89205555, 2, 640x360 
0x1382CA98, 37353941644010888, 89205577, 89205584, 7, 640x360 
0x1382CA98, 37353941644330248, 89205617, 89205623, 6, 640x360 
0x1382CA98, 37353941644657736, 89205642, 89205645, 3, 640x360 
0x1382CA98, 37353941645125696, 89205684, 89205691, 7, 640x360 
0x1382CA98, 37353941645445360, 89205716, 89205724, 8, 640x360 
0x1382CA98, 37353941645769856, 89205751, 89205755, 4, 640x360 
0x1382CA98, 37353941646089736, 89205782, 89205795, 13, 640x360 
0x1382CA98, 37353941646410216, 89205822, 89205829, 7, 640x360 
0x1382CA98, 37353941646725896, 89205855, 89205858, 3, 640x360 
0x1382CA98, 37353941647045136, 89205886, 89205889, 3, 640x360 
0x1382CA98, 37353941647370168, 89205922, 89205926, 4, 640x360 
0x1382CA98, 37353941647700248, 89205965, 89205981, 16, 640x360 
0x1382CA98, 37353941648040664, 89206021, 89206026, 5, 640x360 
0x1382CA98, 37353941648647296, 89206045, 89206053, 8, 640x360 
0x1382CA98, 37353941649125544, 89206100, 89206114, 14, 640x360 
0x1382CA98, 37353941649451568, 89206139, 89206144, 5, 640x360 
0x1382CA98, 37353941649783856, 89206165, 89206186, 21, 640x360 
0x1382CA98, 37353941650109728, 89206198, 89206204, 6, 640x360 
0x1382CA98, 37353941650418608, 89206234, 89206244, 10, 640x360 
0x1382CA98, 37353941650727968, 89206257, 89206259, 2, 640x360 
0x1382CA98, 37353941651044968, 89206282, 89206286, 4, 640x360 
0x1382CA98, 37353941651369768, 89206307, 89206310, 3, 640x360 
0x1382CA98, 37353941651685688, 89206347, 89206350, 3, 640x360 
0x1382CA98, 37353941652009968, 89206378, 89206380, 2, 640x360 
0x1382CA98, 37353941652325872, 89206406, 89206409, 3, 640x360 
0x1382CA98, 37353941652654368, 89206440, 89206443, 3, 640x360 
0x1382CA98, 37353941653135848, 89206487, 89206491, 4, 640x360 
0x1382CA98, 37353941653449880, 89206523, 89206525, 2, 640x360 
0x1382CA98, 37353941653765456, 89206563, 89206565, 2, 640x360 
0x1382CA98, 37353941654089280, 89206580, 89206584, 4, 640x360 
0x1382CA98, 37353941654409792, 89206619, 89206622, 3, 640x360 
0x1382CA98, 37353941654725768, 89206645, 89206647, 2, 640x360 
0x1382CA98, 37353941655047320, 89206678, 89206681, 3, 640x360 
0x1382CA98, 37353941655369504, 89206710, 89206718, 8, 640x360 
0x1382CA98, 37353941655690904, 89206748, 89206754, 6, 640x360 
0x1382CA98, 37353941656024984, 89206777, 89206787, 10, 640x360 
0x1382CA98, 37353941656325160, 89206815, 89206822, 7, 640x360 
0x1382CA98, 37353941656651568, 89206846, 89206852, 6, 640x360 
0x1382CA98, 37353941657126952, 89206892, 89206900, 8, 640x360 
0x1382CA98, 37353941657444544, 89206916, 89206921, 5, 640x360 
0x1382CA98, 37353941657770752, 89206953, 89206959, 6, 640x360 
0x1382CA98, 37353941658084928, 89206984, 89207004, 20, 640x360 
0x1382CA98, 37353941658485448, 89207027, 89207029, 2, 640x360 
0x1382CA98, 37353941658744728, 89207058, 89207068, 10, 640x360 
0x1382CA98, 37353941659052400, 89207089, 89207092, 3, 640x360 
0x1382CA98, 37353941659381928, 89207120, 89207122, 2, 640x360 
0x1382CA98, 37353941659685320, 89207151, 89207154, 3, 640x360 
0x1382CA98, 37353941660028296, 89207187, 89207199, 12, 640x360 
0x1382CA98, 37353941660334392, 89207220, 89207222, 2, 640x360 
0x1382CA98, 37353941660646960, 89207240, 89207243, 3, 640x360 
0x1382CA98, 37353941660965176, 89207285, 89207289, 4, 640x360 
0x1382CA98, 37353941661449472, 89207325, 89207327, 2, 640x360 
0x1382CA98, 37353941661764664, 89207357, 89207359, 2, 640x360 
0x1382CA98, 37353941662089368, 89207384, 89207391, 7, 640x360 
0x1382CA98, 37353941662410640, 89207417, 89207427, 10, 640x360 
0x1382CA98, 37353941662749480, 89207457, 89207462, 5, 640x360 
0x1382CA98, 37353941663048408, 89207488, 89207491, 3, 640x360 
0x1382CA98, 37353941663365184, 89207518, 89207521, 3, 640x360 
0x1382CA98, 37353941663687840, 89207542, 89207545, 3, 640x360 
0x1382CA98, 37353941664008184, 89207580, 89207583, 3, 640x360 
0x1382CA98, 37353941664329232, 89207608, 89207614, 6, 640x360 
0x1382CA98, 37353941664645648, 89207641, 89207649, 8, 640x360 
0x1382CA98, 37353941664964816, 89207675, 89207680, 5, 640x360 
0x1382CA98, 37353941665449448, 89207716, 89207721, 5, 640x360 
0x1382CA98, 37353941665764424, 89207761, 89207794, 33, 640x360 
0x1382CA98, 37353941666129312, 89207844, 89207857, 13, 640x360 
0x1382CA98, 37353941666729736, 89207857, 89207863, 6, 640x360 
0x1382CA98, 37353941667045024, 89207889, 89207891, 2, 640x360 
0x1382CA98, 37353941667364400, 89207909, 89207912, 3, 640x360 
0x1382CA98, 37353941667688472, 89207953, 89207955, 2, 640x360 
0x1382CA98, 37353941668009056, 89207975, 89207983, 8, 640x360 
0x1382CA98, 37353941668324624, 89208006, 89208007, 1, 640x360 
0x1382CA98, 37353941668644656, 89208038, 89208040, 2, 640x360 
0x1382CA98, 37353941668968176, 89208069, 89208072, 3, 640x360 
0x1382CA98, 37353941669444792, 89208115, 89208122, 7, 640x360 
0x1382CA98, 37353941669768024, 89208151, 89208155, 4, 640x360 
0x1382CA98, 37353941670084456, 89208187, 89208190, 3, 640x360 
0x1382CA98, 37353941670420832, 89208220, 89208222, 2, 640x360 
0x1382CA98, 37353941670725824, 89208251, 89208253, 2, 640x360 
0x1382CA98, 37353941671045600, 89208288, 89208291, 3, 640x360 
0x1382CA98, 37353941671364808, 89208312, 89208314, 2, 640x360 
0x1382CA98, 37353941671685208, 89208338, 89208340, 2, 640x360 
0x1382CA98, 37353941672004856, 89208374, 89208376, 2, 640x360 
0x1382CA98, 37353941672324896, 89208404, 89208407, 3, 640x360 
0x1382CA98, 37353941672645240, 89208435, 89208438, 3, 640x360 
0x1382CA98, 37353941672965160, 89208466, 89208469, 3, 640x360 
0x1382CA98, 37353941673444800, 89208537, 89208541, 4, 640x360 
0x1382CA98, 37353941673765544, 89208568, 89208571, 3, 640x360 
0x1382CA98, 37353941674085456, 89208583, 89208587, 4, 640x360 
0x1382CA98, 37353941674404640, 89208623, 89208626, 3, 640x360 
0x1382CA98, 37353941674725176, 89208646, 89208651, 5, 640x360 
0x1382CA98, 37353941675047360, 89208684, 89208690, 6, 640x360 
0x1382CA98, 37353941675367520, 89208715, 89208721, 6, 640x360 
0x1382CA98, 37353941675688208, 89208756, 89208758, 2, 640x360 
0x1382CA98, 37353941676005200, 89208776, 89208779, 3, 640x360 
0x1382CA98, 37353941676325872, 89208810, 89208813, 3, 640x360 
0x1382CA98, 37353941676657672, 89208842, 89208844, 2, 640x360 
0x1382CA98, 37353941676971384, 89208878, 89208880, 2, 640x360 
0x1382CA98, 37353941677444096, 89208931, 89208934, 3, 640x360 
0x1382CA98, 37353941677767000, 89208963, 89208965, 2, 640x360 
0x1382CA98, 37353941678116408, 89208993, 89208995, 2, 640x360 
0x1382CA98, 37353941678409616, 89209020, 89209023, 3, 640x360 
0x1382CA98, 37353941678729184, 89209051, 89209055, 4, 640x360 
0x1382CA98, 37353941679050824, 89209077, 89209080, 3, 640x360 
0x1382CA98, 37353941679369552, 89209109, 89209113, 4, 640x360 
0x1382CA98, 37353941679689200, 89209148, 89209153, 5, 640x360 
0x1382CA98, 37353941680009392, 89209176, 89209179, 3, 640x360 
0x1382CA98, 37353941680329960, 89209209, 89209214, 5, 640x360 
0x1382CA98, 37353941680649992, 89209250, 89209254, 4, 640x360 
0x1382CA98, 37353941680965688, 89209275, 89209281, 6, 640x360 
0x1382CA98, 37353941681444672, 89209323, 89209334, 11, 640x360 
0x1382CA98, 37353941681768560, 89209353, 89209356, 3, 640x360 
0x1382CA98, 37353941682084704, 89209385, 89209388, 3, 640x360 
0x1382CA98, 37353941682411856, 89209416, 89209421, 5, 640x360 
0x1382CA98, 37353941682732504, 89209449, 89209454, 5, 640x360 
0x1382CA98, 37353941683045320, 89209480, 89209486, 6, 640x360 
0x1382CA98, 37353941683365560, 89209519, 89209522, 3, 640x360 
0x1382CA98, 37353941683695584, 89209551, 89209553, 2, 640x360 
0x1382CA98, 37353941684010088, 89209577, 89209584, 7, 640x360 
0x1382CA98, 37353941684325056, 89209623, 89209625, 2, 640x360 
0x1382CA98, 37353941684645248, 89209647, 89209649, 2, 640x360 
0x1382CA98, 37353941684971168, 89209680, 89209682, 2, 640x360 
0x1382CA98, 37353941685288608, 89209709, 89209712, 3, 640x360 
0x1382CA98, 37353941685766504, 89209751, 89209755, 4, 640x360 
0x1382CA98, 37353941686084376, 89209779, 89209782, 3, 640x360 
0x1382CA98, 37353941686416464, 89209813, 89209815, 2, 640x360 
0x1382CA98, 37353941686727720, 89209861, 89209870, 9, 640x360 
0x1382CA98, 37353941687045168, 89209887, 89209893, 6, 640x360 
0x1382CA98, 37353941687364272, 89209924, 89209928, 4, 640x360 
0x1382CA98, 37353941687684440, 89209945, 89209949, 4, 640x360 
0x1382CA98, 37353941688005912, 89209980, 89209983, 3, 640x360 
0x1382CA98, 37353941688324256, 89210019, 89210022, 3, 640x360 
0x1382CA98, 37353941688644592, 89210043, 89210045, 2, 640x360 
0x1382CA98, 37353941688964160, 89210073, 89210076, 3, 640x360 
0x1382CA98, 37353941689287600, 89210107, 89210110, 3, 640x360 
0x1382CA98, 37353941689764288, 89210148, 89210159, 11, 640x360 
0x1382CA98, 37353941690086592, 89210180, 89210194, 14, 640x360 
0x1382CA98, 37353941690408560, 89210214, 89210227, 13, 640x360 
0x1382CA98, 37353941690730456, 89210245, 89210248, 3, 640x360 
0x1382CA98, 37353941691045136, 89210278, 89210281, 3, 640x360 
0x1382CA98, 37353941691365040, 89210318, 89210321, 3, 640x360 
0x1382CA98, 37353941691684888, 89210347, 89210351, 4, 640x360 
0x1382CA98, 37353941692006056, 89210373, 89210379, 6, 640x360 
0x1382CA98, 37353941692324944, 89210418, 89210421, 3, 640x360 
0x1382CA98, 37353941692643856, 89210448, 89210453, 5, 640x360 
0x1382CA98, 37353941692967864, 89210473, 89210475, 2, 640x360 
0x1382CA98, 37353941693284192, 89210509, 89210511, 2, 640x360 
0x1382CA98, 37353941693766712, 89210551, 89210556, 5, 640x360 
0x1382CA98, 37353941694084200, 89210588, 89210590, 2, 640x360 
0x1382CA98, 37353941694439536, 89210631, 89210634, 3, 640x360 
0x1382CA98, 37353941694730072, 89210653, 89210666, 13, 640x360 
0x1382CA98, 37353941695097512, 89210693, 89210700, 7, 640x360 
0x1382CA98, 37353941695367400, 89210717, 89210721, 4, 640x360 
0x1382CA98, 37353941695686568, 89210749, 89210763, 14, 640x360 
0x1382CA98, 37353941696034952, 89210789, 89210801, 12, 640x360 
0x1382CA98, 37353941696367288, 89210828, 89210832, 4, 640x360 
0x1382CA98, 37353941696664568, 89210860, 89210870, 10, 640x360 
0x1382CA98, 37353941696987416, 89210880, 89210883, 3, 640x360 
0x1382CA98, 37353941697284824, 89210906, 89210912, 6, 640x360 
0x1382CA98, 37353941697775192, 89210957, 89210966, 9, 640x360 
0x1382CA98, 37353941698090528, 89210990, 89210993, 3, 640x360 
0x1382CA98, 37353941698416024, 89211026, 89211030, 4, 640x360 
0x1382CA98, 37353941698738688, 89211069, 89211078, 9, 640x360 
0x1382CA98, 37353941699076272, 89211093, 89211095, 2, 640x360 
0x1382CA98, 37353941699363416, 89211113, 89211125, 12, 640x360 
0x1382CA98, 37353941699683616, 89211146, 89211149, 3, 640x360 
0x1382CA98, 37353941700013520, 89211187, 89211195, 8, 640x360 
0x1382CA98, 37353941700336296, 89211211, 89211214, 3, 640x360 
0x1382CA98, 37353941700643920, 89211251, 89211254, 3, 640x360 
0x1382CA98, 37353941700963896, 89211275, 89211281, 6, 640x360 
0x1382CA98, 37353941701285616, 89211306, 89211308, 2, 640x360 
0x1382CA98, 37353941701763536, 89211354, 89211357, 3, 640x360 
0x1382CA98, 37353941702095176, 89211380, 89211384, 4, 640x360 
0x1382CA98, 37353941702407152, 89211412, 89211414, 2, 640x360 
0x1382CA98, 37353941702725784, 89211447, 89211452, 5, 640x360 
0x1382CA98, 37353941703043592, 89211488, 89211491, 3, 640x360 
0x1382CA98, 37353941703368600, 89211524, 89211526, 2, 640x360 
0x1382CA98, 37353941703684944, 89211553, 89211558, 5, 640x360 
0x1382CA98, 37353941704007000, 89211585, 89211588, 3, 640x360 
0x1382CA98, 37353941704323576, 89211622, 89211627, 5, 640x360 
0x1382CA98, 37353941704652904, 89211652, 89211655, 3, 640x360 
0x1382CA98, 37353941704967056, 89211680, 89211684, 4, 640x360 
0x1382CA98, 37353941705289704, 89211698, 89211702, 4, 640x360 
0x1382CA98, 37353941705763184, 89211750, 89211754, 4, 640x360 
0x1382CA98, 37353941706083952, 89211785, 89211787, 2, 640x360 
0x1382CA98, 37353941706404600, 89211814, 89211820, 6, 640x360 
0x1382CA98, 37353941706730480, 89211845, 89211847, 2, 640x360 
0x1382CA98, 37353941707044488, 89211876, 89211879, 3, 640x360 
0x1382CA98, 37353941707364280, 89211910, 89211912, 2, 640x360 
0x1382CA98, 37353941707688080, 89211944, 89211954, 10, 640x360 
0x1382CA98, 37353941708006032, 89211978, 89211980, 2, 640x360 
0x1382CA98, 37353941708340960, 89212009, 89212016, 7, 640x360 
0x1382CA98, 37353941708649160, 89212043, 89212052, 9, 640x360 
0x1382CA98, 37353941708964464, 89212081, 89212085, 4, 640x360 
0x1382CA98, 37353941709283936, 89212115, 89212119, 4, 640x360 
0x1382CA98, 37353941709811544, 89212171, 89212174, 3, 640x360 
0x1382CA98, 37353941710093208, 89212214, 89212224, 10, 640x360 
0x1382CA98, 37353941710435736, 89212247, 89212261, 14, 640x360 
0x1382CA98, 37353941710806576, 89212261, 89212277, 16, 640x360 
0x1382CA98, 37353941711098424, 89212301, 89212307, 6, 640x360 
0x1382CA98, 37353941711368920, 89212322, 89212333, 11, 640x360 
0x1382CA98, 37353941711700328, 89212358, 89212360, 2, 640x360 
0x1382CA98, 37353941712006672, 89212386, 89212394, 8, 640x360 
0x1382CA98, 37353941712331520, 89212427, 89212443, 16, 640x360 
0x1382CA98, 37353941712646744, 89212460, 89212466, 6, 640x360 
0x1382CA98, 37353941712979472, 89212480, 89212503, 23, 640x360 
0x1382CA98, 37353941713311584, 89212507, 89212525, 18, 640x360 
0x1382CA98, 37353941713656272, 89212554, 89212562, 8, 640x360 
0x1382CA98, 37353941714123752, 89212608, 89212617, 9, 640x360 
0x1382CA98, 37353941714478336, 89212658, 89212672, 14, 640x360 
0x1382CA98, 37353941714879480, 89212691, 89212702, 11, 640x360 
0x1382CA98, 37353941715111112, 89212723, 89212726, 3, 640x360 
0x1382CA98, 37353941715371896, 89212736, 89212754, 18, 640x360 
0x1382CA98, 37353941715685576, 89212773, 89212790, 17, 640x360 
0x1382CA98, 37353941716036344, 89212790, 89212797, 7, 640x360 
0x1382CA98, 37353941716360736, 89212825, 89212844, 19, 640x360 
0x1382CA98, 37353941716707064, 89212854, 89212866, 12, 640x360 
0x1382CA98, 37353941716964304, 89212881, 89212892, 11, 640x360 
0x1382CA98, 37353941717302984, 89212914, 89212921, 7, 640x360 
0x1382CA98, 37353941717612592, 89212943, 89212945, 2, 640x360 
0x1382CA98, 37353941718108040, 89213000, 89213004, 4, 640x360 
0x1382CA98, 37353941718428216, 89213027, 89213030, 3, 640x360 
0x1382CA98, 37353941718738048, 89213069, 89213083, 14, 640x360 
0x1382CA98, 37353941719043448, 89213088, 89213091, 3, 640x360 
0x1382CA98, 37353941719363080, 89213120, 89213122, 2, 640x360 
0x1382CA98, 37353941719682976, 89213148, 89213153, 5, 640x360 
0x1382CA98, 37353941720004832, 89213171, 89213177, 6, 640x360 
0x1382CA98, 37353941720324016, 89213207, 89213210, 3, 640x360 
0x1382CA98, 37353941720643992, 89213239, 89213247, 8, 640x360 
0x1382CA98, 37353941720966360, 89213274, 89213281, 7, 640x360 
0x1382CA98, 37353941721286096, 89213310, 89213312, 2, 640x360 
0x1382CA98, 37353941721604456, 89213340, 89213342, 2, 640x360 
0x1382CA98, 37353941722104808, 89213391, 89213394, 3, 640x360 
0x1382CA98, 37353941722409472, 89213415, 89213423, 8, 640x360 
0x1382CA98, 37353941722728016, 89213448, 89213454, 6, 640x360 
0x1382CA98, 37353941723043544, 89213481, 89213486, 5, 640x360 
0x1382CA98, 37353941723362960, 89213514, 89213517, 3, 640x360 
0x1382CA98, 37353941723687344, 89213545, 89213548, 3, 640x360 
0x1382CA98, 37353941724015840, 89213575, 89213578, 3, 640x360 
0x1382CA98, 37353941724323496, 89213607, 89213613, 6, 640x360 
0x1382CA98, 37353941724650240, 89213640, 89213642, 2, 640x360 
0x1382CA98, 37353941724963640, 89213666, 89213672, 6, 640x360 
0x1382CA98, 37353941725287400, 89213706, 89213708, 2, 640x360 
0x1382CA98, 37353941725604016, 89213730, 89213733, 3, 640x360 
0x1382CA98, 37353941726088448, 89213782, 89213788, 6, 640x360 
0x1382CA98, 37353941726422960, 89213819, 89213828, 9, 640x360 
0x1382CA98, 37353941726728288, 89213849, 89213863, 14, 640x360 
0x1382CA98, 37353941727043048, 89213891, 89213897, 6, 640x360 
0x1382CA98, 37353941727366072, 89213920, 89213922, 2, 640x360 
0x1382CA98, 37353941727682952, 89213952, 89213955, 3, 640x360 
0x1382CA98, 37353941728016888, 89213977, 89213981, 4, 640x360 
0x1382CA98, 37353941728340784, 89214020, 89214023, 3, 640x360 
0x1382CA98, 37353941728650280, 89214042, 89214044, 2, 640x360 
0x1382CA98, 37353941728963432, 89214079, 89214081, 2, 640x360 
0x1382CA98, 37353941729294216, 89214108, 89214110, 2, 640x360 
0x1382CA98, 37353941729633000, 89214144, 89214146, 2, 640x360 
0x1382CA98, 37353941730085864, 89214182, 89214194, 12, 640x360 
0x1382CA98, 37353941730410248, 89214217, 89214224, 7, 640x360 
0x1382CA98, 37353941730731976, 89214253, 89214260, 7, 640x360 
0x1382CA98, 37353941731046624, 89214280, 89214284, 4, 640x360 
0x1382CA98, 37353941731362824, 89214319, 89214322, 3, 640x360 
0x1382CA98, 37353941731687360, 89214343, 89214345, 2, 640x360 
0x1382CA98, 37353941732007536, 89214380, 89214382, 2, 640x360 
0x1382CA98, 37353941732342104, 89214423, 89214425, 2, 640x360 
0x1382CA98, 37353941732643360, 89214442, 89214446, 4, 640x360 
0x1382CA98, 37353941732979144, 89214474, 89214478, 4, 640x360 
0x1382CA98, 37353941733311824, 89214513, 89214516, 3, 640x360 
0x1382CA98, 37353941733637744, 89214546, 89214554, 8, 640x360 
0x1382CA98, 37353941734087248, 89214580, 89214585, 5, 640x360 
0x1382CA98, 37353941734409272, 89214619, 89214626, 7, 640x360 
0x1382CA98, 37353941734723008, 89214644, 89214647, 3, 640x360 
0x1382CA98, 37353941735042648, 89214676, 89214678, 2, 640x360 
0x1382CA98, 37353941735362656, 89214712, 89214714, 2, 640x360 
0x1382CA98, 37353941735682824, 89214751, 89214755, 4, 640x360 
0x1382CA98, 37353941736009696, 89214778, 89214780, 2, 640x360 
0x1382CA98, 37353941736332136, 89214815, 89214825, 10, 640x360 
0x1382CA98, 37353941736651368, 89214882, 89214892, 10, 640x360 
0x1382CA98, 37353941737367912, 89214939, 89214955, 16, 640x360 
0x1382CA98, 37353941737514416, 89214961, 89214964, 3, 640x360 
0x1382CA98, 37353941737767936, 89214971, 89214988, 17, 640x360 
0x1382CA98, 37353941738418288, 89215047, 89215093, 46, 640x360 
0x1382CA98, 37353941738749128, 89215103, 89215153, 50, 640x360 
0x1382CA98, 37353941739378472, 89215164, 89215177, 13, 640x360 
0x1382CA98, 37353941740036360, 89215221, 89215234, 13, 640x360 
0x1382CA98, 37353941740378288, 89215260, 89215264, 4, 640x360 
0x1382CA98, 37353941740966968, 89215292, 89215300, 8, 640x360 
0x1382CA98, 37353941741288560, 89215312, 89215314, 2, 640x360 
0x1382CA98, 37353941741645856, 89215348, 89215354, 6, 640x360 
0x1382CA98, 37353941741929976, 89215378, 89215381, 3, 640x360 
0x1382CA98, 37353941742414480, 89215426, 89215433, 7, 640x360 
0x1382CA98, 37353941742723984, 89215457, 89215459, 2, 640x360 
0x1382CA98, 37353941743046096, 89215488, 89215491, 3, 640x360 
0x1382CA98, 37353941743362224, 89215508, 89215513, 5, 640x360 
0x1382CA98, 37353941743682352, 89215551, 89215555, 4, 640x360 
0x1382CA98, 37353941744004608, 89215576, 89215590, 14, 640x360 
0x1382CA98, 37353941744327840, 89215607, 89215610, 3, 640x360 
0x1382CA98, 37353941744642416, 89215638, 89215645, 7, 640x360 
0x1382CA98, 37353941744962776, 89215686, 89215691, 5, 640x360 
0x1382CA98, 37353941745299296, 89215707, 89215709, 2, 640x360 
0x1382CA98, 37353941745608048, 89215746, 89215748, 2, 640x360 
0x1382CA98, 37353941745932688, 89215773, 89215779, 6, 640x360 
0x1382CA98, 37353941746425128, 89215819, 89215823, 4, 640x360 
0x1382CA98, 37353941746733688, 89215851, 89215860, 9, 640x360 
0x1382CA98, 37353941747042040, 89215880, 89215884, 4, 640x360 
0x1382CA98, 37353941747365968, 89215913, 89215915, 2, 640x360 
0x1382CA98, 37353941747686800, 89215952, 89215954, 2, 640x360 
0x1382CA98, 37353941748006976, 89215977, 89215978, 1, 640x360 
0x1382CA98, 37353941748322896, 89216014, 89216020, 6, 640x360 
0x1382CA98, 37353941748642584, 89216041, 89216047, 6, 640x360 
0x1382CA98, 37353941748962464, 89216074, 89216080, 6, 640x360 
0x1382CA98, 37353941749288176, 89216103, 89216105, 2, 640x360 
0x1382CA98, 37353941749606104, 89216130, 89216132, 2, 640x360 
0x1382CA98, 37353941749923160, 89216163, 89216166, 3, 640x360 
0x1382CA98, 37353941750404864, 89216215, 89216223, 8, 640x360 
0x1382CA98, 37353941750728200, 89216258, 89216260, 2, 640x360 
0x1382CA98, 37353941751047520, 89216278, 89216281, 3, 640x360 
0x1382CA98, 37353941751384184, 89216309, 89216311, 2, 640x360 
0x1382CA98, 37353941751682504, 89216365, 89216370, 5, 640x360 
0x1382CA98, 37353941752018536, 89216375, 89216378, 3, 640x360 
0x1382CA98, 37353941752322776, 89216404, 89216411, 7, 640x360 
0x1382CA98, 37353941752656648, 89216447, 89216450, 3, 640x360 
0x1382CA98, 37353941752966296, 89216480, 89216482, 2, 640x360 
0x1382CA98, 37353941753282416, 89216503, 89216512, 9, 640x360 
0x1382CA98, 37353941753604760, 89216531, 89216538, 7, 640x360 
0x1382CA98, 37353941753925112, 89216568, 89216571, 3, 640x360 
0x1382CA98, 37353941754411800, 89216623, 89216625, 2, 640x360 
0x1382CA98, 37353941754740136, 89216648, 89216654, 6, 640x360 
0x1382CA98, 37353941755041944, 89216687, 89216692, 5, 640x360 
0x1382CA98, 37353941755361888, 89216718, 89216720, 2, 640x360 
0x1382CA98, 37353941755687984, 89216745, 89216747, 2, 640x360 
0x1382CA98, 37353941756003096, 89216784, 89216787, 3, 640x360 
0x1382CA98, 37353941756326312, 89216809, 89216811, 2, 640x360 
0x1382CA98, 37353941756646048, 89216848, 89216854, 6, 640x360 
0x1382CA98, 37353941756969192, 89216874, 89216876, 2, 640x360 
0x1382CA98, 37353941757290824, 89216909, 89216911, 2, 640x360 
0x1382CA98, 37353941757612696, 89216940, 89216942, 2, 640x360 
0x1382CA98, 37353941757923376, 89216964, 89216969, 5, 640x360 
0x1382CA98, 37353941758408784, 89217016, 89217021, 5, 640x360 
0x1382CA98, 37353941758726120, 89217045, 89217048, 3, 640x360 
0x1382CA98, 37353941759042384, 89217078, 89217080, 2, 640x360 
0x1382CA98, 37353941759370992, 89217112, 89217116, 4, 640x360 
0x1382CA98, 37353941759682560, 89217144, 89217147, 3, 640x360 
0x1382CA98, 37353941760004664, 89217187, 89217190, 3, 640x360 
0x1382CA98, 37353941760326816, 89217211, 89217213, 2, 640x360 
0x1382CA98, 37353941760646640, 89217244, 89217246, 2, 640x360 
0x1382CA98, 37353941760967696, 89217274, 89217277, 3, 640x360 
0x1382CA98, 37353941761287112, 89217309, 89217312, 3, 640x360 
0x1382CA98, 37353941761613776, 89217342, 89217344, 2, 640x360 
0x1382CA98, 37353941761943208, 89217378, 89217381, 3, 640x360 
0x1382CA98, 37353941762408672, 89217435, 89217438, 3, 640x360 
0x1382CA98, 37353941762730104, 89217459, 89217466, 7, 640x360 
0x1382CA98, 37353941763048024, 89217487, 89217489, 2, 640x360 
0x1382CA98, 37353941763368288, 89217510, 89217513, 3, 640x360 
0x1382CA98, 37353941763681768, 89217551, 89217555, 4, 640x360 
0x1382CA98, 37353941764015464, 89217587, 89217589, 2, 640x360 
0x1382CA98, 37353941764326312, 89217607, 89217610, 3, 640x360 
0x1382CA98, 37353941764651120, 89217645, 89217646, 1, 640x360 
0x1382CA98, 37353941765009096, 89217675, 89217677, 2, 640x360 
0x1382CA98, 37353941765293000, 89217706, 89217709, 3, 640x360 
0x1382CA98, 37353941765613896, 89217743, 89217745, 2, 640x360 
0x1382CA98, 37353941765927936, 89217777, 89217779, 2, 640x360 
0x1382CA98, 37353941766248632, 89217803, 89217806, 3, 640x360 
0x1382CA98, 37353941766721408, 89217849, 89217859, 10, 640x360 
0x1382CA98, 37353941767046376, 89217885, 89217888, 3, 640x360 
0x1382CA98, 37353941767364752, 89217916, 89217920, 4, 640x360 
0x1382CA98, 37353941767685464, 89217940, 89217943, 3, 640x360 
0x1382CA98, 37353941768003320, 89217979, 89217981, 2, 640x360 
0x1382CA98, 37353941768327072, 89218012, 89218014, 2, 640x360 
0x1382CA98, 37353941768649208, 89218044, 89218050, 6, 640x360 
0x1382CA98, 37353941768966208, 89218081, 89218087, 6, 640x360 
0x1382CA98, 37353941769282536, 89218108, 89218114, 6, 640x360 
0x1382CA98, 37353941769608312, 89218145, 89218150, 5, 640x360 
0x1382CA98, 37353941769931888, 89218164, 89218170, 6, 640x360 
0x1382CA98, 37353941770251896, 89218202, 89218213, 11, 640x360 
0x1382CA98, 37353941770726896, 89218249, 89218256, 7, 640x360 
0x1382CA98, 37353941771046952, 89218291, 89218293, 2, 640x360 
0x1382CA98, 37353941771369688, 89218314, 89218316, 2, 640x360 
0x1382CA98, 37353941771683128, 89218354, 89218357, 3, 640x360 
0x1382CA98, 37353941772002320, 89218377, 89218387, 10, 640x360 
0x1382CA98, 37353941772338696, 89218414, 89218421, 7, 640x360 
0x1382CA98, 37353941772642880, 89218447, 89218454, 7, 640x360 
0x1382CA98, 37353941772993192, 89218481, 89218496, 15, 640x360 
0x1382CA98, 37353941773302320, 89218510, 89218513, 3, 640x360 
0x1382CA98, 37353941773653280, 89218544, 89218546, 2, 640x360 
0x1382CA98, 37353941773927440, 89218577, 89218579, 2, 640x360 
0x1382CA98, 37353941774284224, 89218609, 89218612, 3, 640x360 
0x1382CA98, 37353941774727152, 89218653, 89218661, 8, 640x360 
0x1382CA98, 37353941775041504, 89218680, 89218689, 9, 640x360 
0x1382CA98, 37353941775365848, 89218715, 89218728, 13, 640x360 
0x1382CA98, 37353941775682048, 89218753, 89218761, 8, 640x360 
0x1382CA98, 37353941776006240, 89218778, 89218781, 3, 640x360 
0x1382CA98, 37353941776327112, 89218822, 89218827, 5, 640x360 
0x1382CA98, 37353941776642536, 89218845, 89218847, 2, 640x360 
0x1382CA98, 37353941776968752, 89218889, 89218901, 12, 640x360 
0x1382CA98, 37353941777311800, 89218910, 89218919, 9, 640x360 
0x1382CA98, 37353941777610888, 89218949, 89218956, 7, 640x360 
0x1382CA98, 37353941777943432, 89218974, 89218985, 11, 640x360 
0x1382CA98, 37353941778267336, 89219008, 89219013, 5, 640x360 
0x1382CA98, 37353941778725872, 89219045, 89219048, 3, 640x360 
0x1382CA98, 37353941779041336, 89219089, 89219096, 7, 640x360 
0x1382CA98, 37353941779361208, 89219115, 89219125, 10, 640x360 
0x1382CA98, 37353941779687088, 89219148, 89219153, 5, 640x360 
0x1382CA98, 37353941780002656, 89219186, 89219196, 10, 640x360 
0x1382CA98, 37353941780342400, 89219210, 89219212, 2, 640x360 
0x1382CA98, 37353941780647544, 89219242, 89219243, 1, 640x360 
0x1382CA98, 37353941780968496, 89219278, 89219280, 2, 640x360 
0x1382CA98, 37353941781286008, 89219315, 89219319, 4, 640x360 
0x1382CA98, 37353941781608712, 89219334, 89219343, 9, 640x360 
0x1382CA98, 37353941781928040, 89219369, 89219381, 12, 640x360 
0x1382CA98, 37353941782255080, 89219399, 89219413, 14, 640x360 
0x1382CA98, 37353941782721384, 89219453, 89219455, 2, 640x360 
0x1382CA98, 37353941783043040, 89219479, 89219482, 3, 640x360 
0x1382CA98, 37353941783365552, 89219519, 89219522, 3, 640x360 
0x1382CA98, 37353941783681344, 89219550, 89219555, 5, 640x360 
0x1382CA98, 37353941784006304, 89219576, 89219579, 3, 640x360 
0x1382CA98, 37353941784322176, 89219615, 89219618, 3, 640x360 
0x1382CA98, 37353941784641888, 89219640, 89219643, 3, 640x360 
0x1382CA98, 37353941784966168, 89219674, 89219682, 8, 640x360 
0x1382CA98, 37353941785281688, 89219708, 89219712, 4, 640x360 
0x1382CA98, 37353941785610416, 89219735, 89219747, 12, 640x360 
0x1382CA98, 37353941785933960, 89219770, 89219777, 7, 640x360 
0x1382CA98, 37353941786246256, 89219797, 89219801, 4, 640x360 
0x1382CA98, 37353941786727864, 89219846, 89219848, 2, 640x360 
0x1382CA98, 37353941787041984, 89219881, 89219883, 2, 640x360 
0x1382CA98, 37353941787365088, 89219921, 89219923, 2, 640x360 
0x1382CA98, 37353941787681992, 89219945, 89219947, 2, 640x360 
0x1382CA98, 37353941788001640, 89219989, 89219997, 8, 640x360 
0x1382CA98, 37353941788326272, 89220019, 89220022, 3, 640x360 
0x1382CA98, 37353941788641576, 89220051, 89220055, 4, 640x360 
0x1382CA98, 37353941788965888, 89220074, 89220076, 2, 640x360 
0x1382CA98, 37353941789289368, 89220108, 89220110, 2, 640x360 
0x1382CA98, 37353941789641672, 89220139, 89220148, 9, 640x360 
0x1382CA98, 37353941789933176, 89220174, 89220183, 9, 640x360 
0x1382CA98, 37353941790243160, 89220207, 89220215, 8, 640x360 
0x1382CA98, 37353941790722336, 89220244, 89220246, 2, 640x360 
0x1382CA98, 37353941791041496, 89220276, 89220279, 3, 640x360 
0x1382CA98, 37353941791365064, 89220317, 89220326, 9, 640x360 
0x1382CA98, 37353941791681784, 89220352, 89220362, 10, 640x360 
0x1382CA98, 37353941792015528, 89220376, 89220379, 3, 640x360 
0x1382CA98, 37353941792321232, 89220411, 89220415, 4, 640x360 
0x1382CA98, 37353941792651120, 89220441, 89220443, 2, 640x360 
0x1382CA98, 37353941792979712, 89220476, 89220478, 2, 640x360 
0x1382CA98, 37353941793295120, 89220507, 89220509, 2, 640x360 
0x1382CA98, 37353941793609720, 89220536, 89220548, 12, 640x360 
0x1382CA98, 37353941793936944, 89220576, 89220578, 2, 640x360 
0x1382CA98, 37353941794249088, 89220596, 89220601, 5, 640x360 
0x1382CA98, 37353941794571696, 89220636, 89220644, 8, 640x360 
0x1382CA98, 37353941795040648, 89220684, 89220687, 3, 640x360 
0x1382CA98, 37353941795367024, 89220712, 89220714, 2, 640x360 
0x1382CA98, 37353941795686712, 89220746, 89220748, 2, 640x360 
0x1382CA98, 37353941796012152, 89220779, 89220781, 2, 640x360 
0x1382CA98, 37353941796335096, 89220820, 89220823, 3, 640x360 
0x1382CA98, 37353941796647432, 89220837, 89220840, 3, 640x360 
0x1382CA98, 37353941796966344, 89220869, 89220873, 4, 640x360 
0x1382CA98, 37353941797281568, 89220908, 89220910, 2, 640x360 
0x1382CA98, 37353941797602448, 89220937, 89220945, 8, 640x360 
0x1382CA98, 37353941797928016, 89220971, 89220977, 6, 640x360 
0x1382CA98, 37353941798254920, 89220997, 89221010, 13, 640x360 
0x1382CA98, 37353941798590024, 89221042, 89221048, 6, 640x360 
0x1382CA98, 37353941799041240, 89221079, 89221084, 5, 640x360 
0x1382CA98, 37353941799368320, 89221124, 89221127, 3, 640x360 
0x1382CA98, 37353941799689848, 89221150, 89221157, 7, 640x360 
0x1382CA98, 37353941800002664, 89221181, 89221183, 2, 640x360 
0x1382CA98, 37353941800324336, 89221216, 89221220, 4, 640x360 
0x1382CA98, 37353941800641840, 89221241, 89221247, 6, 640x360 
0x1382CA98, 37353941800964808, 89221268, 89221271, 3, 640x360 
0x1382CA98, 37353941801296400, 89221303, 89221306, 3, 640x360 
0x1382CA98, 37353941801602656, 89221341, 89221343, 2, 640x360 
0x1382CA98, 37353941801937080, 89221383, 89221389, 6, 640x360 
0x1382CA98, 37353941802251864, 89221407, 89221414, 7, 640x360 
0x1382CA98, 37353941802568752, 89221439, 89221441, 2, 640x360 
0x1382CA98, 37353941803040528, 89221478, 89221481, 3, 640x360 
0x1382CA98, 37353941803360744, 89221510, 89221513, 3, 640x360 
0x1382CA98, 37353941803681208, 89221542, 89221546, 4, 640x360 
0x1382CA98, 37353941804006008, 89221573, 89221579, 6, 640x360 
0x1382CA98, 37353941804321320, 89221608, 89221612, 4, 640x360 
0x1382CA98, 37353941804647168, 89221640, 89221646, 6, 640x360 
0x1382CA98, 37353941804965368, 89221668, 89221672, 4, 640x360 
0x1382CA98, 37353941805281112, 89221698, 89221701, 3, 640x360 
0x1382CA98, 37353941805939704, 89221775, 89221776, 1, 320x180 
0x1382CA98, 37353941806574760, 89221835, 89221845, 10, 320x180 
0x1382CA98, 37353941807364928, 89221921, 89221923, 2, 320x180 
0x1382CA98, 37353941808011728, 89221974, 89221977, 3, 320x180 
0x1382CA98, 37353941808645480, 89222042, 89222043, 1, 320x180 
0x1382CA98, 37353941809281256, 89222109, 89222118, 9, 320x180 
0x1382CA98, 37353941810593824, 89222250, 89222261, 11, 320x180 
0x1382CA98, 37353941811360928, 89222317, 89222321, 4, 320x180 
0x1382CA98, 37353941812005440, 89222388, 89222389, 1, 320x180 
0x1382CA98, 37353941812643976, 89222446, 89222447, 1, 320x180 
0x1382CA98, 37353941813280640, 89222501, 89222513, 12, 320x180 
0x1382CA98, 37353941813931024, 89222570, 89222575, 5, 320x180 
0x1382CA98, 37353941814571408, 89222637, 89222644, 7, 320x180 
0x1382CA98, 37353941815364216, 89222725, 89222727, 2, 320x180 
0x1382CA98, 37353941816009760, 89222779, 89222780, 1, 320x180 
0x1382CA98, 37353941816648056, 89222843, 89222848, 5, 320x180 
0x1382CA98, 37353941817293144, 89222909, 89222910, 1, 320x180 
0x1382CA98, 37353941817930120, 89222980, 89222982, 2, 320x180 
0x1382CA98, 37353941818564568, 89223044, 89223046, 2, 320x180 
0x1382CA98, 37353941819365112, 89223113, 89223115, 2, 320x180 
0x1382CA98, 37353941820017320, 89223187, 89223194, 7, 320x180 
0x1382CA98, 37353941820645400, 89223242, 89223243, 1, 320x180 
0x1382CA98, 37353941821283616, 89223314, 89223316, 2, 320x180 
0x1382CA98, 37353941821921280, 89223376, 89223377, 1, 320x180 
0x1382CA98, 37353941822570944, 89223439, 89223440, 1, 320x180 
0x1382CA98, 37353941823360304, 89223512, 89223514, 2, 320x180 
0x1382CA98, 37353941824010824, 89223598, 89223614, 16, 320x180 
0x1382CA98, 37353941824640136, 89223647, 89223650, 3, 320x180 
0x1382CA98, 37353941825284080, 89223701, 89223708, 7, 320x180 
0x1382CA98, 37353941825925536, 89223783, 89223792, 9, 320x180 
0x1382CA98, 37353941826562480, 89223843, 89223851, 8, 320x180 
0x1382CA98, 37353941827360040, 89223909, 89223911, 2, 320x180 
0x1382CA98, 37353941828004528, 89223988, 89223989, 1, 320x180 
0x1382CA98, 37353941828643944, 89224042, 89224043, 1, 320x180 
0x1382CA98, 37353941829283000, 89224103, 89224109, 6, 320x180 
0x1382CA98, 37353941829925128, 89224169, 89224179, 10, 320x180 
0x1382CA98, 37353941830563952, 89224237, 89224246, 9, 320x180 
0x1382CA98, 37353941831360632, 89224311, 89224313, 2, 320x180 
0x1382CA98, 37353941832010608, 89224383, 89224392, 9, 320x180 
0x1382CA98, 37353941832643104, 89224448, 89224449, 1, 320x180 
0x1382CA98, 37353941833280032, 89224501, 89224513, 12, 320x180 
0x1382CA98, 37353941833927704, 89224565, 89224568, 3, 320x180 
0x1382CA98, 37353941834561552, 89224632, 89224640, 8, 320x180 
0x1382CA98, 37353941835359680, 89224714, 89224716, 2, 320x180 
0x1382CA98, 37353941836005072, 89224785, 89224787, 2, 320x180 
0x1382CA98, 37353941836643800, 89224843, 89224845, 2, 320x180 
0x1382CA98, 37353941837286272, 89224913, 89224915, 2, 320x180 
0x1382CA98, 37353941837931104, 89224974, 89224976, 2, 320x180 
0x1382CA98, 37353941838560752, 89225033, 89225034, 1, 320x180 
0x1382CA98, 37353941839359920, 89225110, 89225113, 3, 320x180 
0x1382CA98, 37353941840004760, 89225182, 89225194, 12, 320x180 
0x1382CA98, 37353941840643976, 89225241, 89225244, 3, 320x180 
0x1382CA98, 37353941841283480, 89225308, 89225309, 1, 320x180 
0x1382CA98, 37353941841925640, 89225366, 89225377, 11, 320x180 
0x1382CA98, 37353941842566272, 89225429, 89225431, 2, 320x180 
0x1382CA98, 37353941843363712, 89225522, 89225524, 2, 320x180 
0x1382CA98, 37353941844006352, 89225580, 89225592, 12, 320x180 
0x1382CA98, 37353941844639840, 89225644, 89225646, 2, 320x180 
0x1382CA98, 37353941845280240, 89225713, 89225714, 1, 320x180 
0x1382CA98, 37353941845935848, 89225781, 89225790, 9, 320x180 
0x1382CA98, 37353941846565728, 89225846, 89225847, 1, 320x180 
0x1382CA98, 37353941847200184, 89225901, 89225903, 2, 320x180 
0x1382CA98, 37353941848000688, 89225977, 89225981, 4, 320x180 
0x1382CA98, 37353941848641712, 89226042, 89226043, 1, 320x180 
0x1382CA98, 37353941849283888, 89226106, 89226108, 2, 320x180 
0x1382CA98, 37353941849922800, 89226172, 89226174, 2, 320x180 
0x1382CA98, 37353941850565448, 89226236, 89226246, 10, 320x180 
0x1382CA98, 37353941851203928, 89226298, 89226301, 3, 320x180 
0x1382CA98, 37353941852005184, 89226387, 89226389, 2, 320x180 
0x1382CA98, 37353941852644944, 89226445, 89226454, 9, 320x180 
0x1382CA98, 37353941853279416, 89226514, 89226516, 2, 320x180 
0x1382CA98, 37353941853920168, 89226575, 89226577, 2, 320x180 
0x1382CA98, 37353941854562288, 89226630, 89226631, 1, 320x180 
0x1382CA98, 37353941855199928, 89226697, 89226698, 1, 320x180 
0x1382CA98, 37353941856004144, 89226774, 89226779, 5, 320x180 
0x1382CA98, 37353941856644232, 89226846, 89226847, 1, 320x180 
0x1382CA98, 37353941857311656, 89226911, 89226912, 1, 320x180 
0x1382CA98, 37353941857948912, 89226987, 89226988, 1, 320x180 
0x1382CA98, 37353941858565712, 89227028, 89227030, 2, 320x180 
0x1382CA98, 37353941859201000, 89227103, 89227111, 8, 320x180 
0x1382CA98, 37353941860325312, 89227215, 89227221, 6, 640x360 
0x1382CA98, 37353941860648880, 89227252, 89227254, 2, 640x360 
0x1382CA98, 37353941860967216, 89227274, 89227277, 3, 640x360 
0x1382CA98, 37353941861282312, 89227309, 89227312, 3, 640x360 
0x1382CA98, 37353941861607288, 89227344, 89227351, 7, 640x360 
0x1382CA98, 37353941861921800, 89227367, 89227377, 10, 640x360 
0x1382CA98, 37353941862259000, 89227403, 89227414, 11, 640x360 
0x1382CA98, 37353941862565528, 89227446, 89227448, 2, 640x360 
0x1382CA98, 37353941862879920, 89227468, 89227472, 4, 640x360 
0x1382CA98, 37353941863212968, 89227496, 89227499, 3, 640x360 
0x1382CA98, 37353941863679640, 89227545, 89227547, 2, 640x360 
0x1382CA98, 37353941864004336, 89227585, 89227588, 3, 640x360 
0x1382CA98, 37353941864323440, 89227610, 89227618, 8, 640x360 
0x1382CA98, 37353941864644592, 89227638, 89227647, 9, 640x360 
0x1382CA98, 37353941864959272, 89227681, 89227683, 2, 640x360 
0x1382CA98, 37353941865279400, 89227710, 89227712, 2, 640x360 
0x1382CA98, 37353941865600456, 89227737, 89227743, 6, 640x360 
0x1382CA98, 37353941865920888, 89227770, 89227776, 6, 640x360 
0x1382CA98, 37353941866244600, 89227816, 89227821, 5, 640x360 
0x1382CA98, 37353941866570160, 89227834, 89227839, 5, 640x360 
0x1382CA98, 37353941866885024, 89227862, 89227865, 3, 640x360 
0x1382CA98, 37353941867205000, 89227907, 89227909, 2, 640x360 
0x1382CA98, 37353941867679496, 89227950, 89227954, 4, 640x360 
0x1382CA98, 37353941868006504, 89227987, 89227991, 4, 640x360 
0x1382CA98, 37353941868319872, 89228006, 89228014, 8, 640x360 
0x1382CA98, 37353941868641104, 89228039, 89228042, 3, 640x360 
0x1382CA98, 37353941868959208, 89228068, 89228072, 4, 640x360 
0x1382CA98, 37353941869279360, 89228104, 89228112, 8, 640x360 
0x1382CA98, 37353941869603872, 89228147, 89228150, 3, 640x360 
0x1382CA98, 37353941869924120, 89228168, 89228178, 10, 640x360 
0x1382CA98, 37353941870247400, 89228199, 89228209, 10, 640x360 
0x1382CA98, 37353941870560152, 89228233, 89228245, 12, 640x360 
0x1382CA98, 37353941870880296, 89228274, 89228279, 5, 640x360 
0x1382CA98, 37353941871204480, 89228292, 89228295, 3, 640x360 
0x1382CA98, 37353941871679080, 89228347, 89228351, 4, 640x360 
0x1382CA98, 37353941872001768, 89228386, 89228393, 7, 640x360 
0x1382CA98, 37353941872326416, 89228415, 89228418, 3, 640x360 
0x1382CA98, 37353941872644136, 89228446, 89228450, 4, 640x360 
0x1382CA98, 37353941872963112, 89228476, 89228477, 1, 640x360 
0x1382CA98, 37353941873280136, 89228511, 89228513, 2, 640x360 
0x1382CA98, 37353941873602632, 89228543, 89228545, 2, 640x360 
0x1382CA98, 37353941873929128, 89228579, 89228581, 2, 640x360 
0x1382CA98, 37353941874246472, 89228606, 89228608, 2, 640x360 
0x1382CA98, 37353941874578552, 89228634, 89228645, 11, 640x360 
0x1382CA98, 37353941874912080, 89228673, 89228679, 6, 640x360 
0x1382CA98, 37353941875200000, 89228692, 89228700, 8, 640x360 
0x1382CA98, 37353941875519336, 89228735, 89228738, 3, 640x360 
0x1382CA98, 37353941875998624, 89228774, 89228779, 5, 640x360 
0x1382CA98, 37353941876329128, 89228809, 89228811, 2, 640x360 
0x1382CA98, 37353941876648776, 89228842, 89228844, 2, 640x360 
0x1382CA98, 37353941876965656, 89228885, 89228889, 4, 640x360 
0x1382CA98, 37353941877285600, 89228908, 89228914, 6, 640x360 
0x1382CA98, 37353941877601048, 89228936, 89228939, 3, 640x360 
0x1382CA98, 37353941877930160, 89228981, 89228985, 4, 640x360 
0x1382CA98, 37353941878247528, 89229004, 89229014, 10, 640x360 
0x1382CA98, 37353941878567728, 89229038, 89229047, 9, 640x360 
0x1382CA98, 37353941878930152, 89229077, 89229080, 3, 640x360 
0x1382CA98, 37353941879204936, 89229111, 89229113, 2, 640x360 
0x1382CA98, 37353941879520376, 89229130, 89229134, 4, 640x360 
0x1382CA98, 37353941880004008, 89229187, 89229190, 3, 640x360 
0x1382CA98, 37353941880327736, 89229207, 89229210, 3, 640x360 
0x1382CA98, 37353941880652352, 89229243, 89229247, 4, 640x360 
0x1382CA98, 37353941880960232, 89229269, 89229278, 9, 640x360 
0x1382CA98, 37353941881278880, 89229316, 89229320, 4, 640x360 
0x1382CA98, 37353941881607112, 89229344, 89229351, 7, 640x360 
0x1382CA98, 37353941881926312, 89229373, 89229376, 3, 640x360 
0x1382CA98, 37353941882255128, 89229403, 89229415, 12, 640x360 
0x1382CA98, 37353941882570040, 89229434, 89229444, 10, 640x360 
0x1382CA98, 37353941882879320, 89229468, 89229472, 4, 640x360 
0x1382CA98, 37353941883204432, 89229496, 89229503, 7, 640x360 
0x1382CA98, 37353941883520032, 89229530, 89229531, 1, 640x360 
0x1382CA98, 37353941884003224, 89229581, 89229591, 10, 640x360 
0x1382CA98, 37353941884323096, 89229609, 89229612, 3, 640x360 
0x1382CA98, 37353941884643624, 89229644, 89229645, 1, 640x360 
0x1382CA98, 37353941884962344, 89229677, 89229683, 6, 640x360 
0x1382CA98, 37353941885279872, 89229698, 89229702, 4, 640x360 
0x1382CA98, 37353941885626304, 89229747, 89229750, 3, 640x360 
0x1382CA98, 37353941885924864, 89229765, 89229773, 8, 640x360 
0x1382CA98, 37353941886249744, 89229805, 89229814, 9, 640x360 
0x1382CA98, 37353941886559600, 89229838, 89229847, 9, 640x360 
0x1382CA98, 37353941886888784, 89229870, 89229873, 3, 640x360 
0x1382CA98, 37353941887199384, 89229905, 89229912, 7, 640x360 
0x1382CA98, 37353941887521792, 89229935, 89229942, 7, 640x360 
0x1382CA98, 37353941888014648, 89229986, 89229994, 8, 640x360 
0x1382CA98, 37353941888324456, 89230039, 89230047, 8, 640x360 
0x1382CA98, 37353941888774360, 89230096, 89230129, 33, 640x360 
0x1382CA98, 37353941889300272, 89230176, 89230181, 5, 640x360 
0x1382CA98, 37353941889858088, 89230205, 89230208, 3, 640x360 
0x1382CA98, 37353941890210704, 89230210, 89230224, 14, 640x360 
0x1382CA98, 37353941890384784, 89230228, 89230243, 15, 640x360 
0x1382CA98, 37353941890577864, 89230247, 89230256, 9, 640x360 
0x1382CA98, 37353941890927400, 89230280, 89230285, 5, 640x360 
0x1382CA98, 37353941891526384, 89230328, 89230331, 3, 640x360 
0x1382CA98, 37353941892010552, 89230378, 89230380, 2, 640x360 
0x1382CA98, 37353941892329424, 89230409, 89230418, 9, 640x360 
0x1382CA98, 37353941892643976, 89230442, 89230444, 2, 640x360 
0x1382CA98, 37353941892964696, 89230487, 89230491, 4, 640x360 
0x1382CA98, 37353941893297048, 89230509, 89230511, 2, 640x360 
0x1382CA98, 37353941893603688, 89230533, 89230543, 10, 640x360 
0x1382CA98, 37353941893932080, 89230568, 89230572, 4, 640x360 
0x1382CA98, 37353941894255384, 89230598, 89230601, 3, 640x360 
0x1382CA98, 37353941894570904, 89230637, 89230647, 10, 640x360 
0x1382CA98, 37353941894879744, 89230660, 89230662, 2, 640x360 
0x1382CA98, 37353941895200744, 89230694, 89230697, 3, 640x360 
0x1382CA98, 37353941895518912, 89230735, 89230739, 4, 640x360 
0x1382CA98, 37353941896001864, 89230783, 89230787, 4, 640x360 
0x1382CA98, 37353941896322360, 89230814, 89230818, 4, 640x360 
0x1382CA98, 37353941896674400, 89230848, 89230852, 4, 640x360 
0x1382CA98, 37353941896967168, 89230876, 89230878, 2, 640x360 
0x1382CA98, 37353941897285024, 89230914, 89230917, 3, 640x360 
0x1382CA98, 37353941897601168, 89230933, 89230939, 6, 640x360 
0x1382CA98, 37353941897927232, 89230965, 89230972, 7, 640x360 
0x1382CA98, 37353941898259720, 89231013, 89231017, 4, 640x360 
0x1382CA98, 37353941898569760, 89231042, 89231052, 10, 640x360 
0x1382CA98, 37353941898917000, 89231077, 89231093, 16, 640x360 
0x1382CA98, 37353941899199544, 89231107, 89231114, 7, 640x360 
0x1382CA98, 37353941899527040, 89231140, 89231149, 9, 640x360 
0x1382CA98, 37353941899846056, 89231164, 89231168, 4, 640x360 
0x1382CA98, 37353941900317984, 89231215, 89231222, 7, 640x360 
0x1382CA98, 37353941900638712, 89231243, 89231247, 4, 640x360 
0x1382CA98, 37353941900958064, 89231282, 89231294, 12, 640x360 
0x1382CA98, 37353941901278120, 89231308, 89231311, 3, 640x360 
0x1382CA98, 37353941901615896, 89231333, 89231344, 11, 640x360 
0x1382CA98, 37353941901922656, 89231366, 89231379, 13, 640x360 
0x1382CA98, 37353941902246728, 89231404, 89231410, 6, 640x360 
0x1382CA98, 37353941902558512, 89231437, 89231440, 3, 640x360 
0x1382CA98, 37353941902886416, 89231461, 89231463, 2, 640x360 
0x1382CA98, 37353941903208560, 89231502, 89231505, 3, 640x360 
0x1382CA98, 37353941903522256, 89231531, 89231534, 3, 640x360 
0x1382CA98, 37353941903846544, 89231566, 89231571, 5, 640x360 
0x1382CA98, 37353941904324456, 89231613, 89231617, 4, 640x360 
0x1382CA98, 37353941904638040, 89231640, 89231642, 2, 640x360 
0x1382CA98, 37353941904958088, 89231675, 89231677, 2, 640x360 
0x1382CA98, 37353941905282616, 89231700, 89231714, 14, 640x360 
0x1382CA98, 37353941905604520, 89231744, 89231747, 3, 640x360 
0x1382CA98, 37353941905942232, 89231776, 89231778, 2, 640x360 
0x1382CA98, 37353941906239632, 89231807, 89231810, 3, 640x360 
0x1382CA98, 37353941906617304, 89231846, 89231848, 2, 640x360 
0x1382CA98, 37353941906879112, 89231870, 89231873, 3, 640x360 
0x1382CA98, 37353941907198776, 89231902, 89231905, 3, 640x360 
0x1382CA98, 37353941907519232, 89231935, 89231945, 10, 640x360 
0x1382CA98, 37353941907848104, 89231966, 89231977, 11, 640x360 
0x1382CA98, 37353941908317864, 89232010, 89232014, 4, 640x360 
0x1382CA98, 37353941908643600, 89232046, 89232048, 2, 640x360 
0x1382CA98, 37353941908963024, 89232076, 89232078, 2, 640x360 
0x1382CA98, 37353941909282096, 89232106, 89232113, 7, 640x360 
0x1382CA98, 37353941909600024, 89232138, 89232141, 3, 640x360 
0x1382CA98, 37353941909919464, 89232172, 89232178, 6, 640x360 
0x1382CA98, 37353941910250416, 89232204, 89232212, 8, 640x360 
0x1382CA98, 37353941910558136, 89232229, 89232232, 3, 640x360 
0x1382CA98, 37353941910878192, 89232263, 89232268, 5, 640x360 
0x1382CA98, 37353941911199176, 89232297, 89232299, 2, 640x360 
0x1382CA98, 37353941911522848, 89232335, 89232346, 11, 640x360 
0x1382CA98, 37353941911860960, 89232371, 89232378, 7, 640x360 
0x1382CA98, 37353941912317536, 89232414, 89232421, 7, 640x360 
0x1382CA98, 37353941912647864, 89232447, 89232452, 5, 640x360 
0x1382CA98, 37353941912964616, 89232481, 89232490, 9, 640x360 
0x1382CA98, 37353941913288800, 89232513, 89232521, 8, 640x360 
0x1382CA98, 37353941913613144, 89232546, 89232551, 5, 640x360 
0x1382CA98, 37353941913930152, 89232577, 89232581, 4, 640x360 
0x1382CA98, 37353941914255392, 89232615, 89232635, 20, 640x360 
0x1382CA98, 37353941914560920, 89232653, 89232662, 9, 640x360 
0x1382CA98, 37353941914926464, 89232681, 89232714, 33, 640x360 
0x1382CA98, 37353941915313248, 89232746, 89232761, 15, 640x360 
0x1382CA98, 37353941915527040, 89232775, 89232786, 11, 640x360 
0x1382CA98, 37353941915842920, 89232791, 89232813, 22, 640x360 
0x1382CA98, 37353941916355544, 89232844, 89232855, 11, 640x360 
0x1382CA98, 37353941916654904, 89232864, 89232872, 8, 640x360 
0x1382CA98, 37353941916967704, 89232891, 89232911, 20, 640x360 
0x1382CA98, 37353941917286776, 89232923, 89232930, 7, 640x360 
0x1382CA98, 37353941917603000, 89232951, 89232957, 6, 640x360 
0x1382CA98, 37353941917931512, 89232977, 89232979, 2, 640x360 
0x1382CA98, 37353941918260328, 89233025, 89233041, 16, 640x360 
0x1382CA98, 37353941918618840, 89233044, 89233055, 11, 640x360 
0x1382CA98, 37353941918905000, 89233076, 89233078, 2, 640x360 
0x1382CA98, 37353941919198528, 89233097, 89233101, 4, 640x360 
0x1382CA98, 37353941919521144, 89233138, 89233151, 13, 640x360 
0x1382CA98, 37353941919842776, 89233174, 89233177, 3, 640x360 
0x1382CA98, 37353941920324352, 89233221, 89233230, 9, 640x360 
0x1382CA98, 37353941920641880, 89233254, 89233263, 9, 640x360 
0x1382CA98, 37353941920959648, 89233275, 89233279, 4, 640x360 
0x1382CA98, 37353941921294184, 89233313, 89233316, 3, 640x360 
0x1382CA98, 37353941921604544, 89233348, 89233350, 2, 640x360 
0x1382CA98, 37353941921932984, 89233366, 89233376, 10, 640x360 
0x1382CA98, 37353941922245544, 89233408, 89233414, 6, 640x360 
0x1382CA98, 37353941922558616, 89233440, 89233443, 3, 640x360 
0x1382CA98, 37353941922877792, 89233470, 89233478, 8, 640x360 
0x1382CA98, 37353941923198600, 89233496, 89233498, 2, 640x360 
0x1382CA98, 37353941923518176, 89233534, 89233537, 3, 640x360 
0x1382CA98, 37353941923837952, 89233560, 89233562, 2, 640x360 
0x1382CA98, 37353941924323512, 89233609, 89233611, 2, 640x360 
0x1382CA98, 37353941924637304, 89233652, 89233662, 10, 640x360 
0x1382CA98, 37353941924957576, 89233685, 89233693, 8, 640x360 
0x1382CA98, 37353941925281416, 89233713, 89233716, 3, 640x360 
0x1382CA98, 37353941925609384, 89233741, 89233746, 5, 640x360 
0x1382CA98, 37353941925932912, 89233773, 89233780, 7, 640x360 
0x1382CA98, 37353941926245416, 89233805, 89233808, 3, 640x360 
0x1382CA98, 37353941926562032, 89233838, 89233841, 3, 640x360 
0x1382CA98, 37353941926877768, 89233865, 89233868, 3, 640x360 
0x1382CA98, 37353941927197784, 89233891, 89233895, 4, 640x360 
0x1382CA98, 37353941927518664, 89233924, 89233926, 2, 640x360 
0x1382CA98, 37353941927849808, 89233963, 89233968, 5, 640x360 
0x1382CA98, 37353941928162960, 89233994, 89233996, 2, 640x360 
0x1382CA98, 37353941928639160, 89234047, 89234049, 2, 640x360 
0x1382CA98, 37353941928957632, 89234070, 89234074, 4, 640x360 
0x1382CA98, 37353941929277752, 89234109, 89234111, 2, 640x360 
0x1382CA98, 37353941929603800, 89234150, 89234152, 2, 640x360 
0x1382CA98, 37353941929917704, 89234169, 89234175, 6, 640x360 
0x1382CA98, 37353941930242392, 89234211, 89234223, 12, 640x360 
0x1382CA98, 37353941930583536, 89234247, 89234253, 6, 640x360 
0x1382CA98, 37353941930931168, 89234286, 89234290, 4, 640x360 
0x1382CA98, 37353941931202536, 89234308, 89234312, 4, 640x360 
0x1382CA98, 37353941931518600, 89234335, 89234342, 7, 640x360 
0x1382CA98, 37353941931838784, 89234363, 89234365, 2, 640x360 
0x1382CA98, 37353941932158528, 89234390, 89234397, 7, 640x360 
0x1382CA98, 37353941932646480, 89234447, 89234450, 3, 640x360 
0x1382CA98, 37353941932964448, 89234479, 89234481, 2, 640x360 
0x1382CA98, 37353941933281416, 89234504, 89234506, 2, 640x360 
0x1382CA98, 37353941933601288, 89234534, 89234544, 10, 640x360 
0x1382CA98, 37353941933925856, 89234565, 89234569, 4, 640x360 
0x1382CA98, 37353941934239984, 89234596, 89234599, 3, 640x360 
0x1382CA98, 37353941934558904, 89234631, 89234635, 4, 640x360 
0x1382CA98, 37353941934878584, 89234661, 89234664, 3, 640x360 
0x1382CA98, 37353941935197336, 89234697, 89234699, 2, 640x360 
0x1382CA98, 37353941935517816, 89234728, 89234731, 3, 640x360 
0x1382CA98, 37353941935840608, 89234761, 89234763, 2, 640x360 
0x1382CA98, 37353941936165032, 89234792, 89234798, 6, 640x360 
0x1382CA98, 37353941936641656, 89234842, 89234852, 10, 640x360 
0x1382CA98, 37353941936966368, 89234871, 89234874, 3, 640x360 
0x1382CA98, 37353941937284168, 89234899, 89234906, 7, 640x360 
0x1382CA98, 37353941937600120, 89234936, 89234943, 7, 640x360 
0x1382CA98, 37353941937919064, 89234965, 89234968, 3, 640x360 
0x1382CA98, 37353941938244408, 89235001, 89235010, 9, 640x360 
0x1382CA98, 37353941938558128, 89235043, 89235044, 1, 640x360 
0x1382CA98, 37353941938880904, 89235066, 89235071, 5, 640x360 
0x1382CA98, 37353941939197480, 89235095, 89235096, 1, 640x360 
0x1382CA98, 37353941939534496, 89235131, 89235138, 7, 640x360 
0x1382CA98, 37353941939842784, 89235169, 89235182, 13, 640x360 
0x1382CA98, 37353941940195136, 89235203, 89235211, 8, 640x360 
0x1382CA98, 37353941940656504, 89235258, 89235264, 6, 640x360 
0x1382CA98, 37353941940962360, 89235293, 89235296, 3, 640x360 
0x1382CA98, 37353941941302888, 89235305, 89235308, 3, 640x360 
0x1382CA98, 37353941941598464, 89235332, 89235339, 7, 640x360 
0x1382CA98, 37353941941929896, 89235372, 89235379, 7, 640x360 
0x1382CA98, 37353941942243944, 89235397, 89235401, 4, 640x360 
0x1382CA98, 37353941942563184, 89235439, 89235442, 3, 640x360 
0x1382CA98, 37353941942877352, 89235467, 89235473, 6, 640x360 
0x1382CA98, 37353941943197520, 89235494, 89235497, 3, 640x360 
0x1382CA98, 37353941943517856, 89235526, 89235534, 8, 640x360 
0x1382CA98, 37353941943837784, 89235571, 89235573, 2, 640x360 
0x1382CA98, 37353941944158088, 89235591, 89235596, 5, 640x360 
0x1382CA98, 37353941944639784, 89235638, 89235641, 3, 640x360 
0x1382CA98, 37353941944957480, 89235675, 89235677, 2, 640x360 
0x1382CA98, 37353941945277416, 89235700, 89235705, 5, 640x360 
0x1382CA98, 37353941945597520, 89235741, 89235744, 3, 640x360 
0x1382CA98, 37353941945921240, 89235769, 89235772, 3, 640x360 
0x1382CA98, 37353941946244328, 89235796, 89235799, 3, 640x360 
0x1382CA98, 37353941946558992, 89235837, 89235839, 2, 640x360 
0x1382CA98, 37353941946877384, 89235864, 89235867, 3, 640x360 
0x1382CA98, 37353941947198024, 89235895, 89235897, 2, 640x360 
0x1382CA98, 37353941947518664, 89235926, 89235928, 2, 640x360 
0x1382CA98, 37353941947846424, 89235971, 89235973, 2, 640x360 
0x1382CA98, 37353941948158592, 89235990, 89235997, 7, 640x360 
0x1382CA98, 37353941948643472, 89236041, 89236055, 14, 640x360 
0x1382CA98, 37353941948962112, 89236079, 89236082, 3, 640x360 
0x1382CA98, 37353941949276672, 89236107, 89236109, 2, 640x360 
0x1382CA98, 37353941949599424, 89236139, 89236142, 3, 640x360 
0x1382CA98, 37353941949944896, 89236183, 89236188, 5, 640x360 
0x1382CA98, 37353941950244384, 89236203, 89236207, 4, 640x360 
0x1382CA98, 37353941950563088, 89236240, 89236243, 3, 640x360 
0x1382CA98, 37353941950882984, 89236264, 89236265, 1, 640x360 
0x1382CA98, 37353941951197304, 89236305, 89236307, 2, 640x360 
0x1382CA98, 37353941951517272, 89236335, 89236338, 3, 640x360 
0x1382CA98, 37353941951837608, 89236358, 89236361, 3, 640x360 
0x1382CA98, 37353941952159408, 89236404, 89236413, 9, 640x360 
0x1382CA98, 37353941952643504, 89236448, 89236452, 4, 640x360 
0x1382CA98, 37353941952964616, 89236480, 89236482, 2, 640x360 
0x1382CA98, 37353941953326352, 89236511, 89236513, 2, 640x360 
0x1382CA98, 37353941953623976, 89236543, 89236545, 2, 640x360 
0x1382CA98, 37353941953923520, 89236572, 89236576, 4, 640x360 
0x1382CA98, 37353941954242528, 89236610, 89236612, 2, 640x360 
0x1382CA98, 37353941954586608, 89236645, 89236647, 2, 640x360 
0x1382CA98, 37353941954882184, 89236672, 89236676, 4, 640x360 
0x1382CA98, 37353941955197344, 89236706, 89236709, 3, 640x360 
0x1382CA98, 37353941955517184, 89236736, 89236739, 3, 640x360 
0x1382CA98, 37353941955843632, 89236768, 89236771, 3, 640x360 
0x1382CA98, 37353941956157232, 89236791, 89236793, 2, 640x360 
0x1382CA98, 37353941956498800, 89236834, 89236838, 4, 640x360 
0x1382CA98, 37353941956958704, 89236871, 89236875, 4, 640x360 
0x1382CA98, 37353941957277616, 89236908, 89236911, 3, 640x360 
0x1382CA98, 37353941957599128, 89236936, 89236944, 8, 640x360 
0x1382CA98, 37353941957926864, 89236972, 89236984, 12, 640x360 
0x1382CA98, 37353941958237832, 89237005, 89237013, 8, 640x360 
0x1382CA98, 37353941958560120, 89237038, 89237045, 7, 640x360 
0x1382CA98, 37353941958880776, 89237065, 89237074, 9, 640x360 
0x1382CA98, 37353941959203040, 89237093, 89237096, 3, 640x360 
0x1382CA98, 37353941959527960, 89237138, 89237142, 4, 640x360 
0x1382CA98, 37353941959842384, 89237175, 89237179, 4, 640x360 
0x1382CA98, 37353941960172528, 89237197, 89237205, 8, 640x360 
0x1382CA98, 37353941960482136, 89237234, 89237244, 10, 640x360 
0x1382CA98, 37353941960965712, 89237287, 89237291, 4, 640x360 
0x1382CA98, 37353941961283384, 89237319, 89237323, 4, 640x360 
0x1382CA98, 37353941961604736, 89237345, 89237349, 4, 640x360 
0x1382CA98, 37353941961955832, 89237378, 89237380, 2, 640x360 
0x1382CA98, 37353941962247624, 89237410, 89237412, 2, 640x360 
0x1382CA98, 37353941962564192, 89237437, 89237446, 9, 640x360 
0x1382CA98, 37353941962881728, 89237476, 89237478, 2, 640x360 
0x1382CA98, 37353941963202656, 89237497, 89237508, 11, 640x360 
0x1382CA98, 37353941963519472, 89237531, 89237534, 3, 640x360 
0x1382CA98, 37353941963840968, 89237557, 89237560, 3, 640x360 
0x1382CA98, 37353941964157432, 89237595, 89237596, 1, 640x360 
0x1382CA98, 37353941964477016, 89237638, 89237647, 9, 640x360 
0x1382CA98, 37353941964960496, 89237681, 89237683, 2, 640x360 
0x1382CA98, 37353941965276368, 89237720, 89237730, 10, 640x360 
0x1382CA98, 37353941965601544, 89237755, 89237757, 2, 640x360 
0x1382CA98, 37353941965923472, 89237766, 89237774, 8, 640x360 
0x1382CA98, 37353941966247728, 89237798, 89237804, 6, 640x360 
0x1382CA98, 37353941966557560, 89237836, 89237843, 7, 640x360 
0x1382CA98, 37353941966880504, 89237866, 89237873, 7, 640x360 
0x1382CA98, 37353941967198632, 89237905, 89237908, 3, 640x360 
0x1382CA98, 37353941967521120, 89237927, 89237930, 3, 640x360 
0x1382CA98, 37353941967845776, 89237959, 89237963, 4, 640x360 
0x1382CA98, 37353941968157848, 89238003, 89238012, 9, 640x360 
0x1382CA98, 37353941968479848, 89238024, 89238032, 8, 640x360 
0x1382CA98, 37353941968956480, 89238081, 89238083, 2, 640x360 
0x1382CA98, 37353941969298288, 89238107, 89238110, 3, 640x360 
0x1382CA98, 37353941969611552, 89238141, 89238143, 2, 640x360 
0x1382CA98, 37353941969935496, 89238176, 89238178, 2, 640x360 
0x1382CA98, 37353941970243288, 89238201, 89238204, 3, 640x360 
0x1382CA98, 37353941970579760, 89238239, 89238241, 2, 640x360 
0x1382CA98, 37353941970932536, 89238280, 89238288, 8, 640x360 
0x1382CA98, 37353941971200088, 89238309, 89238322, 13, 640x360 
0x1382CA98, 37353941971518824, 89238329, 89238332, 3, 640x360 
0x1382CA98, 37353941971849400, 89238372, 89238381, 9, 640x360 
0x1382CA98, 37353941972162952, 89238414, 89238422, 8, 640x360 
0x1382CA98, 37353941972489232, 89238440, 89238446, 6, 640x360 
0x1382CA98, 37353941972956632, 89238480, 89238483, 3, 640x360 
0x1382CA98, 37353941973287720, 89238507, 89238510, 3, 640x360 
0x1382CA98, 37353941973608632, 89238553, 89238556, 3, 640x360 
0x1382CA98, 37353941973930872, 89238578, 89238580, 2, 640x360 
0x1382CA98, 37353941974259680, 89238612, 89238615, 3, 640x360 
0x1382CA98, 37353941974564680, 89238646, 89238650, 4, 640x360 
0x1382CA98, 37353941974880568, 89238669, 89238679, 10, 640x360 
0x1382CA98, 37353941975201072, 89238713, 89238714, 1, 640x360 
0x1382CA98, 37353941975516520, 89238731, 89238735, 4, 640x360 
0x1382CA98, 37353941975837000, 89238762, 89238764, 2, 640x360 
0x1382CA98, 37353941976157032, 89238803, 89238805, 2, 640x360 
0x1382CA98, 37353941976481688, 89238829, 89238831, 2, 640x360 
0x1382CA98, 37353941976960136, 89238883, 89238887, 4, 640x360 
0x1382CA98, 37353941977280248, 89238904, 89238907, 3, 640x360 
0x1382CA98, 37353941977601984, 89238942, 89238945, 3, 640x360 
0x1382CA98, 37353941977920392, 89238974, 89238977, 3, 640x360 
0x1382CA98, 37353941978236184, 89239006, 89239008, 2, 640x360 
0x1382CA98, 37353941978561256, 89239027, 89239030, 3, 640x360 
0x1382CA98, 37353941978911472, 89239074, 89239076, 2, 640x360 
0x1382CA98, 37353941979202920, 89239097, 89239100, 3, 640x360 
0x1382CA98, 37353941979517784, 89239144, 89239146, 2, 640x360 
0x1382CA98, 37353941979844656, 89239157, 89239159, 2, 640x360 
0x1382CA98, 37353941980158424, 89239195, 89239198, 3, 640x360 
0x1382CA98, 37353941980488520, 89239229, 89239231, 2, 640x360 
0x1382CA98, 37353941980812688, 89239256, 89239258, 2, 640x360 
0x1382CA98, 37353941981276208, 89239319, 89239328, 9, 640x360 
0x1382CA98, 37353941981616096, 89239361, 89239364, 3, 640x360 
0x1382CA98, 37353941981928376, 89239381, 89239385, 4, 640x360 
0x1382CA98, 37353941982270064, 89239415, 89239419, 4, 640x360 
0x1382CA98, 37353941982556848, 89239453, 89239461, 8, 640x360 
0x1382CA98, 37353941982876472, 89239479, 89239489, 10, 640x360 
0x1382CA98, 37353941983234616, 89239515, 89239519, 4, 640x360 
0x1382CA98, 37353941983526112, 89239536, 89239546, 10, 640x360 
0x1382CA98, 37353941983837720, 89239564, 89239569, 5, 640x360 
0x1382CA98, 37353941984160840, 89239591, 89239596, 5, 640x360 
0x1382CA98, 37353941984500616, 89239628, 89239630, 2, 640x360 
0x1382CA98, 37353941984808864, 89239664, 89239667, 3, 640x360 
0x1382CA98, 37353941985280152, 89239709, 89239711, 2, 640x360 
0x1382CA98, 37353941985596224, 89239738, 89239740, 2, 640x360 
0x1382CA98, 37353941985918096, 89239765, 89239769, 4, 640x360 
0x1382CA98, 37353941986243728, 89239798, 89239805, 7, 640x360 
0x1382CA98, 37353941986563496, 89239831, 89239835, 4, 640x360 
0x1382CA98, 37353941986876864, 89239872, 89239874, 2, 640x360 
0x1382CA98, 37353941987200288, 89239895, 89239902, 7, 640x360 
0x1382CA98, 37353941987520152, 89239926, 89239929, 3, 640x360 
0x1382CA98, 37353941987836672, 89239971, 89239980, 9, 640x360 
0x1382CA98, 37353941988162568, 89240006, 89240014, 8, 640x360 
0x1382CA98, 37353941988476400, 89240024, 89240028, 4, 640x360 
0x1382CA98, 37353941988796768, 89240064, 89240066, 2, 640x360 
0x1382CA98, 37353941989286280, 89240101, 89240112, 11, 640x360 
0x1382CA98, 37353941989598768, 89240149, 89240162, 13, 640x360 
0x1382CA98, 37353941989958496, 89240174, 89240178, 4, 640x360 
0x1382CA98, 37353941990267880, 89240205, 89240215, 10, 640x360 
0x1382CA98, 37353941990557120, 89240239, 89240242, 3, 640x360 
0x1382CA98, 37353941990876656, 89240263, 89240267, 4, 640x360 
0x1382CA98, 37353941991195952, 89240295, 89240298, 3, 640x360 
0x1382CA98, 37353941991516032, 89240336, 89240338, 2, 640x360 
0x1382CA98, 37353941991840848, 89240358, 89240360, 2, 640x360 
0x1382CA98, 37353941992168040, 89240402, 89240405, 3, 640x360 
0x1382CA98, 37353941992480312, 89240428, 89240434, 6, 640x360 
0x1382CA98, 37353941992796040, 89240461, 89240463, 2, 640x360 
0x1382CA98, 37353941993276080, 89240515, 89240521, 6, 640x360 
0x1382CA98, 37353941993608144, 89240548, 89240551, 3, 640x360 
0x1382CA98, 37353941993928000, 89240570, 89240579, 9, 640x360 
0x1382CA98, 37353941994243816, 89240598, 89240602, 4, 640x360 
0x1382CA98, 37353941994566408, 89240629, 89240631, 2, 640x360 
0x1382CA98, 37353941994879688, 89240663, 89240665, 2, 640x360 
0x1382CA98, 37353941995201120, 89240693, 89240695, 2, 640x360 
0x1382CA98, 37353941995520736, 89240731, 89240733, 2, 640x360 
0x1382CA98, 37353941995836128, 89240769, 89240779, 10, 640x360 
0x1382CA98, 37353941996177504, 89240796, 89240798, 2, 640x360 
0x1382CA98, 37353941996482512, 89240834, 89240839, 5, 640x360 
0x1382CA98, 37353941996802456, 89240860, 89240863, 3, 640x360 
0x1382CA98, 37353941997276240, 89240915, 89240922, 7, 640x360 
0x1382CA98, 37353941997605152, 89240937, 89240944, 7, 640x360 
0x1382CA98, 37353941997923632, 89240974, 89240983, 9, 640x360 
0x1382CA98, 37353941998238120, 89241005, 89241007, 2, 640x360 
0x1382CA98, 37353941998563904, 89241040, 89241042, 2, 640x360 
0x1382CA98, 37353941998875536, 89241068, 89241073, 5, 640x360 
0x1382CA98, 37353941999199864, 89241101, 89241106, 5, 640x360 
0x1382CA98, 37353941999521960, 89241139, 89241141, 2, 640x360 
0x1382CA98, 37353941999841552, 89241162, 89241164, 2, 640x360 
0x1382CA98, 37353942000161904, 89241198, 89241201, 3, 640x360 
0x1382CA98, 37353942000479208, 89241225, 89241227, 2, 640x360 
0x1382CA98, 37353942000796216, 89241251, 89241255, 4, 640x360 
0x1382CA98, 37353942001279712, 89241306, 89241308, 2, 640x360 
0x1382CA98, 37353942001595648, 89241330, 89241333, 3, 640x360 
0x1382CA98, 37353942001916208, 89241364, 89241367, 3, 640x360 
0x1382CA98, 37353942002255456, 89241411, 89241413, 2, 640x360 
0x1382CA98, 37353942002558184, 89241431, 89241435, 4, 640x360 
0x1382CA98, 37353942002879384, 89241472, 89241475, 3, 640x360 
0x1382CA98, 37353942003201400, 89241494, 89241497, 3, 640x360 
0x1382CA98, 37353942003522488, 89241526, 89241529, 3, 640x360 
0x1382CA98, 37353942003839856, 89241557, 89241563, 6, 640x360 
0x1382CA98, 37353942004159568, 89241590, 89241596, 6, 640x360 
0x1382CA98, 37353942004476168, 89241623, 89241626, 3, 640x360 
0x1382CA98, 37353942004800256, 89241656, 89241658, 2, 640x360 
0x1382CA98, 37353942005278560, 89241703, 89241708, 5, 640x360 
0x1382CA98, 37353942005604624, 89241733, 89241738, 5, 640x360 
0x1382CA98, 37353942005916616, 89241765, 89241775, 10, 640x360 
0x1382CA98, 37353942006243240, 89241806, 89241809, 3, 640x360 
0x1382CA98, 37353942006576360, 89241838, 89241842, 4, 640x360 
0x1382CA98, 37353942006879448, 89241876, 89241878, 2, 640x360 
0x1382CA98, 37353942007195416, 89241902, 89241904, 2, 640x360 
0x1382CA98, 37353942007517960, 89241929, 89241932, 3, 640x360 
0x1382CA98, 37353942007841288, 89241961, 89241964, 3, 640x360 
0x1382CA98, 37353942008168392, 89241993, 89241995, 2, 640x360 
0x1382CA98, 37353942008490592, 89242025, 89242033, 8, 640x360 
0x1382CA98, 37353942008797016, 89242066, 89242074, 8, 640x360 
0x1382CA98, 37353942009117248, 89242089, 89242092, 3, 640x360 
0x1382CA98, 37353942009595296, 89242141, 89242143, 2, 640x360 
0x1382CA98, 37353942009915416, 89242171, 89242174, 3, 640x360 
0x1382CA98, 37353942010240040, 89242202, 89242206, 4, 640x360 
0x1382CA98, 37353942010560416, 89242234, 89242244, 10, 640x360 
0x1382CA98, 37353942010875368, 89242274, 89242281, 7, 640x360 
0x1382CA98, 37353942011199664, 89242301, 89242308, 7, 640x360 
0x1382CA98, 37353942011517032, 89242331, 89242333, 2, 640x360 
0x1382CA98, 37353942011838760, 89242359, 89242362, 3, 640x360 
0x1382CA98, 37353942012156160, 89242393, 89242395, 2, 640x360 
0x1382CA98, 37353942012480432, 89242424, 89242427, 3, 640x360 
0x1382CA98, 37353942012815240, 89242460, 89242461, 1, 640x360 
0x1382CA98, 37353942013122560, 89242503, 89242506, 3, 640x360 
0x1382CA98, 37353942013595448, 89242533, 89242537, 4, 640x360 
0x1382CA98, 37353942013928600, 89242575, 89242582, 7, 640x360 
0x1382CA98, 37353942014245016, 89242612, 89242614, 2, 640x360 
0x1382CA98, 37353942014563064, 89242641, 89242644, 3, 640x360 
0x1382CA98, 37353942014879304, 89242672, 89242675, 3, 640x360 
0x1382CA98, 37353942015195024, 89242698, 89242701, 3, 640x360 
0x1382CA98, 37353942015517016, 89242726, 89242728, 2, 640x360 
0x1382CA98, 37353942015835096, 89242773, 89242779, 6, 640x360 
0x1382CA98, 37353942016166064, 89242792, 89242795, 3, 640x360 
0x1382CA98, 37353942016477632, 89242835, 89242838, 3, 640x360 
0x1382CA98, 37353942016804640, 89242868, 89242879, 11, 640x360 
0x1382CA98, 37353942017124112, 89242900, 89242905, 5, 640x360 
0x1382CA98, 37353942017601584, 89242937, 89242945, 8, 640x360 
0x1382CA98, 37353942017927968, 89242970, 89242973, 3, 640x360 
0x1382CA98, 37353942018235216, 89242997, 89243000, 3, 640x360 
0x1382CA98, 37353942018556408, 89243030, 89243032, 2, 640x360 
0x1382CA98, 37353942018875848, 89243070, 89243072, 2, 640x360 
0x1382CA98, 37353942019209416, 89243095, 89243098, 3, 640x360 
0x1382CA98, 37353942019521240, 89243139, 89243143, 4, 640x360 
0x1382CA98, 37353942019849040, 89243160, 89243163, 3, 640x360 
0x1382CA98, 37353942020156464, 89243199, 89243201, 2, 640x360 
0x1382CA98, 37353942020482704, 89243223, 89243226, 3, 640x360 
0x1382CA98, 37353942020810624, 89243258, 89243261, 3, 640x360 
0x1382CA98, 37353942021123504, 89243301, 89243305, 4, 640x360 
0x1382CA98, 37353942021596040, 89243335, 89243340, 5, 640x360 
0x1382CA98, 37353942021927568, 89243366, 89243379, 13, 640x360 
0x1382CA98, 37353942022244968, 89243406, 89243412, 6, 640x360 
0x1382CA98, 37353942022555824, 89243430, 89243434, 4, 640x360 
0x1382CA98, 37353942022874880, 89243469, 89243477, 8, 640x360 
0x1382CA98, 37353942023195192, 89243502, 89243506, 4, 640x360 
0x1382CA98, 37353942023514960, 89243535, 89243539, 4, 640x360 
0x1382CA98, 37353942023835632, 89243561, 89243563, 2, 640x360 
0x1382CA98, 37353942024155808, 89243597, 89243599, 2, 640x360 
0x1382CA98, 37353942024475696, 89243625, 89243627, 2, 640x360 
0x1382CA98, 37353942024800000, 89243659, 89243662, 3, 640x360 
0x1382CA98, 37353942025119800, 89243686, 89243691, 5, 640x360 
0x1382CA98, 37353942025595344, 89243732, 89243735, 3, 640x360 
0x1382CA98, 37353942025931448, 89243765, 89243771, 6, 640x360 
0x1382CA98, 37353942026260656, 89243798, 89243805, 7, 640x360 
0x1382CA98, 37353942026567392, 89243834, 89243843, 9, 640x360 
0x1382CA98, 37353942026874984, 89243865, 89243869, 4, 640x360 
0x1382CA98, 37353942027229360, 89243895, 89243897, 2, 640x360 
0x1382CA98, 37353942027515976, 89243926, 89243934, 8, 640x360 
0x1382CA98, 37353942027837928, 89243973, 89243975, 2, 640x360 
0x1382CA98, 37353942028155408, 89244003, 89244012, 9, 640x360 
0x1382CA98, 37353942028479048, 89244032, 89244038, 6, 640x360 
0x1382CA98, 37353942028798080, 89244061, 89244063, 2, 640x360 
0x1382CA98, 37353942029122952, 89244101, 89244106, 5, 640x360 
0x1382CA98, 37353942029600176, 89244142, 89244147, 5, 640x360 
0x1382CA98, 37353942029919672, 89244176, 89244179, 3, 640x360 
0x1382CA98, 37353942030241912, 89244198, 89244203, 5, 640x360 
0x1382CA98, 37353942030555008, 89244231, 89244233, 2, 640x360 
0x1382CA98, 37353942030875120, 89244261, 89244263, 2, 640x360 
0x1382CA98, 37353942031195120, 89244295, 89244298, 3, 640x360 
0x1382CA98, 37353942031515432, 89244329, 89244331, 2, 640x360 
0x1382CA98, 37353942031835504, 89244358, 89244361, 3, 640x360 
0x1382CA98, 37353942032162688, 89244391, 89244393, 2, 640x360 
0x1382CA98, 37353942032478280, 89244426, 89244428, 2, 640x360 
0x1382CA98, 37353942032820872, 89244457, 89244460, 3, 640x360 
0x1382CA98, 37353942033123088, 89244487, 89244502, 15, 640x360 
0x1382CA98, 37353942033595736, 89244543, 89244554, 11, 640x360 
0x1382CA98, 37353942033924240, 89244571, 89244579, 8, 640x360 
0x1382CA98, 37353942034250736, 89244609, 89244616, 7, 640x360 
0x1382CA98, 37353942034556680, 89244638, 89244640, 2, 640x360 
0x1382CA98, 37353942034875200, 89244664, 89244668, 4, 640x360 
0x1382CA98, 37353942035194640, 89244692, 89244694, 2, 640x360 
0x1382CA98, 37353942035521752, 89244729, 89244731, 2, 640x360 
0x1382CA98, 37353942035835368, 89244758, 89244763, 5, 640x360 
0x1382CA98, 37353942036155680, 89244801, 89244805, 4, 640x360 
0x1382CA98, 37353942036481856, 89244826, 89244833, 7, 640x360 
0x1382CA98, 37353942036796008, 89244858, 89244862, 4, 640x360 
0x1382CA98, 37353942037115848, 89244885, 89244896, 11, 640x360 
0x1382CA98, 37353942037437216, 89244920, 89244927, 7, 640x360 
0x1382CA98, 37353942037916992, 89244970, 89244973, 3, 640x360 
0x1382CA98, 37353942038241504, 89244998, 89245007, 9, 640x360 
0x1382CA98, 37353942038563560, 89245030, 89245032, 2, 640x360 
0x1382CA98, 37353942038882272, 89245063, 89245067, 4, 640x360 
0x1382CA98, 37353942039197840, 89245094, 89245097, 3, 640x360 
0x1382CA98, 37353942039520072, 89245126, 89245129, 3, 640x360 
0x1382CA98, 37353942039839608, 89245164, 89245169, 5, 640x360 
0x1382CA98, 37353942040158728, 89245189, 89245198, 9, 640x360 
0x1382CA98, 37353942040481440, 89245228, 89245235, 7, 640x360 
0x1382CA98, 37353942040798904, 89245253, 89245263, 10, 640x360 
0x1382CA98, 37353942041115216, 89245287, 89245293, 6, 640x360 
0x1382CA98, 37353942041434952, 89245319, 89245325, 6, 640x360 
0x1382CA98, 37353942041918712, 89245366, 89245373, 7, 640x360 
0x1382CA98, 37353942042238896, 89245398, 89245404, 6, 640x360 
0x1382CA98, 37353942042604912, 89245441, 89245444, 3, 640x360 
0x1382CA98, 37353942042874280, 89245473, 89245475, 2, 640x360 
0x1382CA98, 37353942043196448, 89245496, 89245499, 3, 640x360 
0x1382CA98, 37353942043518880, 89245528, 89245532, 4, 640x360 
0x1382CA98, 37353942043840352, 89245566, 89245573, 7, 640x360 
0x1382CA98, 37353942044161864, 89245596, 89245598, 2, 640x360 
0x1382CA98, 37353942044478720, 89245625, 89245627, 2, 640x360 
0x1382CA98, 37353942044800264, 89245656, 89245658, 2, 640x360 
0x1382CA98, 37353942045115440, 89245691, 89245693, 2, 640x360 
0x1382CA98, 37353942045441088, 89245726, 89245728, 2, 640x360 
0x1382CA98, 37353942045916072, 89245765, 89245769, 4, 640x360 
0x1382CA98, 37353942046237288, 89245797, 89245801, 4, 640x360 
0x1382CA98, 37353942046562360, 89245827, 89245830, 3, 640x360 
0x1382CA98, 37353942046875912, 89245865, 89245869, 4, 640x360 
0x1382CA98, 37353942047196368, 89245897, 89245899, 2, 640x360 
0x1382CA98, 37353942047514608, 89245935, 89245938, 3, 640x360 
0x1382CA98, 37353942047834968, 89245961, 89245963, 2, 640x360 
0x1382CA98, 37353942048155136, 89245999, 89246004, 5, 640x360 
0x1382CA98, 37353942048478648, 89246026, 89246028, 2, 640x360 
0x1382CA98, 37353942048795280, 89246059, 89246061, 2, 640x360 
0x1382CA98, 37353942049120304, 89246092, 89246094, 2, 640x360 
0x1382CA98, 37353942049442072, 89246116, 89246131, 15, 640x360 
0x1382CA98, 37353942049929520, 89246182, 89246184, 2, 640x360 
0x1382CA98, 37353942050239232, 89246218, 89246230, 12, 640x360 
0x1382CA98, 37353942050557232, 89246242, 89246250, 8, 640x360 
0x1382CA98, 37353942050875456, 89246270, 89246278, 8, 640x360 
0x1382CA98, 37353942051194640, 89246297, 89246299, 2, 640x360 
0x1382CA98, 37353942051518752, 89246328, 89246332, 4, 640x360 
0x1382CA98, 37353942051835984, 89246360, 89246362, 2, 640x360 
0x1382CA98, 37353942052154576, 89246402, 89246405, 3, 640x360 
0x1382CA98, 37353942052478456, 89246431, 89246433, 2, 640x360 
0x1382CA98, 37353942052796968, 89246459, 89246461, 2, 640x360 
0x1382CA98, 37353942053114952, 89246496, 89246498, 2, 640x360 
0x1382CA98, 37353942053434656, 89246518, 89246522, 4, 640x360 
0x1382CA98, 37353942053920320, 89246573, 89246579, 6, 640x360 
0x1382CA98, 37353942054238608, 89246607, 89246610, 3, 640x360 
0x1382CA98, 37353942054563472, 89246627, 89246629, 2, 640x360 
0x1382CA98, 37353942054878312, 89246665, 89246667, 2, 640x360 
0x1382CA98, 37353942055194384, 89246693, 89246696, 3, 640x360 
0x1382CA98, 37353942055514048, 89246735, 89246745, 10, 640x360 
0x1382CA98, 37353942055838096, 89246772, 89246774, 2, 640x360 
0x1382CA98, 37353942056156136, 89246793, 89246795, 2, 640x360 
0x1382CA98, 37353942056493888, 89246838, 89246841, 3, 640x360 
0x1382CA98, 37353942056797128, 89246857, 89246860, 3, 640x360 
0x1382CA98, 37353942057118440, 89246884, 89246895, 11, 640x360 
0x1382CA98, 37353942057435320, 89246921, 89246928, 7, 640x360 
0x1382CA98, 37353942057926072, 89246989, 89246991, 2, 640x360 
0x1382CA98, 37353942058237768, 89247022, 89247030, 8, 640x360 
0x1382CA98, 37353942058577688, 89247084, 89247095, 11, 640x360 
0x1382CA98, 37353942059214464, 89247113, 89247115, 2, 640x360 
0x1382CA98, 37353942059516120, 89247139, 89247155, 16, 640x360 
0x1382CA98, 37353942059838200, 89247171, 89247185, 14, 640x360 
0x1382CA98, 37353942060158920, 89247199, 89247204, 5, 640x360 
0x1382CA98, 37353942060476688, 89247231, 89247233, 2, 640x360 
0x1382CA98, 37353942060802792, 89247270, 89247279, 9, 640x360 
0x1382CA98, 37353942061141936, 89247292, 89247297, 5, 640x360 
0x1382CA98, 37353942061489656, 89247339, 89247355, 16, 640x360 
0x1382CA98, 37353942061759952, 89247379, 89247391, 12, 640x360 
0x1382CA98, 37353942062239600, 89247410, 89247416, 6, 640x360 
0x1382CA98, 37353942062628528, 89247444, 89247446, 2, 640x360 
0x1382CA98, 37353942062880424, 89247466, 89247479, 13, 640x360 
0x1382CA98, 37353942063196672, 89247506, 89247514, 8, 640x360 
0x1382CA98, 37353942063517592, 89247526, 89247536, 10, 640x360 
0x1382CA98, 37353942063834096, 89247559, 89247563, 4, 640x360 
0x1382CA98, 37353942064155192, 89247591, 89247599, 8, 640x360 
0x1382CA98, 37353942064474624, 89247620, 89247624, 4, 640x360 
0x1382CA98, 37353942064794392, 89247656, 89247659, 3, 640x360 
0x1382CA98, 37353942065118320, 89247713, 89247742, 29, 640x360 
0x1382CA98, 37353942065462008, 89247766, 89247787, 21, 640x360 
0x1382CA98, 37353942065846456, 89247788, 89247814, 26, 640x360 
0x1382CA98, 37353942066269184, 89247830, 89247835, 5, 640x360 
0x1382CA98, 37353942066619216, 89247848, 89247854, 6, 640x360 
0x1382CA98, 37353942066879512, 89247877, 89247878, 1, 640x360 
0x1382CA98, 37353942067193872, 89247894, 89247907, 13, 640x360 
0x1382CA98, 37353942067513872, 89247929, 89247931, 2, 640x360 
0x1382CA98, 37353942067837760, 89247965, 89247971, 6, 640x360 
0x1382CA98, 37353942068180352, 89248013, 89248015, 2, 640x360 
0x1382CA98, 37353942068479808, 89248039, 89248042, 3, 640x360 
0x1382CA98, 37353942068794848, 89248060, 89248071, 11, 640x360 
0x1382CA98, 37353942069128312, 89248094, 89248096, 2, 640x360 
0x1382CA98, 37353942069441256, 89248136, 89248142, 6, 640x360 
0x1382CA98, 37353942069778840, 89248161, 89248164, 3, 640x360 
0x1382CA98, 37353942070239624, 89248204, 89248213, 9, 640x360 
0x1382CA98, 37353942070555184, 89248231, 89248235, 4, 640x360 
0x1382CA98, 37353942070873488, 89248263, 89248265, 2, 640x360 
0x1382CA98, 37353942071197568, 89248297, 89248298, 1, 640x360 
0x1382CA98, 37353942071513744, 89248333, 89248337, 4, 640x360 
0x1382CA98, 37353942071837088, 89248362, 89248363, 1, 640x360 
0x1382CA98, 37353942072161024, 89248395, 89248398, 3, 640x360 
0x1382CA98, 37353942072473952, 89248428, 89248429, 1, 640x360 
0x1382CA98, 37353942072800720, 89248459, 89248460, 1, 640x360 
0x1382CA98, 37353942073128056, 89248491, 89248494, 3, 640x360 
0x1382CA98, 37353942073443728, 89248525, 89248527, 2, 640x360 
0x1382CA98, 37353942073755760, 89248553, 89248556, 3, 640x360 
0x1382CA98, 37353942074237800, 89248607, 89248613, 6, 640x360 
0x1382CA98, 37353942074554304, 89248638, 89248641, 3, 640x360 
0x1382CA98, 37353942074878784, 89248661, 89248663, 2, 640x360 
0x1382CA98, 37353942075199104, 89248697, 89248704, 7, 640x360 
0x1382CA98, 37353942075519648, 89248735, 89248739, 4, 640x360 
0x1382CA98, 37353942075837456, 89248764, 89248766, 2, 640x360 
0x1382CA98, 37353942076162672, 89248792, 89248795, 3, 640x360 
0x1382CA98, 37353942076482920, 89248823, 89248826, 3, 640x360 
0x1382CA98, 37353942076794656, 89248852, 89248856, 4, 640x360 
0x1382CA98, 37353942077134232, 89248897, 89248901, 4, 640x360 
0x1382CA98, 37353942077446392, 89248930, 89248933, 3, 640x360 
0x1382CA98, 37353942077761216, 89248964, 89248967, 3, 640x360 
0x1382CA98, 37353942078235600, 89249010, 89249012, 2, 640x360 
0x1382CA98, 37353942078600576, 89249040, 89249042, 2, 640x360 
0x1382CA98, 37353942078886856, 89249066, 89249073, 7, 640x360 
0x1382CA98, 37353942079193736, 89249102, 89249107, 5, 640x360 
0x1382CA98, 37353942079521360, 89249137, 89249145, 8, 640x360 
0x1382CA98, 37353942079839416, 89249171, 89249180, 9, 640x360 
0x1382CA98, 37353942080178704, 89249200, 89249206, 6, 640x360 
0x1382CA98, 37353942080487880, 89249225, 89249228, 3, 640x360 
0x1382CA98, 37353942080807736, 89249259, 89249262, 3, 640x360 
0x1382CA98, 37353942081132712, 89249294, 89249297, 3, 640x360 
0x1382CA98, 37353942081441792, 89249327, 89249329, 2, 640x360 
0x1382CA98, 37353942081782640, 89249358, 89249361, 3, 640x360 
0x1382CA98, 37353942082251760, 89249413, 89249415, 2, 640x360 
0x1382CA98, 37353942082555968, 89249433, 89249439, 6, 640x360 
0x1382CA98, 37353942082910872, 89249469, 89249478, 9, 640x360 
0x1382CA98, 37353942083193672, 89249506, 89249513, 7, 640x360 
0x1382CA98, 37353942083517608, 89249538, 89249542, 4, 640x360 
0x1382CA98, 37353942083834008, 89249561, 89249564, 3, 640x360 
0x1382CA98, 37353942084153576, 89249602, 89249605, 3, 640x360 
0x1382CA98, 37353942084473880, 89249629, 89249631, 2, 640x360 
0x1382CA98, 37353942084794352, 89249657, 89249660, 3, 640x360 
0x1382CA98, 37353942085118720, 89249692, 89249695, 3, 640x360 
0x1382CA98, 37353942085434584, 89249725, 89249727, 2, 640x360 
0x1382CA98, 37353942085757504, 89249758, 89249770, 12, 640x360 
0x1382CA98, 37353942086266064, 89249815, 89249829, 14, 640x360 
0x1382CA98, 37353942086615912, 89249837, 89249846, 9, 640x360 
0x1382CA98, 37353942086873216, 89249866, 89249871, 5, 640x360 
0x1382CA98, 37353942087212392, 89249904, 89249914, 10, 640x360 
0x1382CA98, 37353942087518056, 89249930, 89249932, 2, 640x360 
0x1382CA98, 37353942087840616, 89249968, 89249978, 10, 640x360 
0x1382CA98, 37353942088167928, 89249998, 89250003, 5, 640x360 
0x1382CA98, 37353942088485808, 89250026, 89250028, 2, 640x360 
0x1382CA98, 37353942088813936, 89250068, 89250072, 4, 640x360 
0x1382CA98, 37353942089117424, 89250104, 89250111, 7, 640x360 
0x1382CA98, 37353942089442168, 89250140, 89250148, 8, 640x360 
0x1382CA98, 37353942089775792, 89250161, 89250171, 10, 640x360 
0x1382CA98, 37353942090087976, 89250181, 89250186, 5, 640x360 
0x1382CA98, 37353942090552848, 89250234, 89250244, 10, 640x360 
0x1382CA98, 37353942090872968, 89250265, 89250269, 4, 640x360 
0x1382CA98, 37353942091194048, 89250297, 89250300, 3, 640x360 
0x1382CA98, 37353942091516648, 89250346, 89250351, 5, 640x360 
0x1382CA98, 37353942091836008, 89250366, 89250374, 8, 640x360 
0x1382CA98, 37353942092159904, 89250403, 89250407, 4, 640x360 
0x1382CA98, 37353942092484880, 89250433, 89250444, 11, 640x360 
0x1382CA98, 37353942092797888, 89250471, 89250474, 3, 640x360 
0x1382CA98, 37353942093130208, 89250496, 89250498, 2, 640x360 
0x1382CA98, 37353942093434056, 89250525, 89250527, 2, 640x360 
0x1382CA98, 37353942093759920, 89250559, 89250563, 4, 640x360 
0x1382CA98, 37353942094083984, 89250592, 89250594, 2, 640x360 
0x1382CA98, 37353942094553232, 89250628, 89250631, 3, 640x360 
0x1382CA98, 37353942094873408, 89250660, 89250663, 3, 640x360 
0x1382CA98, 37353942095194736, 89250696, 89250698, 2, 640x360 
0x1382CA98, 37353942095513120, 89250730, 89250732, 2, 640x360 
0x1382CA98, 37353942095836008, 89250765, 89250767, 2, 640x360 
0x1382CA98, 37353942096153568, 89250790, 89250792, 2, 640x360 
0x1382CA98, 37353942096473984, 89250821, 89250824, 3, 640x360 
0x1382CA98, 37353942096795192, 89250858, 89250860, 2, 640x360 
0x1382CA98, 37353942097115104, 89250892, 89250896, 4, 640x360 
0x1382CA98, 37353942097447336, 89250916, 89250923, 7, 640x360 
0x1382CA98, 37353942097754600, 89250948, 89250953, 5, 640x360 
0x1382CA98, 37353942098088400, 89250987, 89250994, 7, 640x360 
0x1382CA98, 37353942098554304, 89251041, 89251044, 3, 640x360 
0x1382CA98, 37353942098884592, 89251061, 89251063, 2, 640x360 
0x1382CA98, 37353942099193280, 89251103, 89251113, 10, 640x360 
0x1382CA98, 37353942099522656, 89251138, 89251146, 8, 640x360 
0x1382CA98, 37353942099836848, 89251158, 89251162, 4, 640x360 
0x1382CA98, 37353942100159088, 89251199, 89251201, 2, 640x360 
0x1382CA98, 37353942100473184, 89251225, 89251228, 3, 640x360 
0x1382CA98, 37353942100801112, 89251254, 89251257, 3, 640x360 
0x1382CA98, 37353942101132352, 89251295, 89251297, 2, 640x360 
0x1382CA98, 37353942101436912, 89251326, 89251329, 3, 640x360 
0x1382CA98, 37353942101757824, 89251358, 89251360, 2, 640x360 
0x1382CA98, 37353942102083208, 89251387, 89251394, 7, 640x360 
0x1382CA98, 37353942102552584, 89251442, 89251451, 9, 640x360 
0x1382CA98, 37353942102875984, 89251466, 89251481, 15, 640x360 
0x1382CA98, 37353942103195288, 89251508, 89251512, 4, 640x360 
0x1382CA98, 37353942103524896, 89251539, 89251542, 3, 640x360 
0x1382CA98, 37353942103833320, 89251570, 89251574, 4, 640x360 
0x1382CA98, 37353942104157448, 89251611, 89251613, 2, 640x360 
0x1382CA98, 37353942104476784, 89251631, 89251637, 6, 640x360 
0x1382CA98, 37353942104803432, 89251681, 89251695, 14, 640x360 
0x1382CA98, 37353942105147272, 89251703, 89251722, 19, 640x360 
0x1382CA98, 37353942105462376, 89251731, 89251743, 12, 640x360 
0x1382CA98, 37353942105775072, 89251759, 89251762, 3, 640x360 
0x1382CA98, 37353942106075136, 89251791, 89251794, 3, 640x360 
0x1382CA98, 37353942106557216, 89251838, 89251847, 9, 640x360 
0x1382CA98, 37353942106872696, 89251864, 89251867, 3, 640x360 
0x1382CA98, 37353942107192472, 89251899, 89251904, 5, 640x360 
0x1382CA98, 37353942107521424, 89251926, 89251929, 3, 640x360 
0x1382CA98, 37353942107839608, 89251965, 89251970, 5, 640x360 
0x1382CA98, 37353942108156432, 89251990, 89251994, 4, 640x360 
0x1382CA98, 37353942108501608, 89252025, 89252029, 4, 640x360 
0x1382CA98, 37353942108809544, 89252061, 89252063, 2, 640x360 
0x1382CA98, 37353942109128064, 89252098, 89252101, 3, 640x360 
0x1382CA98, 37353942109433192, 89252125, 89252129, 4, 640x360 
0x1382CA98, 37353942109752992, 89252168, 89252174, 6, 640x360 
0x1382CA98, 37353942110086616, 89252191, 89252194, 3, 640x360 
0x1382CA98, 37353942110552592, 89252231, 89252241, 10, 640x360 
0x1382CA98, 37353942110875912, 89252263, 89252265, 2, 640x360 
0x1382CA98, 37353942111196352, 89252295, 89252298, 3, 640x360 
0x1382CA98, 37353942111512944, 89252330, 89252341, 11, 640x360 
0x1382CA98, 37353942111848072, 89252369, 89252372, 3, 640x360 
0x1382CA98, 37353942112152880, 89252404, 89252408, 4, 640x360 
0x1382CA98, 37353942112473248, 89252430, 89252432, 2, 640x360 
0x1382CA98, 37353942112795816, 89252467, 89252472, 5, 640x360 
0x1382CA98, 37353942113116688, 89252494, 89252497, 3, 640x360 
0x1382CA98, 37353942113452752, 89252527, 89252530, 3, 640x360 
0x1382CA98, 37353942113762296, 89252578, 89252586, 8, 640x360 
0x1382CA98, 37353942114127464, 89252596, 89252598, 2, 640x360 
0x1382CA98, 37353942114438720, 89252639, 89252654, 15, 640x360 
0x1382CA98, 37353942114875568, 89252674, 89252681, 7, 640x360 
0x1382CA98, 37353942115197880, 89252709, 89252711, 2, 640x360 
0x1382CA98, 37353942115515168, 89252738, 89252742, 4, 640x360 
0x1382CA98, 37353942115846352, 89252778, 89252794, 16, 640x360 
0x1382CA98, 37353942116206736, 89252832, 89252843, 11, 640x360 
0x1382CA98, 37353942116489888, 89252844, 89252860, 16, 640x360 
0x1382CA98, 37353942116804392, 89252878, 89252886, 8, 640x360 
0x1382CA98, 37353942117132312, 89252948, 89252957, 9, 640x360 
0x1382CA98, 37353942117510664, 89252966, 89252985, 19, 640x360 
0x1382CA98, 37353942117966016, 89253013, 89253015, 2, 640x360 
0x1382CA98, 37353942118431928, 89253060, 89253068, 8, 640x360 
0x1382CA98, 37353942118670416, 89253081, 89253094, 13, 640x360 
0x1382CA98, 37353942119212368, 89253132, 89253146, 14, 640x360 
0x1382CA98, 37353942119531456, 89253148, 89253152, 4, 640x360 
0x1382CA98, 37353942119836344, 89253175, 89253179, 4, 640x360 
0x1382CA98, 37353942120153424, 89253207, 89253209, 2, 640x360 
0x1382CA98, 37353942120472864, 89253226, 89253229, 3, 640x360 
0x1382CA98, 37353942120795568, 89253261, 89253273, 12, 640x360 
0x1382CA98, 37353942121128752, 89253300, 89253306, 6, 640x360 
0x1382CA98, 37353942121439272, 89253323, 89253327, 4, 640x360 
0x1382CA98, 37353942121772136, 89253364, 89253368, 4, 640x360 
0x1382CA98, 37353942122094120, 89253399, 89253411, 12, 640x360 
0x1382CA98, 37353942122444224, 89253440, 89253456, 16, 640x360 
0x1382CA98, 37353942122876648, 89253473, 89253480, 7, 640x360 
0x1382CA98, 37353942123204240, 89253522, 89253526, 4, 640x360 
0x1382CA98, 37353942123528360, 89253546, 89253570, 24, 640x360 
0x1382CA98, 37353942123845344, 89253576, 89253590, 14, 640x360 
0x1382CA98, 37353942124169592, 89253616, 89253625, 9, 640x360 
0x1382CA98, 37353942124486216, 89253643, 89253645, 2, 640x360 
0x1382CA98, 37353942124793336, 89253665, 89253675, 10, 640x360 
0x1382CA98, 37353942125120744, 89253707, 89253711, 4, 640x360 
0x1382CA98, 37353942125444040, 89253736, 89253745, 9, 640x360 
0x1382CA98, 37353942125788184, 89253765, 89253770, 5, 640x360 
0x1382CA98, 37353942126090152, 89253788, 89253792, 4, 640x360 
0x1382CA98, 37353942126406728, 89253826, 89253833, 7, 640x360 
0x1382CA98, 37353942126889944, 89253874, 89253877, 3, 640x360 
0x1382CA98, 37353942127194048, 89253906, 89253914, 8, 640x360 
0x1382CA98, 37353942127515016, 89253940, 89253942, 2, 640x360 
0x1382CA98, 37353942127840672, 89253966, 89253969, 3, 640x360 
0x1382CA98, 37353942128172896, 89254004, 89254014, 10, 640x360 
0x1382CA98, 37353942128478952, 89254032, 89254035, 3, 640x360 
0x1382CA98, 37353942128802640, 89254063, 89254065, 2, 640x360 
0x1382CA98, 37353942129112280, 89254090, 89254093, 3, 640x360 
0x1382CA98, 37353942129432648, 89254121, 89254125, 4, 640x360 
0x1382CA98, 37353942129753328, 89254157, 89254159, 2, 640x360 
0x1382CA98, 37353942130073464, 89254184, 89254186, 2, 640x360 
0x1382CA98, 37353942130392536, 89254219, 89254221, 2, 640x360 
0x1382CA98, 37353942130872208, 89254260, 89254263, 3, 640x360 
0x1382CA98, 37353942131196976, 89254297, 89254301, 4, 640x360 
0x1382CA98, 37353942131512528, 89254328, 89254331, 3, 640x360 
0x1382CA98, 37353942131836384, 89254360, 89254363, 3, 640x360 
0x1382CA98, 37353942132156464, 89254403, 89254405, 2, 640x360 
0x1382CA98, 37353942132472832, 89254426, 89254429, 3, 640x360 
0x1382CA98, 37353942132798976, 89254458, 89254461, 3, 640x360 
0x1382CA98, 37353942133112760, 89254491, 89254502, 11, 640x360 
0x1382CA98, 37353942133446760, 89254523, 89254526, 3, 640x360 
0x1382CA98, 37353942133759320, 89254574, 89254578, 4, 640x360 
0x1382CA98, 37353942134119456, 89254602, 89254640, 38, 640x360 
0x1382CA98, 37353942134471944, 89254646, 89254676, 30, 640x360 
0x1382CA98, 37353942134881240, 89254692, 89254695, 3, 640x360 
0x1382CA98, 37353942135259216, 89254723, 89254748, 25, 640x360 
0x1382CA98, 37353942135521352, 89254781, 89254824, 43, 640x360 
0x1382CA98, 37353942136159040, 89254831, 89254836, 5, 640x360 
0x1382CA98, 37353942136584816, 89254857, 89254865, 8, 640x360 
0x1382CA98, 37353942136853856, 89254875, 89254889, 14, 640x360 
0x1382CA98, 37353942137127184, 89254896, 89254968, 72, 640x360 
0x1382CA98, 37353942137455528, 89254983, 89255010, 27, 640x360 
0x1382CA98, 37353942138112264, 89255013, 89255032, 19, 640x360 
0x1382CA98, 37353942138469816, 89255039, 89255043, 4, 640x360 
0x1382CA98, 37353942138940904, 89255090, 89255094, 4, 640x360 
0x1382CA98, 37353942139203048, 89255115, 89255125, 10, 640x360 
0x1382CA98, 37353942139519672, 89255144, 89255187, 43, 640x360 
0x1382CA98, 37353942139872712, 89255192, 89255221, 29, 640x360 
0x1382CA98, 37353942140260208, 89255224, 89255240, 16, 640x360 
0x1382CA98, 37353942140486272, 89255246, 89255254, 8, 640x360 
0x1382CA98, 37353942140824488, 89255291, 89255299, 8, 640x360 
0x1382CA98, 37353942141458024, 89255355, 89255362, 7, 640x360 
0x1382CA98, 37353942141796560, 89255374, 89255408, 34, 640x360 
0x1382CA98, 37353942142091976, 89255418, 89255443, 25, 640x360 
0x1382CA98, 37353942142469328, 89255443, 89255462, 19, 640x360 
0x1382CA98, 37353942142772560, 89255471, 89255486, 15, 640x360 
0x1382CA98, 37353942143195328, 89255509, 89255511, 2, 640x360 
0x1382CA98, 37353942143516440, 89255542, 89255563, 21, 640x360 
0x1382CA98, 37353942143841576, 89255580, 89255618, 38, 640x360 
0x1382CA98, 37353942144160472, 89255628, 89255639, 11, 640x360 
0x1382CA98, 37353942144494584, 89255642, 89255655, 13, 640x360 
0x1382CA98, 37353942144804624, 89255669, 89255688, 19, 640x360 
0x1382CA98, 37353942145180560, 89255712, 89255715, 3, 640x360 
0x1382CA98, 37353942145443848, 89255728, 89255731, 3, 640x360 
0x1382CA98, 37353942145780272, 89255773, 89255810, 37, 640x360 
0x1382CA98, 37353942146085640, 89255811, 89255824, 13, 640x360 
0x1382CA98, 37353942146415288, 89255858, 89255867, 9, 640x360 
0x1382CA98, 37353942146818952, 89255894, 89255928, 34, 640x360 
0x1382CA98, 37353942147254552, 89255928, 89255946, 18, 640x360 
0x1382CA98, 37353942147525552, 89255987, 89255990, 3, 640x360 
0x1382CA98, 37353942147834248, 89255995, 89256015, 20, 640x360 
0x1382CA98, 37353942148525760, 89256036, 89256051, 15, 640x360 
0x1382CA98, 37353942148843072, 89256068, 89256073, 5, 640x360 
0x1382CA98, 37353942149121136, 89256089, 89256098, 9, 640x360 
0x1382CA98, 37353942149439304, 89256135, 89256142, 7, 640x360 
0x1382CA98, 37353942149766320, 89256160, 89256164, 4, 640x360 
0x1382CA98, 37353942150075688, 89256204, 89256210, 6, 640x360 
0x1382CA98, 37353942150393832, 89256229, 89256231, 2, 640x360 
0x1382CA98, 37353942150712288, 89256258, 89256268, 10, 640x360 
0x1382CA98, 37353942151195648, 89256309, 89256316, 7, 640x360 
0x1382CA98, 37353942151521008, 89256333, 89256340, 7, 640x360 
0x1382CA98, 37353942151834472, 89256370, 89256378, 8, 640x360 
0x1382CA98, 37353942152153536, 89256400, 89256407, 7, 640x360 
0x1382CA98, 37353942152472288, 89256430, 89256432, 2, 640x360 
0x1382CA98, 37353942152793440, 89256466, 89256469, 3, 640x360 
0x1382CA98, 37353942153115200, 89256497, 89256499, 2, 640x360 
0x1382CA98, 37353942153432872, 89256532, 89256535, 3, 640x360 
0x1382CA98, 37353942153758024, 89256559, 89256565, 6, 640x360 
0x1382CA98, 37353942154083120, 89256596, 89256598, 2, 640x360 
0x1382CA98, 37353942154408080, 89256616, 89256619, 3, 640x360 
0x1382CA98, 37353942154717856, 89256649, 89256653, 4, 640x360 
0x1382CA98, 37353942155195392, 89256696, 89256705, 9, 640x360 
0x1382CA98, 37353942155515184, 89256728, 89256731, 3, 640x360 
0x1382CA98, 37353942155836880, 89256761, 89256764, 3, 640x360 
0x1382CA98, 37353942156175448, 89256805, 89256807, 2, 640x360 
0x1382CA98, 37353942156471856, 89256825, 89256827, 2, 640x360 
0x1382CA98, 37353942156808872, 89256859, 89256861, 2, 640x360 
0x1382CA98, 37353942157117008, 89256897, 89256899, 2, 640x360 
0x1382CA98, 37353942157432032, 89256919, 89256923, 4, 640x360 
0x1382CA98, 37353942157751952, 89256947, 89256954, 7, 640x360 
0x1382CA98, 37353942158072944, 89256992, 89257000, 8, 640x360 
0x1382CA98, 37353942158395152, 89257025, 89257028, 3, 640x360 
0x1382CA98, 37353942158736456, 89257059, 89257061, 2, 640x360 
0x1382CA98, 37353942159192704, 89257098, 89257101, 3, 640x360 
0x1382CA98, 37353942159523136, 89257140, 89257151, 11, 640x360 
0x1382CA98, 37353942159835592, 89257159, 89257162, 3, 640x360 
0x1382CA98, 37353942160161832, 89257202, 89257214, 12, 640x360 
0x1382CA98, 37353942160476080, 89257227, 89257235, 8, 640x360 
0x1382CA98, 37353942160798472, 89257258, 89257267, 9, 640x360 
0x1382CA98, 37353942161112792, 89257297, 89257298, 1, 640x360 
0x1382CA98, 37353942161434728, 89257320, 89257329, 9, 640x360 
0x1382CA98, 37353942161757760, 89257357, 89257360, 3, 640x360 
0x1382CA98, 37353942162088320, 89257392, 89257394, 2, 640x360 
0x1382CA98, 37353942162400768, 89257412, 89257415, 3, 640x360 
0x1382CA98, 37353942162711576, 89257448, 89257453, 5, 640x360 
0x1382CA98, 37353942163195104, 89257499, 89257501, 2, 640x360 
0x1382CA98, 37353942163511440, 89257527, 89257530, 3, 640x360 
0x1382CA98, 37353942163836280, 89257572, 89257580, 8, 640x360 
0x1382CA98, 37353942164154432, 89257595, 89257602, 7, 640x360 
0x1382CA98, 37353942164472784, 89257623, 89257632, 9, 640x360 
0x1382CA98, 37353942164800416, 89257660, 89257662, 2, 640x360 
0x1382CA98, 37353942165113264, 89257683, 89257689, 6, 640x360 
0x1382CA98, 37353942165434968, 89257716, 89257720, 4, 640x360 
0x1382CA98, 37353942165759744, 89257751, 89257762, 11, 640x360 
0x1382CA98, 37353942166089480, 89257789, 89257796, 7, 640x360 
0x1382CA98, 37353942166392904, 89257813, 89257815, 2, 640x360 
0x1382CA98, 37353942166712104, 89257847, 89257851, 4, 640x360 
0x1382CA98, 37353942167195576, 89257897, 89257900, 3, 640x360 
0x1382CA98, 37353942167515056, 89257933, 89257939, 6, 640x360 
0x1382CA98, 37353942167831216, 89257959, 89257961, 2, 640x360 
0x1382CA98, 37353942168151664, 89257991, 89257994, 3, 640x360 
0x1382CA98, 37353942168474864, 89258033, 89258039, 6, 640x360 
0x1382CA98, 37353942168791984, 89258067, 89258072, 5, 640x360 
0x1382CA98, 37353942169113816, 89258099, 89258115, 16, 640x360 
0x1382CA98, 37353942169434400, 89258136, 89258140, 4, 640x360 
0x1382CA98, 37353942169777856, 89258159, 89258162, 3, 640x360 
0x1382CA98, 37353942170080184, 89258191, 89258203, 12, 640x360 
0x1382CA98, 37353942170427472, 89258227, 89258229, 2, 640x360 
0x1382CA98, 37353942170717328, 89258254, 89258261, 7, 640x360 
0x1382CA98, 37353942171035232, 89258283, 89258288, 5, 640x360 
0x1382CA98, 37353942171510768, 89258328, 89258339, 11, 640x360 
0x1382CA98, 37353942171831392, 89258361, 89258368, 7, 640x360 
0x1382CA98, 37353942172155888, 89258394, 89258404, 10, 640x360 
0x1382CA98, 37353942172477752, 89258425, 89258434, 9, 640x360 
0x1382CA98, 37353942172798192, 89258458, 89258460, 2, 640x360 
0x1382CA98, 37353942173111016, 89258499, 89258502, 3, 640x360 
0x1382CA98, 37353942173436112, 89258518, 89258526, 8, 640x360 
0x1382CA98, 37353942173754864, 89258557, 89258564, 7, 640x360 
0x1382CA98, 37353942174090016, 89258588, 89258597, 9, 640x360 
0x1382CA98, 37353942174429256, 89258623, 89258631, 8, 640x360 
0x1382CA98, 37353942174711224, 89258654, 89258658, 4, 640x360 
0x1382CA98, 37353942175034584, 89258683, 89258694, 11, 640x360 
0x1382CA98, 37353942175515024, 89258737, 89258743, 6, 640x360 
0x1382CA98, 37353942175830744, 89258759, 89258768, 9, 640x360 
0x1382CA98, 37353942176151288, 89258794, 89258796, 2, 640x360 
0x1382CA98, 37353942176474568, 89258825, 89258828, 3, 640x360 
0x1382CA98, 37353942176794392, 89258856, 89258861, 5, 640x360 
0x1382CA98, 37353942177110976, 89258884, 89258895, 11, 640x360 
0x1382CA98, 37353942177430920, 89258925, 89258928, 3, 640x360 
0x1382CA98, 37353942177754496, 89258956, 89258963, 7, 640x360 
0x1382CA98, 37353942178078640, 89258988, 89258995, 7, 640x360 
0x1382CA98, 37353942178398848, 89259018, 89259029, 11, 640x360 
0x1382CA98, 37353942178712320, 89259051, 89259058, 7, 640x360 
0x1382CA98, 37353942179036264, 89259083, 89259088, 5, 640x360 
0x1382CA98, 37353942179516080, 89259137, 89259140, 3, 640x360 
0x1382CA98, 37353942179833136, 89259158, 89259165, 7, 640x360 
0x1382CA98, 37353942180154744, 89259191, 89259199, 8, 640x360 
0x1382CA98, 37353942180472968, 89259227, 89259236, 9, 640x360 
0x1382CA98, 37353942180793112, 89259256, 89259260, 4, 640x360 
0x1382CA98, 37353942181111584, 89259294, 89259302, 8, 640x360 
0x1382CA98, 37353942181431264, 89259314, 89259318, 4, 640x360 
0x1382CA98, 37353942181756792, 89259353, 89259360, 7, 640x360 
0x1382CA98, 37353942182084096, 89259382, 89259386, 4, 640x360 
0x1382CA98, 37353942182392280, 89259426, 89259434, 8, 640x360 
0x1382CA98, 37353942182728152, 89259458, 89259465, 7, 640x360 
0x1382CA98, 37353942183036224, 89259491, 89259493, 2, 640x360 
0x1382CA98, 37353942183510376, 89259529, 89259531, 2, 640x360 
0x1382CA98, 37353942183831624, 89259562, 89259569, 7, 640x360 
0x1382CA98, 37353942184151096, 89259604, 89259613, 9, 640x360 
0x1382CA98, 37353942184483960, 89259625, 89259633, 8, 640x360 
0x1382CA98, 37353942184791944, 89259657, 89259667, 10, 640x360 
0x1382CA98, 37353942185113816, 89259692, 89259695, 3, 640x360 
0x1382CA98, 37353942185435888, 89259721, 89259730, 9, 640x360 
0x1382CA98, 37353942185755168, 89259747, 89259752, 5, 640x360 
0x1382CA98, 37353942186085336, 89259782, 89259785, 3, 640x360 
0x1382CA98, 37353942186396200, 89259825, 89259833, 8, 640x360 
0x1382CA98, 37353942186711360, 89259857, 89259859, 2, 640x360 
0x1382CA98, 37353942187031096, 89259885, 89259890, 5, 640x360 
0x1382CA98, 37353942187510400, 89259937, 89259943, 6, 640x360 
0x1382CA98, 37353942187834576, 89259967, 89259972, 5, 640x360 
0x1382CA98, 37353942188150656, 89259991, 89259993, 2, 640x360 
0x1382CA98, 37353942188474608, 89260028, 89260029, 1, 640x360 
0x1382CA98, 37353942188791728, 89260060, 89260066, 6, 640x360 
0x1382CA98, 37353942189111256, 89260086, 89260091, 5, 640x360 
0x1382CA98, 37353942189433264, 89260122, 89260125, 3, 640x360 
0x1382CA98, 37353942189752472, 89260148, 89260151, 3, 640x360 
0x1382CA98, 37353942190076720, 89260188, 89260192, 4, 640x360 
0x1382CA98, 37353942190409776, 89260224, 89260226, 2, 640x360 
0x1382CA98, 37353942190714440, 89260247, 89260253, 6, 640x360 
0x1382CA98, 37353942191034232, 89260289, 89260297, 8, 640x360 
0x1382CA98, 37353942191514240, 89260332, 89260334, 2, 640x360 
0x1382CA98, 37353942191830648, 89260365, 89260370, 5, 640x360 
0x1382CA98, 37353942192151536, 89260388, 89260392, 4, 640x360 
0x1382CA98, 37353942192470512, 89260425, 89260429, 4, 640x360 
0x1382CA98, 37353942192790984, 89260460, 89260462, 2, 640x360 
0x1382CA98, 37353942193115616, 89260492, 89260495, 3, 640x360 
0x1382CA98, 37353942193430768, 89260519, 89260525, 6, 640x360 
0x1382CA98, 37353942193763160, 89260564, 89260566, 2, 640x360 
0x1382CA98, 37353942194093640, 89260588, 89260591, 3, 640x360 
0x1382CA98, 37353942194397200, 89260619, 89260628, 9, 640x360 
0x1382CA98, 37353942194710736, 89260648, 89260651, 3, 640x360 
0x1382CA98, 37353942195035608, 89260679, 89260682, 3, 640x360 
0x1382CA98, 37353942195510696, 89260726, 89260730, 4, 640x360 
0x1382CA98, 37353942195840832, 89260773, 89260775, 2, 640x360 
0x1382CA98, 37353942196150968, 89260792, 89260796, 4, 640x360 
0x1382CA98, 37353942196473000, 89260826, 89260827, 1, 640x360 
0x1382CA98, 37353942196790600, 89260861, 89260863, 2, 640x360 
0x1382CA98, 37353942197111440, 89260882, 89260886, 4, 640x360 
0x1382CA98, 37353942197431456, 89260920, 89260926, 6, 640x360 
0x1382CA98, 37353942197757384, 89260946, 89260948, 2, 640x360 
0x1382CA98, 37353942198099640, 89260985, 89260993, 8, 640x360 
0x1382CA98, 37353942198391384, 89261014, 89261018, 4, 640x360 
0x1382CA98, 37353942198710904, 89261050, 89261055, 5, 640x360 
0x1382CA98, 37353942199036232, 89261081, 89261085, 4, 640x360 
0x1382CA98, 37353942199351280, 89261118, 89261123, 5, 640x360 
0x1382CA98, 37353942199834392, 89261166, 89261169, 3, 640x360 
0x1382CA98, 37353942200150048, 89261202, 89261205, 3, 640x360 
0x1382CA98, 37353942200476416, 89261241, 89261243, 2, 640x360 
0x1382CA98, 37353942200791640, 89261272, 89261277, 5, 640x360 
0x1382CA98, 37353942201115248, 89261293, 89261295, 2, 640x360 
0x1382CA98, 37353942201432880, 89261323, 89261325, 2, 640x360 
0x1382CA98, 37353942201750888, 89261348, 89261354, 6, 640x360 
0x1382CA98, 37353942202082816, 89261384, 89261389, 5, 640x360 
0x1382CA98, 37353942202391000, 89261423, 89261429, 6, 640x360 
0x1382CA98, 37353942202710448, 89261447, 89261451, 4, 640x360 
0x1382CA98, 37353942203035208, 89261479, 89261481, 2, 640x360 
0x1382CA98, 37353942203351104, 89261511, 89261519, 8, 640x360 
0x1382CA98, 37353942203833816, 89261558, 89261570, 12, 640x360 
0x1382CA98, 37353942204155248, 89261589, 89261598, 9, 640x360 
0x1382CA98, 37353942204474272, 89261622, 89261631, 9, 640x360 
0x1382CA98, 37353942204799872, 89261659, 89261668, 9, 640x360 
0x1382CA98, 37353942205111408, 89261684, 89261699, 15, 640x360 
0x1382CA98, 37353942205434208, 89261719, 89261726, 7, 640x360 
0x1382CA98, 37353942205753376, 89261749, 89261757, 8, 640x360 
0x1382CA98, 37353942206096816, 89261788, 89261795, 7, 640x360 
0x1382CA98, 37353942206390816, 89261818, 89261826, 8, 640x360 
0x1382CA98, 37353942206710920, 89261847, 89261851, 4, 640x360 
0x1382CA98, 37353942207030856, 89261882, 89261885, 3, 640x360 
0x1382CA98, 37353942207350960, 89261919, 89261929, 10, 640x360 
0x1382CA98, 37353942207836136, 89261966, 89261969, 3, 640x360 
0x1382CA98, 37353942208150000, 89261995, 89261998, 3, 640x360 
0x1382CA98, 37353942208472024, 89262027, 89262029, 2, 640x360 
0x1382CA98, 37353942208793808, 89262059, 89262066, 7, 640x360 
0x1382CA98, 37353942209110536, 89262093, 89262099, 6, 640x360 
0x1382CA98, 37353942209431328, 89262123, 89262126, 3, 640x360 
0x1382CA98, 37353942209754240, 89262156, 89262162, 6, 640x360 
0x1382CA98, 37353942210080528, 89262189, 89262198, 9, 640x360 
0x1382CA98, 37353942210400016, 89262223, 89262227, 4, 640x360 
0x1382CA98, 37353942210725768, 89262257, 89262260, 3, 640x360 
0x1382CA98, 37353942211032248, 89262298, 89262302, 4, 640x360 
0x1382CA98, 37353942211354992, 89262317, 89262322, 5, 640x360 
0x1382CA98, 37353942211833536, 89262362, 89262365, 3, 640x360 
0x1382CA98, 37353942212156720, 89262414, 89262416, 2, 640x360 
0x1382CA98, 37353942212471552, 89262434, 89262439, 5, 640x360 
0x1382CA98, 37353942212790456, 89262460, 89262463, 3, 640x360 
0x1382CA98, 37353942213110312, 89262486, 89262498, 12, 640x360 
0x1382CA98, 37353942213441368, 89262531, 89262534, 3, 640x360 
0x1382CA98, 37353942213758936, 89262550, 89262556, 6, 640x360 
0x1382CA98, 37353942214075712, 89262596, 89262598, 2, 640x360 
0x1382CA98, 37353942214390184, 89262616, 89262622, 6, 640x360 
0x1382CA98, 37353942214712552, 89262665, 89262668, 3, 640x360 
0x1382CA98, 37353942215032768, 89262691, 89262699, 8, 640x360 
0x1382CA98, 37353942215374416, 89262711, 89262714, 3, 640x360 
0x1382CA98, 37353942215834224, 89262772, 89262782, 10, 640x360 
0x1382CA98, 37353942216156832, 89262800, 89262802, 2, 640x360 
0x1382CA98, 37353942216472944, 89262831, 89262835, 4, 640x360 
0x1382CA98, 37353942216791744, 89262853, 89262862, 9, 640x360 
0x1382CA98, 37353942217109976, 89262899, 89262906, 7, 640x360 
0x1382CA98, 37353942217430824, 89262921, 89262929, 8, 640x360 
0x1382CA98, 37353942217754208, 89262955, 89262965, 10, 640x360 
0x1382CA98, 37353942218076016, 89262981, 89262984, 3, 640x360 
0x1382CA98, 37353942218390240, 89263014, 89263019, 5, 640x360 
0x1382CA98, 37353942218713856, 89263050, 89263058, 8, 640x360 
0x1382CA98, 37353942219031104, 89263084, 89263088, 4, 640x360 
0x1382CA98, 37353942219355488, 89263121, 89263123, 2, 640x360 
0x1382CA98, 37353942219833888, 89263167, 89263178, 11, 640x360 
0x1382CA98, 37353942220152808, 89263191, 89263201, 10, 640x360 
0x1382CA98, 37353942220471776, 89263222, 89263232, 10, 640x360 
0x1382CA98, 37353942220794640, 89263266, 89263269, 3, 640x360 
0x1382CA98, 37353942221110400, 89263290, 89263292, 2, 640x360 
0x1382CA98, 37353942221430160, 89263322, 89263329, 7, 640x360 
0x1382CA98, 37353942221758664, 89263355, 89263363, 8, 640x360 
0x1382CA98, 37353942222075216, 89263392, 89263394, 2, 640x360 
0x1382CA98, 37353942222408600, 89263423, 89263430, 7, 640x360 
0x1382CA98, 37353942222710184, 89263455, 89263458, 3, 640x360 
0x1382CA98, 37353942223030784, 89263477, 89263484, 7, 640x360 
0x1382CA98, 37353942223350024, 89263516, 89263519, 3, 640x360 
0x1382CA98, 37353942223670288, 89263543, 89263549, 6, 640x360 
0x1382CA98, 37353942224156512, 89263601, 89263605, 4, 640x360 
0x1382CA98, 37353942224470392, 89263626, 89263628, 2, 640x360 
0x1382CA98, 37353942224789320, 89263658, 89263660, 2, 640x360 
0x1382CA98, 37353942225132976, 89263691, 89263697, 6, 640x360 
0x1382CA98, 37353942225431712, 89263722, 89263730, 8, 640x360 
0x1382CA98, 37353942225752960, 89263759, 89263764, 5, 640x360 
0x1382CA98, 37353942226075480, 89263781, 89263786, 5, 640x360 
0x1382CA98, 37353942226389768, 89263816, 89263831, 15, 640x360 
0x1382CA98, 37353942226709720, 89263849, 89263852, 3, 640x360 
0x1382CA98, 37353942227030240, 89263883, 89263894, 11, 640x360 
0x1382CA98, 37353942227350144, 89263910, 89263913, 3, 640x360 
0x1382CA98, 37353942227670848, 89263961, 89263969, 8, 640x360 
0x1382CA98, 37353942228153424, 89263995, 89263998, 3, 640x360 
0x1382CA98, 37353942228478808, 89264040, 89264043, 3, 640x360 
0x1382CA98, 37353942228790264, 89264062, 89264065, 3, 640x360 
0x1382CA98, 37353942229114320, 89264103, 89264114, 11, 640x360 
0x1382CA98, 37353942229431888, 89264131, 89264132, 1, 640x360 
0x1382CA98, 37353942229753752, 89264160, 89264161, 1, 640x360 
0x1382CA98, 37353942230073760, 89264184, 89264191, 7, 640x360 
0x1382CA98, 37353942230390016, 89264214, 89264217, 3, 640x360 
0x1382CA98, 37353942230714096, 89264245, 89264247, 2, 640x360 
0x1382CA98, 37353942231033568, 89264289, 89264291, 2, 640x360 
0x1382CA98, 37353942231353592, 89264309, 89264312, 3, 640x360 
0x1382CA98, 37353942231670928, 89264342, 89264356, 14, 640x360 
0x1382CA98, 37353942232164656, 89264394, 89264401, 7, 640x360 
0x1382CA98, 37353942232472080, 89264428, 89264430, 2, 640x360 
0x1382CA98, 37353942232789328, 89264458, 89264461, 3, 640x360 
0x1382CA98, 37353942233109176, 89264487, 89264490, 3, 640x360 
0x1382CA98, 37353942233430384, 89264516, 89264522, 6, 640x360 
0x1382CA98, 37353942233754592, 89264550, 89264559, 9, 640x360 
0x1382CA98, 37353942234094688, 89264588, 89264597, 9, 640x360 
0x1382CA98, 37353942234393272, 89264635, 89264638, 3, 640x360 
0x1382CA98, 37353942234709784, 89264655, 89264657, 2, 640x360 
0x1382CA98, 37353942235030096, 89264677, 89264680, 3, 640x360 
0x1382CA98, 37353942235349872, 89264709, 89264712, 3, 640x360 
0x1382CA98, 37353942235674368, 89264741, 89264743, 2, 640x360 
0x1382CA98, 37353942236151536, 89264788, 89264790, 2, 640x360 
0x1382CA98, 37353942236469736, 89264826, 89264828, 2, 640x360 
0x1382CA98, 37353942236789744, 89264860, 89264862, 2, 640x360 
0x1382CA98, 37353942237114848, 89264891, 89264894, 3, 640x360 
0x1382CA98, 37353942237431936, 89264922, 89264925, 3, 640x360 
0x1382CA98, 37353942237750480, 89264957, 89264959, 2, 640x360 
0x1382CA98, 37353942238084024, 89264988, 89264995, 7, 640x360 
0x1382CA98, 37353942238396888, 89265025, 89265032, 7, 640x360 
0x1382CA98, 37353942238712624, 89265055, 89265057, 2, 640x360 
0x1382CA98, 37353942239029696, 89265088, 89265091, 3, 640x360 
0x1382CA98, 37353942239349480, 89265108, 89265115, 7, 640x360 
0x1382CA98, 37353942239669624, 89265140, 89265148, 8, 640x360 
0x1382CA98, 37353942240153296, 89265189, 89265195, 6, 640x360 
0x1382CA98, 37353942240473464, 89265230, 89265234, 4, 640x360 
0x1382CA98, 37353942240789552, 89265257, 89265264, 7, 640x360 
0x1382CA98, 37353942241114264, 89265292, 89265294, 2, 640x360 
0x1382CA98, 37353942241430072, 89265326, 89265329, 3, 640x360 
0x1382CA98, 37353942241764376, 89265357, 89265363, 6, 640x360 
0x1382CA98, 37353942242130608, 89265399, 89265403, 4, 640x360 
0x1382CA98, 37353942242393184, 89265436, 89265440, 4, 640x360 
0x1382CA98, 37353942242732648, 89265458, 89265460, 2, 640x360 
0x1382CA98, 37353942243029864, 89265488, 89265491, 3, 640x360 
0x1382CA98, 37353942243354800, 89265510, 89265514, 4, 640x360 
0x1382CA98, 37353942243674280, 89265541, 89265544, 3, 640x360 
0x1382CA98, 37353942244154520, 89265592, 89265601, 9, 640x360 
0x1382CA98, 37353942244469344, 89265622, 89265625, 3, 640x360 
0x1382CA98, 37353942244793608, 89265665, 89265673, 8, 640x360 
0x1382CA98, 37353942245115992, 89265697, 89265699, 2, 640x360 
0x1382CA98, 37353942245436656, 89265726, 89265728, 2, 640x360 
0x1382CA98, 37353942245760592, 89265751, 89265761, 10, 640x360 
0x1382CA98, 37353942246099856, 89265792, 89265795, 3, 640x360 
0x1382CA98, 37353942246412864, 89265813, 89265817, 4, 640x360 
0x1382CA98, 37353942246713280, 89265850, 89265854, 4, 640x360 
0x1382CA98, 37353942247030064, 89265885, 89265889, 4, 640x360 
0x1382CA98, 37353942247350272, 89265908, 89265911, 3, 640x360 
0x1382CA98, 37353942247671416, 89265939, 89265944, 5, 640x360 
0x1382CA98, 37353942248149584, 89265992, 89265998, 6, 640x360 
0x1382CA98, 37353942248475128, 89266027, 89266036, 9, 640x360 
0x1382CA98, 37353942248788736, 89266059, 89266066, 7, 640x360 
0x1382CA98, 37353942249110472, 89266100, 89266108, 8, 640x360 
0x1382CA98, 37353942249444192, 89266132, 89266139, 7, 640x360 
0x1382CA98, 37353942249771768, 89266164, 89266166, 2, 640x360 
0x1382CA98, 37353942250074424, 89266190, 89266193, 3, 640x360 
0x1382CA98, 37353942250396184, 89266216, 89266219, 3, 640x360 
0x1382CA98, 37353942250708992, 89266248, 89266251, 3, 640x360 
0x1382CA98, 37353942251034304, 89266279, 89266281, 2, 640x360 
0x1382CA98, 37353942251364656, 89266311, 89266314, 3, 640x360 
0x1382CA98, 37353942251669784, 89266347, 89266349, 2, 640x360 
0x1382CA98, 37353942251989696, 89266371, 89266379, 8, 640x360 
0x1382CA98, 37353942252471440, 89266423, 89266425, 2, 640x360 
0x1382CA98, 37353942252789688, 89266460, 89266466, 6, 640x360 
0x1382CA98, 37353942253109792, 89266489, 89266501, 12, 640x360 
0x1382CA98, 37353942253433184, 89266516, 89266525, 9, 640x360 
0x1382CA98, 37353942253752168, 89266548, 89266550, 2, 640x360 
0x1382CA98, 37353942254072432, 89266580, 89266582, 2, 640x360 
0x1382CA98, 37353942254392664, 89266612, 89266614, 2, 640x360 
0x1382CA98, 37353942254711040, 89266644, 89266646, 2, 640x360 
0x1382CA98, 37353942255042544, 89266676, 89266679, 3, 640x360 
0x1382CA98, 37353942255350720, 89266708, 89266715, 7, 640x360 
0x1382CA98, 37353942255673736, 89266754, 89266757, 3, 640x360 
0x1382CA98, 37353942255990080, 89266774, 89266777, 3, 640x360 
0x1382CA98, 37353942256473776, 89266824, 89266826, 2, 640x360 
0x1382CA98, 37353942256790232, 89266853, 89266861, 8, 640x360 
0x1382CA98, 37353942257109128, 89266886, 89266895, 9, 640x360 
0x1382CA98, 37353942257429832, 89266914, 89266918, 4, 640x360 
0x1382CA98, 37353942257753240, 89266947, 89266952, 5, 640x360 
0x1382CA98, 37353942258073024, 89266993, 89266995, 2, 640x360 
0x1382CA98, 37353942258392416, 89267017, 89267027, 10, 640x360 
0x1382CA98, 37353942258709376, 89267052, 89267060, 8, 640x360 
0x1382CA98, 37353942259028968, 89267081, 89267083, 2, 640x360 
0x1382CA98, 37353942259364152, 89267113, 89267115, 2, 640x360 
0x1382CA98, 37353942259676112, 89267157, 89267160, 3, 640x360 
0x1382CA98, 37353942259990272, 89267183, 89267190, 7, 640x360 
0x1382CA98, 37353942260473200, 89267229, 89267236, 7, 640x360 
0x1382CA98, 37353942260788960, 89267263, 89267266, 3, 640x360 
0x1382CA98, 37353942261134944, 89267300, 89267313, 13, 640x360 
0x1382CA98, 37353942261451392, 89267342, 89267352, 10, 640x360 
0x1382CA98, 37353942261773640, 89267359, 89267362, 3, 640x360 
0x1382CA98, 37353942262101528, 89267414, 89267422, 8, 640x360 
0x1382CA98, 37353942262442032, 89267427, 89267432, 5, 640x360 
0x1382CA98, 37353942262710688, 89267464, 89267467, 3, 640x360 
0x1382CA98, 37353942263030216, 89267482, 89267485, 3, 640x360 
0x1382CA98, 37353942263348952, 89267509, 89267512, 3, 640x360 
0x1382CA98, 37353942263668864, 89267541, 89267544, 3, 640x360 
0x1382CA98, 37353942263989400, 89267580, 89267582, 2, 640x360 
0x1382CA98, 37353942264468432, 89267618, 89267627, 9, 640x360 
0x1382CA98, 37353942264792208, 89267661, 89267663, 2, 640x360 
0x1382CA98, 37353942265108912, 89267688, 89267690, 2, 640x360 
0x1382CA98, 37353942265428928, 89267723, 89267725, 2, 640x360 
0x1382CA98, 37353942265751856, 89267756, 89267758, 2, 640x360 
0x1382CA98, 37353942266084360, 89267790, 89267792, 2, 640x360 
0x1382CA98, 37353942266398624, 89267812, 89267814, 2, 640x360 
0x1382CA98, 37353942266726616, 89267848, 89267851, 3, 640x360 
0x1382CA98, 37353942267035600, 89267879, 89267883, 4, 640x360 
0x1382CA98, 37353942267353736, 89267912, 89267914, 2, 640x360 
0x1382CA98, 37353942267747272, 89267963, 89267989, 26, 640x360 
0x1382CA98, 37353942268018664, 89268012, 89268025, 13, 640x360 
0x1382CA98, 37353942268480888, 89268043, 89268046, 3, 640x360 
0x1382CA98, 37353942268790784, 89268071, 89268075, 4, 640x360 
0x1382CA98, 37353942269111920, 89268094, 89268096, 2, 640x360 
0x1382CA98, 37353942269434160, 89268130, 89268133, 3, 640x360 
0x1382CA98, 37353942269762200, 89268154, 89268161, 7, 640x360 
0x1382CA98, 37353942270082088, 89268193, 89268195, 2, 640x360 
0x1382CA98, 37353942270400512, 89268220, 89268229, 9, 640x360 
0x1382CA98, 37353942270708552, 89268247, 89268251, 4, 640x360 
0x1382CA98, 37353942271028712, 89268291, 89268293, 2, 640x360 
0x1382CA98, 37353942271353224, 89268309, 89268312, 3, 640x360 
0x1382CA98, 37353942271675616, 89268349, 89268351, 2, 640x360 
0x1382CA98, 37353942271988696, 89268373, 89268376, 3, 640x360 
0x1382CA98, 37353942272469136, 89268431, 89268433, 2, 640x360 
0x1382CA98, 37353942272790448, 89268465, 89268470, 5, 640x360 
0x1382CA98, 37353942273110656, 89268484, 89268490, 6, 640x360 
0x1382CA98, 37353942273430136, 89268520, 89268529, 9, 640x360 
0x1382CA98, 37353942273751744, 89268550, 89268562, 12, 640x360 
0x1382CA98, 37353942274079872, 89268582, 89268586, 4, 640x360 
0x1382CA98, 37353942274392136, 89268614, 89268617, 3, 640x360 
0x1382CA98, 37353942274708256, 89268651, 89268655, 4, 640x360 
0x1382CA98, 37353942275028728, 89268678, 89268680, 2, 640x360 
0x1382CA98, 37353942275352352, 89268711, 89268714, 3, 640x360 
0x1382CA98, 37353942275668736, 89268744, 89268746, 2, 640x360 
0x1382CA98, 37353942275989088, 89268772, 89268781, 9, 640x360 
0x1382CA98, 37353942276313056, 89268803, 89268805, 2, 640x360 
0x1382CA98, 37353942276788672, 89268851, 89268854, 3, 640x360 
0x1382CA98, 37353942277109200, 89268883, 89268894, 11, 640x360 
0x1382CA98, 37353942277430144, 89268920, 89268927, 7, 640x360 
0x1382CA98, 37353942277769344, 89268952, 89268963, 11, 640x360 
0x1382CA98, 37353942278075848, 89268987, 89268997, 10, 640x360 
0x1382CA98, 37353942278393920, 89269020, 89269029, 9, 640x360 
0x1382CA98, 37353942278708280, 89269047, 89269051, 4, 640x360 
0x1382CA98, 37353942279028616, 89269084, 89269093, 9, 640x360 
0x1382CA98, 37353942279348568, 89269120, 89269134, 14, 640x360 
0x1382CA98, 37353942279692824, 89269149, 89269162, 13, 640x360 
0x1382CA98, 37353942279989744, 89269187, 89269195, 8, 640x360 
0x1382CA98, 37353942280337112, 89269213, 89269215, 2, 640x360 
0x1382CA98, 37353942280788224, 89269266, 89269280, 14, 640x360 
0x1382CA98, 37353942281107760, 89269286, 89269301, 15, 640x360 
0x1382CA98, 37353942281433144, 89269317, 89269327, 10, 640x360 
0x1382CA98, 37353942281757320, 89269365, 89269370, 5, 640x360 
0x1382CA98, 37353942282072888, 89269384, 89269390, 6, 640x360 
0x1382CA98, 37353942282405712, 89269411, 89269414, 3, 640x360 
0x1382CA98, 37353942282708296, 89269450, 89269455, 5, 640x360 
0x1382CA98, 37353942283028056, 89269480, 89269482, 2, 640x360 
0x1382CA98, 37353942283348312, 89269522, 89269532, 10, 640x360 
0x1382CA98, 37353942283679976, 89269549, 89269551, 2, 640x360 
0x1382CA98, 37353942283991944, 89269577, 89269579, 2, 640x360 
0x1382CA98, 37353942284318976, 89269610, 89269613, 3, 640x360 
0x1382CA98, 37353942284796464, 89269659, 89269662, 3, 640x360 
0x1382CA98, 37353942285108416, 89269684, 89269696, 12, 640x360 
0x1382CA98, 37353942285428704, 89269723, 89269726, 3, 640x360 
0x1382CA98, 37353942285751896, 89269753, 89269762, 9, 640x360 
0x1382CA98, 37353942286099368, 89269786, 89269795, 9, 640x360 
0x1382CA98, 37353942286388936, 89269818, 89269824, 6, 640x360 
0x1382CA98, 37353942286711080, 89269849, 89269851, 2, 640x360 
0x1382CA98, 37353942287030624, 89269882, 89269885, 3, 640x360 
0x1382CA98, 37353942287348800, 89269917, 89269922, 5, 640x360 
0x1382CA98, 37353942287675208, 89269953, 89269956, 3, 640x360 
0x1382CA98, 37353942287989200, 89269977, 89269983, 6, 640x360 
0x1382CA98, 37353942288309160, 89270008, 89270014, 6, 640x360 
0x1382CA98, 37353942288790376, 89270061, 89270064, 3, 640x360 
0x1382CA98, 37353942289131664, 89270099, 89270103, 4, 640x360 
0x1382CA98, 37353942289431432, 89270124, 89270133, 9, 640x360 
0x1382CA98, 37353942289754208, 89270158, 89270161, 3, 640x360 
0x1382CA98, 37353942290099736, 89270191, 89270193, 2, 640x360 
0x1382CA98, 37353942290391936, 89270216, 89270225, 9, 640x360 
0x1382CA98, 37353942290708800, 89270248, 89270250, 2, 640x360 
0x1382CA98, 37353942291027920, 89270280, 89270282, 2, 640x360 
0x1382CA98, 37353942291351816, 89270312, 89270314, 2, 640x360 
0x1382CA98, 37353942291668904, 89270346, 89270347, 1, 640x360 
0x1382CA98, 37353942291990592, 89270380, 89270381, 1, 640x360 
0x1382CA98, 37353942292309160, 89270417, 89270423, 6, 640x360 
0x1382CA98, 37353942292789128, 89270459, 89270462, 3, 640x360 
0x1382CA98, 37353942293111432, 89270503, 89270507, 4, 640x360 
0x1382CA98, 37353942293439960, 89270526, 89270533, 7, 640x360 
0x1382CA98, 37353942293763032, 89270555, 89270557, 2, 640x360 
0x1382CA98, 37353942294075144, 89270585, 89270587, 2, 640x360 
0x1382CA98, 37353942294394984, 89270618, 89270620, 2, 640x360 
0x1382CA98, 37353942294713328, 89270651, 89270655, 4, 640x360 
0x1382CA98, 37353942295034160, 89270687, 89270691, 4, 640x360 
0x1382CA98, 37353942295348808, 89270709, 89270715, 6, 640x360 
0x1382CA98, 37353942295673960, 89270747, 89270749, 2, 640x360 
0x1382CA98, 37353942295989448, 89270776, 89270781, 5, 640x360 
0x1382CA98, 37353942296311680, 89270816, 89270821, 5, 640x360 
0x1382CA98, 37353942296790312, 89270865, 89270867, 2, 640x360 
0x1382CA98, 37353942297108432, 89270889, 89270892, 3, 640x360 
0x1382CA98, 37353942297431560, 89270925, 89270935, 10, 640x360 
0x1382CA98, 37353942297751648, 89270951, 89270963, 12, 640x360 
0x1382CA98, 37353942298097736, 89270989, 89270992, 3, 640x360 
0x1382CA98, 37353942298406792, 89271017, 89271021, 4, 640x360 
0x1382CA98, 37353942298708360, 89271045, 89271047, 2, 640x360 
0x1382CA98, 37353942299028008, 89271091, 89271094, 3, 640x360 
0x1382CA98, 37353942299353368, 89271124, 89271131, 7, 640x360 
0x1382CA98, 37353942299669808, 89271146, 89271149, 3, 640x360 
0x1382CA98, 37353942300006976, 89271177, 89271182, 5, 640x360 
0x1382CA98, 37353942300317264, 89271210, 89271217, 7, 640x360 
0x1382CA98, 37353942300787384, 89271259, 89271261, 2, 640x360 
0x1382CA98, 37353942301112000, 89271285, 89271288, 3, 640x360 
0x1382CA98, 37353942301428496, 89271317, 89271321, 4, 640x360 
0x1382CA98, 37353942301753816, 89271349, 89271352, 3, 640x360 
0x1382CA98, 37353942302088456, 89271382, 89271386, 4, 640x360 
0x1382CA98, 37353942302399368, 89271419, 89271423, 4, 640x360 
0x1382CA98, 37353942302715504, 89271446, 89271448, 2, 640x360 
0x1382CA98, 37353942303031784, 89271488, 89271491, 3, 640x360 
0x1382CA98, 37353942303348664, 89271519, 89271522, 3, 640x360 
0x1382CA98, 37353942303668736, 89271542, 89271545, 3, 640x360 
0x1382CA98, 37353942303988656, 89271589, 89271592, 3, 640x360 
0x1382CA98, 37353942304308824, 89271608, 89271612, 4, 640x360 
0x1382CA98, 37353942304631864, 89271646, 89271649, 3, 640x360 
0x1382CA98, 37353942305107720, 89271691, 89271693, 2, 640x360 
0x1382CA98, 37353942305428152, 89271718, 89271725, 7, 640x360 
0x1382CA98, 37353942305748016, 89271761, 89271764, 3, 640x360 
0x1382CA98, 37353942306068208, 89271791, 89271795, 4, 640x360 
0x1382CA98, 37353942306387568, 89271814, 89271816, 2, 640x360 
0x1382CA98, 37353942306707560, 89271851, 89271855, 4, 640x360 
0x1382CA98, 37353942307031472, 89271887, 89271890, 3, 640x360 
0x1382CA98, 37353942307348752, 89271923, 89271925, 2, 640x360 
0x1382CA98, 37353942307668152, 89271947, 89271955, 8, 640x360 
0x1382CA98, 37353942308008984, 89271994, 89272004, 10, 640x360 
0x1382CA98, 37353942308317632, 89272023, 89272041, 18, 640x360 
0x1382CA98, 37353942308662976, 89272058, 89272061, 3, 640x360 
0x1382CA98, 37353942309113744, 89272098, 89272102, 4, 640x360 
0x1382CA98, 37353942309435464, 89272127, 89272142, 15, 640x360 
0x1382CA98, 37353942309782144, 89272169, 89272176, 7, 640x360 
0x1382CA98, 37353942310074480, 89272194, 89272200, 6, 640x360 
0x1382CA98, 37353942310389280, 89272225, 89272227, 2, 640x360 
0x1382CA98, 37353942310707384, 89272251, 89272262, 11, 640x360 
0x1382CA98, 37353942311031616, 89272283, 89272286, 3, 640x360 
0x1382CA98, 37353942311356936, 89272316, 89272318, 2, 640x360 
0x1382CA98, 37353942311671480, 89272351, 89272355, 4, 640x360 
0x1382CA98, 37353942311992400, 89272384, 89272389, 5, 640x360 
0x1382CA98, 37353942312317224, 89272424, 89272427, 3, 640x360 
0x1382CA98, 37353942312636248, 89272442, 89272450, 8, 640x360 
0x1382CA98, 37353942313110544, 89272495, 89272505, 10, 640x360 
0x1382CA98, 37353942313428312, 89272523, 89272529, 6, 640x360 
0x1382CA98, 37353942313755344, 89272558, 89272565, 7, 640x360 
0x1382CA98, 37353942314073864, 89272588, 89272592, 4, 640x360 
0x1382CA98, 37353942314390112, 89272615, 89272626, 11, 640x360 
0x1382CA98, 37353942314707120, 89272655, 89272657, 2, 640x360 
0x1382CA98, 37353942315027472, 89272687, 89272692, 5, 640x360 
0x1382CA98, 37353942315348192, 89272718, 89272723, 5, 640x360 
0x1382CA98, 37353942315667296, 89272741, 89272749, 8, 640x360 
0x1382CA98, 37353942315987616, 89272777, 89272779, 2, 640x360 
0x1382CA98, 37353942316319016, 89272810, 89272817, 7, 640x360 
0x1382CA98, 37353942316630744, 89272842, 89272852, 10, 640x360 
0x1382CA98, 37353942317107296, 89272899, 89272901, 2, 640x360 
0x1382CA98, 37353942317431776, 89272928, 89272930, 2, 640x360 
0x1382CA98, 37353942317761640, 89272963, 89272965, 2, 640x360 
0x1382CA98, 37353942318080328, 89272999, 89273004, 5, 640x360 
0x1382CA98, 37353942318414856, 89273026, 89273055, 29, 640x360 
0x1382CA98, 37353942318712640, 89273058, 89273073, 15, 640x360 
0x1382CA98, 37353942319034976, 89273098, 89273106, 8, 640x360 
0x1382CA98, 37353942319360768, 89273150, 89273161, 11, 640x360 
0x1382CA98, 37353942319677512, 89273161, 89273199, 38, 640x360 
0x1382CA98, 37353942319997080, 89273200, 89273212, 12, 640x360 
0x1382CA98, 37353942320320888, 89273234, 89273241, 7, 640x360 
0x1382CA98, 37353942320663408, 89273283, 89273297, 14, 640x360 
0x1382CA98, 37353942321116424, 89273302, 89273326, 24, 640x360 
0x1382CA98, 37353942321436248, 89273374, 89273391, 17, 640x360 
0x1382CA98, 37353942321876128, 89273444, 89273448, 4, 640x360 
0x1382CA98, 37353942322704280, 89273474, 89273493, 19, 640x360 
0x1382CA98, 37353942322996960, 89273495, 89273511, 16, 640x360 
0x1382CA98, 37353942323204312, 89273528, 89273530, 2, 640x360 
0x1382CA98, 37353942323458888, 89273543, 89273559, 16, 640x360 
0x1382CA98, 37353942323744064, 89273586, 89273598, 12, 640x360 
0x1382CA98, 37353942324100240, 89273613, 89273623, 10, 640x360 
0x1382CA98, 37353942324632328, 89273648, 89273654, 6, 640x360 
0x1382CA98, 37353942325112392, 89273693, 89273702, 9, 640x360 
0x1382CA98, 37353942325453408, 89273727, 89273729, 2, 640x360 
0x1382CA98, 37353942325750968, 89273750, 89273756, 6, 640x360 
0x1382CA98, 37353942326073160, 89273782, 89273785, 3, 640x360 
0x1382CA98, 37353942326386912, 89273822, 89273831, 9, 640x360 
0x1382CA98, 37353942326706904, 89273846, 89273849, 3, 640x360 
0x1382CA98, 37353942327027112, 89273877, 89273880, 3, 640x360 
0x1382CA98, 37353942327347008, 89273912, 89273915, 3, 640x360 
0x1382CA98, 37353942327667608, 89273950, 89273953, 3, 640x360 
0x1382CA98, 37353942328005200, 89273982, 89273984, 2, 640x360 
0x1382CA98, 37353942328320912, 89274011, 89274018, 7, 640x360 
0x1382CA98, 37353942328627424, 89274055, 89274057, 2, 640x360 
0x1382CA98, 37353942329106528, 89274093, 89274099, 6, 640x360 
0x1382CA98, 37353942329431736, 89274125, 89274135, 10, 640x360 
0x1382CA98, 37353942329773816, 89274158, 89274161, 3, 640x360 
0x1382CA98, 37353942330068024, 89274183, 89274199, 16, 640x360 
0x1382CA98, 37353942330391368, 89274217, 89274228, 11, 640x360 
0x1382CA98, 37353942330710608, 89274249, 89274254, 5, 640x360 
0x1382CA98, 37353942331026968, 89274280, 89274282, 2, 640x360 
0x1382CA98, 37353942331347512, 89274310, 89274312, 2, 640x360 
0x1382CA98, 37353942331671872, 89274345, 89274348, 3, 640x360 
0x1382CA98, 37353942332002720, 89274380, 89274383, 3, 640x360 
0x1382CA98, 37353942332364320, 89274421, 89274429, 8, 640x360 
0x1382CA98, 37353942332652080, 89274447, 89274452, 5, 640x360 
0x1382CA98, 37353942332990832, 89274481, 89274486, 5, 640x360 
0x1382CA98, 37353942333429520, 89274531, 89274534, 3, 640x360 
0x1382CA98, 37353942333753816, 89274558, 89274560, 2, 640x360 
0x1382CA98, 37353942334067128, 89274590, 89274593, 3, 640x360 
0x1382CA98, 37353942334396520, 89274618, 89274624, 6, 640x360 
0x1382CA98, 37353942334708624, 89274650, 89274654, 4, 640x360 
0x1382CA98, 37353942335028808, 89274688, 89274691, 3, 640x360 
0x1382CA98, 37353942335347080, 89274710, 89274713, 3, 640x360 
0x1382CA98, 37353942335670360, 89274749, 89274751, 2, 640x360 
0x1382CA98, 37353942335992232, 89274776, 89274778, 2, 640x360 
0x1382CA98, 37353942336310664, 89274815, 89274818, 3, 640x360 
0x1382CA98, 37353942336629776, 89274845, 89274847, 2, 640x360 
0x1382CA98, 37353942336963984, 89274877, 89274884, 7, 640x360 
0x1382CA98, 37353942337431664, 89274926, 89274928, 2, 640x360 
0x1382CA98, 37353942337746744, 89274949, 89274952, 3, 640x360 
0x1382CA98, 37353942338068560, 89274988, 89274997, 9, 640x360 
0x1382CA98, 37353942338390800, 89275015, 89275019, 4, 640x360 
0x1382CA98, 37353942338710360, 89275058, 89275068, 10, 640x360 
0x1382CA98, 37353942339030152, 89275080, 89275082, 2, 640x360 
0x1382CA98, 37353942339351160, 89275115, 89275125, 10, 640x360 
0x1382CA98, 37353942339703016, 89275146, 89275149, 3, 640x360 
0x1382CA98, 37353942340004048, 89275176, 89275178, 2, 640x360 
0x1382CA98, 37353942340320560, 89275210, 89275213, 3, 640x360 
0x1382CA98, 37353942340646936, 89275252, 89275261, 9, 640x360 
0x1382CA98, 37353942340958296, 89275281, 89275285, 4, 640x360 
0x1382CA98, 37353942341426368, 89275326, 89275329, 3, 640x360 
0x1382CA98, 37353942341746368, 89275350, 89275360, 10, 640x360 
0x1382CA98, 37353942342077112, 89275384, 89275396, 12, 640x360 
0x1382CA98, 37353942342417040, 89275426, 89275436, 10, 640x360 
0x1382CA98, 37353942342707992, 89275459, 89275461, 2, 640x360 
0x1382CA98, 37353942343026416, 89275479, 89275481, 2, 640x360 
0x1382CA98, 37353942343347224, 89275521, 89275528, 7, 640x360 
0x1382CA98, 37353942343667608, 89275554, 89275565, 11, 640x360 
0x1382CA98, 37353942343999976, 89275582, 89275585, 3, 640x360 
0x1382CA98, 37353942344309520, 89275615, 89275618, 3, 640x360 
0x1382CA98, 37353942344628080, 89275649, 89275653, 4, 640x360 
0x1382CA98, 37353942344950928, 89275683, 89275686, 3, 640x360 
0x1382CA98, 37353942345429208, 89275723, 89275730, 7, 640x360 
0x1382CA98, 37353942345755520, 89275755, 89275757, 2, 640x360 
0x1382CA98, 37353942346070528, 89275780, 89275782, 2, 640x360 
0x1382CA98, 37353942346391136, 89275814, 89275817, 3, 640x360 
0x1382CA98, 37353942346706688, 89275845, 89275848, 3, 640x360 
0x1382CA98, 37353942347037256, 89275876, 89275879, 3, 640x360 
0x1382CA98, 37353942347347640, 89275908, 89275914, 6, 640x360 
0x1382CA98, 37353942347671704, 89275940, 89275946, 6, 640x360 
0x1382CA98, 37353942347990888, 89275974, 89275984, 10, 640x360 
0x1382CA98, 37353942348316304, 89276011, 89276015, 4, 640x360 
0x1382CA98, 37353942348626584, 89276043, 89276046, 3, 640x360 
0x1382CA98, 37353942349426744, 89276131, 89276133, 2, 640x360 
0x1382CA98, 37353942349754440, 89276159, 89276161, 2, 640x360 
0x1382CA98, 37353942350070000, 89276191, 89276193, 2, 640x360 
0x1382CA98, 37353942350390640, 89276215, 89276219, 4, 640x360 
0x1382CA98, 37353942350710240, 89276245, 89276247, 2, 640x360 
0x1382CA98, 37353942351026136, 89276277, 89276283, 6, 640x360 
0x1382CA98, 37353942351346352, 89276318, 89276323, 5, 640x360 
0x1382CA98, 37353942351666448, 89276351, 89276356, 5, 640x360 
0x1382CA98, 37353942351986376, 89276378, 89276384, 6, 640x360 
0x1382CA98, 37353942352307856, 89276410, 89276417, 7, 640x360 
0x1382CA98, 37353942352626328, 89276446, 89276454, 8, 640x360 
0x1382CA98, 37353942352948784, 89276490, 89276493, 3, 640x360 
0x1382CA98, 37353942353438600, 89276526, 89276539, 13, 640x360 
0x1382CA98, 37353942353772520, 89276562, 89276565, 3, 640x360 
0x1382CA98, 37353942354070776, 89276608, 89276613, 5, 640x360 
0x1382CA98, 37353942354407168, 89276623, 89276636, 13, 640x360 
0x1382CA98, 37353942354734984, 89276654, 89276659, 5, 640x360 
0x1382CA98, 37353942355030496, 89276682, 89276686, 4, 640x360 
0x1382CA98, 37353942355350536, 89276719, 89276722, 3, 640x360 
0x1382CA98, 37353942355666320, 89276739, 89276742, 3, 640x360 
0x1382CA98, 37353942355986320, 89276780, 89276782, 2, 640x360 
0x1382CA98, 37353942356306984, 89276809, 89276812, 3, 640x360 
0x1382CA98, 37353942356627048, 89276844, 89276850, 6, 640x360 
0x1382CA98, 37353942356947344, 89276870, 89276873, 3, 640x360 
0x1382CA98, 37353942357271312, 89276900, 89276906, 6, 640x360 
0x1382CA98, 37353942357751872, 89276953, 89276956, 3, 640x360 
0x1382CA98, 37353942358071520, 89276982, 89276985, 3, 640x360 
0x1382CA98, 37353942358407688, 89277014, 89277017, 3, 640x360 
0x1382CA98, 37353942358706384, 89277047, 89277049, 2, 640x360 
0x1382CA98, 37353942359033256, 89277077, 89277079, 2, 640x360 
0x1382CA98, 37353942359346400, 89277108, 89277114, 6, 640x360 
0x1382CA98, 37353942359667040, 89277158, 89277161, 3, 640x360 
0x1382CA98, 37353942359987984, 89277178, 89277190, 12, 640x360 
0x1382CA98, 37353942360311568, 89277208, 89277211, 3, 640x360 
0x1382CA98, 37353942360635584, 89277249, 89277254, 5, 640x360 
0x1382CA98, 37353942360948288, 89277269, 89277276, 7, 640x360 
0x1382CA98, 37353942361266280, 89277301, 89277313, 12, 640x360 
0x1382CA98, 37353942361748856, 89277348, 89277350, 2, 640x360 
0x1382CA98, 37353942362088632, 89277382, 89277385, 3, 640x360 
0x1382CA98, 37353942362396240, 89277422, 89277425, 3, 640x360 
0x1382CA98, 37353942362706192, 89277459, 89277466, 7, 640x360 
0x1382CA98, 37353942363038424, 89277488, 89277490, 2, 640x360 
0x1382CA98, 37353942363346744, 89277511, 89277513, 2, 640x360 
0x1382CA98, 37353942363671408, 89277552, 89277562, 10, 640x360 
0x1382CA98, 37353942364001248, 89277580, 89277583, 3, 640x360 
0x1382CA98, 37353942364311728, 89277609, 89277612, 3, 640x360 
0x1382CA98, 37353942364630088, 89277645, 89277648, 3, 640x360 
0x1382CA98, 37353942364946920, 89277666, 89277670, 4, 640x360 
0x1382CA98, 37353942365270352, 89277701, 89277712, 11, 640x360 
0x1382CA98, 37353942365748392, 89277757, 89277760, 3, 640x360 
0x1382CA98, 37353942366080880, 89277782, 89277785, 3, 640x360 
0x1382CA98, 37353942366391072, 89277816, 89277823, 7, 640x360 
0x1382CA98, 37353942366706720, 89277859, 89277870, 11, 640x360 
0x1382CA98, 37353942367033744, 89277895, 89277905, 10, 640x360 
0x1382CA98, 37353942367350248, 89277914, 89277916, 2, 640x360 
0x1382CA98, 37353942367666280, 89277943, 89277947, 4, 640x360 
0x1382CA98, 37353942367986616, 89277975, 89277977, 2, 640x360 
0x1382CA98, 37353942368312736, 89278010, 89278011, 1, 640x360 
0x1382CA98, 37353942368646640, 89278041, 89278044, 3, 640x360 
0x1382CA98, 37353942368952112, 89278079, 89278086, 7, 640x360 
0x1382CA98, 37353942369291944, 89278126, 89278129, 3, 640x360 
0x1382CA98, 37353942369800192, 89278162, 89278164, 2, 640x360 
0x1382CA98, 37353942370075360, 89278198, 89278200, 2, 640x360 
0x1382CA98, 37353942370386904, 89278226, 89278234, 8, 640x360 
0x1382CA98, 37353942370708232, 89278259, 89278261, 2, 640x360 
0x1382CA98, 37353942371032288, 89278282, 89278293, 11, 640x360 
0x1382CA98, 37353942371345696, 89278324, 89278331, 7, 640x360 
0x1382CA98, 37353942371689160, 89278355, 89278366, 11, 640x360 
0x1382CA98, 37353942371993728, 89278389, 89278399, 10, 640x360 
0x1382CA98, 37353942372311304, 89278416, 89278425, 9, 640x360 
0x1382CA98, 37353942372637216, 89278471, 89278483, 12, 640x360 
0x1382CA98, 37353942372960376, 89278483, 89278493, 10, 640x360 
0x1382CA98, 37353942373288592, 89278526, 89278528, 2, 640x360 
0x1382CA98, 37353942373753064, 89278573, 89278582, 9, 640x360 
0x1382CA98, 37353942374069992, 89278597, 89278599, 2, 640x360 
0x1382CA98, 37353942374386328, 89278625, 89278636, 11, 640x360 
0x1382CA98, 37353942374746640, 89278658, 89278660, 2, 640x360 
0x1382CA98, 37353942375029648, 89278687, 89278698, 11, 640x360 
0x1382CA98, 37353942375351560, 89278731, 89278737, 6, 640x360 
0x1382CA98, 37353942375666416, 89278747, 89278752, 5, 640x360 
0x1382CA98, 37353942375987544, 89278789, 89278792, 3, 640x360 
0x1382CA98, 37353942376312128, 89278816, 89278822, 6, 640x360 
0x1382CA98, 37353942376630424, 89278852, 89278858, 6, 640x360 
0x1382CA98, 37353942376958928, 89278886, 89278895, 9, 640x360 
0x1382CA98, 37353942377269896, 89278921, 89278924, 3, 640x360 
0x1382CA98, 37353942377753000, 89278954, 89278964, 10, 640x360 
0x1382CA98, 37353942378099992, 89278994, 89279004, 10, 640x360 
0x1382CA98, 37353942378392080, 89279030, 89279032, 2, 640x360 
0x1382CA98, 37353942378707168, 89279074, 89279085, 11, 640x360 
0x1382CA98, 37353942379039928, 89279094, 89279099, 5, 640x360 
0x1382CA98, 37353942379353504, 89279120, 89279124, 4, 640x360 
0x1382CA98, 37353942379671056, 89279150, 89279156, 6, 640x360 
0x1382CA98, 37353942379992784, 89279190, 89279196, 6, 640x360 
0x1382CA98, 37353942380310280, 89279216, 89279218, 2, 640x360 
0x1382CA98, 37353942380637328, 89279255, 89279260, 5, 640x360 
0x1382CA98, 37353942380947392, 89279278, 89279281, 3, 640x360 
0x1382CA98, 37353942381296480, 89279311, 89279313, 2, 640x360 
0x1382CA98, 37353942381750400, 89279352, 89279362, 10, 640x360 
0x1382CA98, 37353942382069040, 89279398, 89279403, 5, 640x360 
0x1382CA98, 37353942382425496, 89279432, 89279439, 7, 640x360 
0x1382CA98, 37353942382712592, 89279453, 89279460, 7, 640x360 
0x1382CA98, 37353942383025176, 89279483, 89279487, 4, 640x360 
0x1382CA98, 37353942383350104, 89279516, 89279520, 4, 640x360 
0x1382CA98, 37353942383668024, 89279556, 89279558, 2, 640x360 
0x1382CA98, 37353942383990128, 89279580, 89279592, 12, 640x360 
0x1382CA98, 37353942384309528, 89279614, 89279620, 6, 640x360 
0x1382CA98, 37353942384630848, 89279651, 89279655, 4, 640x360 
0x1382CA98, 37353942384949712, 89279678, 89279690, 12, 640x360 
0x1382CA98, 37353942385267520, 89279721, 89279724, 3, 640x360 
0x1382CA98, 37353942385601312, 89279738, 89279743, 5, 640x360 
0x1382CA98, 37353942386098032, 89279795, 89279797, 2, 640x360 
0x1382CA98, 37353942386412664, 89279819, 89279823, 4, 640x360 
0x1382CA98, 37353942386710744, 89279850, 89279853, 3, 640x360 
0x1382CA98, 37353942387028328, 89279882, 89279886, 4, 640x360 
0x1382CA98, 37353942387346168, 89279915, 89279919, 4, 640x360 
0x1382CA98, 37353942387666096, 89279956, 89279964, 8, 640x360 
0x1382CA98, 37353942387992312, 89279976, 89279981, 5, 640x360 
0x1382CA98, 37353942388321216, 89280023, 89280033, 10, 640x360 
0x1382CA98, 37353942388631944, 89280043, 89280048, 5, 640x360 
0x1382CA98, 37353942388967360, 89280084, 89280090, 6, 640x360 
0x1382CA98, 37353942389268192, 89280105, 89280109, 4, 640x360 
0x1382CA98, 37353942389591320, 89280144, 89280146, 2, 640x360 
0x1382CA98, 37353942390071688, 89280183, 89280186, 3, 640x360 
0x1382CA98, 37353942390391832, 89280215, 89280220, 5, 640x360 
0x1382CA98, 37353942390710152, 89280248, 89280250, 2, 640x360 
0x1382CA98, 37353942391027768, 89280287, 89280290, 3, 640x360 
0x1382CA98, 37353942391345192, 89280309, 89280312, 3, 640x360 
0x1382CA98, 37353942391683736, 89280347, 89280350, 3, 640x360 
0x1382CA98, 37353942391990256, 89280373, 89280382, 9, 640x360 
0x1382CA98, 37353942392309256, 89280404, 89280407, 3, 640x360 
0x1382CA98, 37353942392628536, 89280443, 89280445, 2, 640x360 
0x1382CA98, 37353942392950928, 89280480, 89280482, 2, 640x360 
0x1382CA98, 37353942393270312, 89280501, 89280509, 8, 640x360 
0x1382CA98, 37353942393586280, 89280532, 89280535, 3, 640x360 
0x1382CA98, 37353942394067504, 89280587, 89280592, 5, 640x360 
0x1382CA98, 37353942394389952, 89280620, 89280623, 3, 640x360 
0x1382CA98, 37353942394709528, 89280647, 89280651, 4, 640x360 
0x1382CA98, 37353942395025744, 89280679, 89280682, 3, 640x360 
0x1382CA98, 37353942395348600, 89280710, 89280717, 7, 640x360 
0x1382CA98, 37353942395666904, 89280741, 89280747, 6, 640x360 
0x1382CA98, 37353942395985280, 89280775, 89280777, 2, 640x360 
0x1382CA98, 37353942396310352, 89280808, 89280815, 7, 640x360 
0x1382CA98, 37353942396626312, 89280844, 89280853, 9, 640x360 
0x1382CA98, 37353942396946616, 89280877, 89280879, 2, 640x360 
0x1382CA98, 37353942397289696, 89280908, 89280912, 4, 640x360 
0x1382CA98, 37353942397598776, 89280937, 89280946, 9, 640x360 
0x1382CA98, 37353942398087520, 89280998, 89281006, 8, 640x360 
0x1382CA98, 37353942398405056, 89281023, 89281035, 12, 640x360 
0x1382CA98, 37353942398711712, 89281060, 89281063, 3, 640x360 
0x1382CA98, 37353942399025384, 89281091, 89281095, 4, 640x360 
0x1382CA98, 37353942399346104, 89281112, 89281115, 3, 640x360 
0x1382CA98, 37353942399716984, 89281156, 89281162, 6, 640x360 
0x1382CA98, 37353942400009256, 89281183, 89281191, 8, 640x360 
0x1382CA98, 37353942400307272, 89281231, 89281239, 8, 640x360 
0x1382CA98, 37353942400653152, 89281251, 89281262, 11, 640x360 
0x1382CA98, 37353942400947128, 89281283, 89281302, 19, 640x360 
0x1382CA98, 37353942401302288, 89281311, 89281313, 2, 640x360 
0x1382CA98, 37353942401585512, 89281334, 89281348, 14, 640x360 
0x1382CA98, 37353942402068472, 89281387, 89281392, 5, 640x360 
0x1382CA98, 37353942402387016, 89281425, 89281428, 3, 640x360 
0x1382CA98, 37353942402705536, 89281450, 89281455, 5, 640x360 
0x1382CA98, 37353942403038256, 89281489, 89281498, 9, 640x360 
0x1382CA98, 37353942403354640, 89281517, 89281526, 9, 640x360 
0x1382CA98, 37353942403665696, 89281551, 89281558, 7, 640x360 
0x1382CA98, 37353942403993416, 89281590, 89281594, 4, 640x360 
0x1382CA98, 37353942404313056, 89281611, 89281615, 4, 640x360 
0x1382CA98, 37353942404629840, 89281655, 89281658, 3, 640x360 
0x1382CA98, 37353942404967360, 89281688, 89281693, 5, 640x360 
0x1382CA98, 37353942405269816, 89281720, 89281726, 6, 640x360 
0x1382CA98, 37353942405595552, 89281748, 89281758, 10, 640x360 
0x1382CA98, 37353942406090184, 89281786, 89281797, 11, 640x360 
0x1382CA98, 37353942406389056, 89281817, 89281821, 4, 640x360 
0x1382CA98, 37353942406708152, 89281849, 89281859, 10, 640x360 
0x1382CA98, 37353942407024976, 89281881, 89281882, 1, 640x360 
0x1382CA98, 37353942407371240, 89281924, 89281926, 2, 640x360 
0x1382CA98, 37353942407670712, 89281954, 89281958, 4, 640x360 
0x1382CA98, 37353942408034472, 89281985, 89281991, 6, 640x360 
0x1382CA98, 37353942408306392, 89282020, 89282023, 3, 640x360 
0x1382CA98, 37353942408631688, 89282047, 89282055, 8, 640x360 
0x1382CA98, 37353942408945928, 89282068, 89282074, 6, 640x360 
0x1382CA98, 37353942409268864, 89282103, 89282114, 11, 640x360 
0x1382CA98, 37353942409598312, 89282141, 89282151, 10, 640x360 
0x1382CA98, 37353942410065168, 89282180, 89282182, 2, 640x360 
0x1382CA98, 37353942410389264, 89282224, 89282226, 2, 640x360 
0x1382CA98, 37353942410708528, 89282246, 89282255, 9, 640x360 
0x1382CA98, 37353942411024512, 89282283, 89282294, 11, 640x360 
0x1382CA98, 37353942411348552, 89282311, 89282313, 2, 640x360 
0x1382CA98, 37353942411670872, 89282349, 89282351, 2, 640x360 
0x1382CA98, 37353942411997136, 89282377, 89282379, 2, 640x360 
0x1382CA98, 37353942412308624, 89282421, 89282429, 8, 640x360 
0x1382CA98, 37353942412624816, 89282451, 89282462, 11, 640x360 
0x1382CA98, 37353942412946600, 89282482, 89282490, 8, 640x360 
0x1382CA98, 37353942413270192, 89282510, 89282512, 2, 640x360 
0x1382CA98, 37353942413591024, 89282539, 89282546, 7, 640x360 
0x1382CA98, 37353942413915928, 89282574, 89282582, 8, 640x360 
0x1382CA98, 37353942414389560, 89282623, 89282626, 3, 640x360 
0x1382CA98, 37353942414708080, 89282649, 89282653, 4, 640x360 
0x1382CA98, 37353942415024664, 89282678, 89282681, 3, 640x360 
0x1382CA98, 37353942415346760, 89282713, 89282716, 3, 640x360 
0x1382CA98, 37353942415673752, 89282747, 89282751, 4, 640x360 
0x1382CA98, 37353942416002808, 89282781, 89282784, 3, 640x360 
0x1382CA98, 37353942416344232, 89282811, 89282818, 7, 640x360 
0x1382CA98, 37353942416630016, 89282847, 89282855, 8, 640x360 
0x1382CA98, 37353942416951704, 89282878, 89282880, 2, 640x360 
0x1382CA98, 37353942417280208, 89282911, 89282913, 2, 640x360 
0x1382CA98, 37353942417590472, 89282944, 89282946, 2, 640x360 
0x1382CA98, 37353942417922440, 89282976, 89282978, 2, 640x360 
0x1382CA98, 37353942418385384, 89283021, 89283027, 6, 640x360 
0x1382CA98, 37353942418708592, 89283062, 89283065, 3, 640x360 
0x1382CA98, 37353942419028128, 89283078, 89283081, 3, 640x360 
0x1382CA98, 37353942419344384, 89283118, 89283123, 5, 640x360 
0x1382CA98, 37353942419664920, 89283144, 89283147, 3, 640x360 
0x1382CA98, 37353942419987000, 89283182, 89283186, 4, 640x360 
0x1382CA98, 37353942420306240, 89283216, 89283219, 3, 640x360 
0x1382CA98, 37353942420635408, 89283248, 89283250, 2, 640x360 
0x1382CA98, 37353942420945464, 89283271, 89283279, 8, 640x360 
0x1382CA98, 37353942421264848, 89283306, 89283312, 6, 640x360 
0x1382CA98, 37353942421588640, 89283331, 89283334, 3, 640x360 
0x1382CA98, 37353942421910464, 89283374, 89283381, 7, 640x360 
0x1382CA98, 37353942422384776, 89283414, 89283417, 3, 640x360 
0x1382CA98, 37353942422704000, 89283457, 89283465, 8, 640x360 
0x1382CA98, 37353942423025320, 89283475, 89283477, 2, 640x360 
0x1382CA98, 37353942423367976, 89283522, 89283525, 3, 640x360 
0x1382CA98, 37353942423664648, 89283549, 89283552, 3, 640x360 
0x1382CA98, 37353942423988576, 89283577, 89283583, 6, 640x360 
0x1382CA98, 37353942424309728, 89283609, 89283616, 7, 640x360 
0x1382CA98, 37353942424624568, 89283638, 89283640, 2, 640x360 
0x1382CA98, 37353942424944648, 89283670, 89283674, 4, 640x360 
0x1382CA98, 37353942425265192, 89283707, 89283710, 3, 640x360 
0x1382CA98, 37353942425584784, 89283734, 89283742, 8, 640x360 
0x1382CA98, 37353942425904848, 89283765, 89283770, 5, 640x360 
0x1382CA98, 37353942426385280, 89283813, 89283815, 2, 640x360 
0x1382CA98, 37353942426705136, 89283855, 89283858, 3, 640x360 
0x1382CA98, 37353942427024584, 89283878, 89283890, 12, 640x360 
0x1382CA98, 37353942427351224, 89283911, 89283916, 5, 640x360 
0x1382CA98, 37353942427664936, 89283942, 89283948, 6, 640x360 
0x1382CA98, 37353942427985624, 89283975, 89283982, 7, 640x360 
0x1382CA98, 37353942428306616, 89284010, 89284018, 8, 640x360 
0x1382CA98, 37353942428628712, 89284046, 89284049, 3, 640x360 
0x1382CA98, 37353942428953304, 89284082, 89284093, 11, 640x360 
0x1382CA98, 37353942429291928, 89284113, 89284115, 2, 640x360 
0x1382CA98, 37353942429607008, 89284141, 89284148, 7, 640x360 
0x1382CA98, 37353942429908680, 89284187, 89284190, 3, 640x360 
0x1382CA98, 37353942430384112, 89284227, 89284232, 5, 640x360 
0x1382CA98, 37353942430708424, 89284265, 89284267, 2, 640x360 
0x1382CA98, 37353942431023928, 89284287, 89284291, 4, 640x360 
0x1382CA98, 37353942431348816, 89284311, 89284314, 3, 640x360 
0x1382CA98, 37353942431672048, 89284351, 89284362, 11, 640x360 
0x1382CA98, 37353942431998968, 89284382, 89284383, 1, 640x360 
0x1382CA98, 37353942432309488, 89284415, 89284417, 2, 640x360 
0x1382CA98, 37353942432625664, 89284450, 89284455, 5, 640x360 
0x1382CA98, 37353942432944672, 89284482, 89284484, 2, 640x360 
0x1382CA98, 37353942433267160, 89284498, 89284501, 3, 640x360 
0x1382CA98, 37353942433590120, 89284538, 89284540, 2, 640x360 
0x1382CA98, 37353942433908280, 89284571, 89284574, 3, 640x360 
0x1382CA98, 37353942434385440, 89284616, 89284630, 14, 640x360 
0x1382CA98, 37353942434709768, 89284650, 89284653, 3, 640x360 
0x1382CA98, 37353942435024304, 89284686, 89284691, 5, 640x360 
0x1382CA98, 37353942435349712, 89284719, 89284727, 8, 640x360 
0x1382CA98, 37353942435664912, 89284745, 89284750, 5, 640x360 
0x1382CA98, 37353942435991824, 89284786, 89284796, 10, 640x360 
0x1382CA98, 37353942436308200, 89284819, 89284822, 3, 640x360 
0x1382CA98, 37353942436632408, 89284846, 89284853, 7, 640x360 
0x1382CA98, 37353942436951600, 89284867, 89284873, 6, 640x360 
0x1382CA98, 37353942437285944, 89284909, 89284911, 2, 640x360 
0x1382CA98, 37353942437591096, 89284937, 89284940, 3, 640x360 
0x1382CA98, 37353942437913408, 89284967, 89284969, 2, 640x360 
0x1382CA98, 37353942438384296, 89285014, 89285017, 3, 640x360 
0x1382CA98, 37353942438708664, 89285047, 89285051, 4, 640x360 
0x1382CA98, 37353942439025264, 89285088, 89285091, 3, 640x360 
0x1382CA98, 37353942439348080, 89285114, 89285116, 2, 640x360 
0x1382CA98, 37353942439670296, 89285155, 89285163, 8, 640x360 
0x1382CA98, 37353942439992152, 89285181, 89285183, 2, 640x360 
0x1382CA98, 37353942440319016, 89285207, 89285209, 2, 640x360 
0x1382CA98, 37353942440641488, 89285240, 89285242, 2, 640x360 
0x1382CA98, 37353942440952008, 89285277, 89285279, 2, 640x360 
0x1382CA98, 37353942441269816, 89285301, 89285307, 6, 640x360 
0x1382CA98, 37353942441585192, 89285332, 89285335, 3, 640x360 
0x1382CA98, 37353942441904880, 89285366, 89285369, 3, 640x360 
0x1382CA98, 37353942442226032, 89285403, 89285406, 3, 640x360 
0x1382CA98, 37353942442704608, 89285443, 89285446, 3, 640x360 
0x1382CA98, 37353942443024888, 89285481, 89285484, 3, 640x360 
0x1382CA98, 37353942443344656, 89285512, 89285520, 8, 640x360 
0x1382CA98, 37353942443664656, 89285545, 89285547, 2, 640x360 
0x1382CA98, 37353942443988864, 89285585, 89285589, 4, 640x360 
0x1382CA98, 37353942444304560, 89285610, 89285612, 2, 640x360 
0x1382CA98, 37353942444625664, 89285642, 89285644, 2, 640x360 
0x1382CA98, 37353942444947656, 89285676, 89285679, 3, 640x360 
0x1382CA98, 37353942445282496, 89285709, 89285716, 7, 640x360 
0x1382CA98, 37353942445605472, 89285743, 89285747, 4, 640x360 
0x1382CA98, 37353942445922968, 89285774, 89285776, 2, 640x360 
0x1382CA98, 37353942446224592, 89285818, 89285829, 11, 640x360 
0x1382CA98, 37353942446703408, 89285854, 89285858, 4, 640x360 
0x1382CA98, 37353942447029672, 89285886, 89285892, 6, 640x360 
0x1382CA98, 37353942447357976, 89285919, 89285929, 10, 640x360 
0x1382CA98, 37353942447678368, 89285960, 89285973, 13, 640x360 
0x1382CA98, 37353942448011536, 89285982, 89285985, 3, 640x360 
0x1382CA98, 37353942448310080, 89286014, 89286016, 2, 640x360 
0x1382CA98, 37353942448646616, 89286043, 89286045, 2, 640x360 
0x1382CA98, 37353942448957896, 89286086, 89286099, 13, 640x360 
0x1382CA98, 37353942449269272, 89286118, 89286135, 17, 640x360 
0x1382CA98, 37353942449615272, 89286161, 89286165, 4, 640x360 
0x1382CA98, 37353942449904888, 89286183, 89286193, 10, 640x360 
0x1382CA98, 37353942450237880, 89286224, 89286234, 10, 640x360 
0x1382CA98, 37353942450712208, 89286260, 89286263, 3, 640x360 
0x1382CA98, 37353942451023784, 89286297, 89286299, 2, 640x360 
0x1382CA98, 37353942451353776, 89286314, 89286316, 2, 640x360 
0x1382CA98, 37353942451674328, 89286342, 89286346, 4, 640x360 
0x1382CA98, 37353942451989616, 89286375, 89286378, 3, 640x360 
0x1382CA98, 37353942452308416, 89286408, 89286411, 3, 640x360 
0x1382CA98, 37353942452626048, 89286447, 89286449, 2, 640x360 
0x1382CA98, 37353942452943744, 89286470, 89286477, 7, 640x360 
0x1382CA98, 37353942453264744, 89286502, 89286508, 6, 640x360 
0x1382CA98, 37353942453595128, 89286538, 89286541, 3, 640x360 
0x1382CA98, 37353942453905128, 89286565, 89286567, 2, 640x360 
0x1382CA98, 37353942454226784, 89286605, 89286610, 5, 640x360 
0x1382CA98, 37353942454704264, 89286646, 89286651, 5, 640x360 
0x1382CA98, 37353942455040960, 89286688, 89286691, 3, 640x360 
0x1382CA98, 37353942455348272, 89286723, 89286725, 2, 640x360 
0x1382CA98, 37353942455668320, 89286742, 89286751, 9, 640x360 
0x1382CA98, 37353942455989640, 89286777, 89286783, 6, 640x360 
0x1382CA98, 37353942456308688, 89286809, 89286812, 3, 640x360 
0x1382CA98, 37353942456624112, 89286841, 89286843, 2, 640x360 
0x1382CA98, 37353942456944008, 89286875, 89286886, 11, 640x360 
0x1382CA98, 37353942457269888, 89286898, 89286900, 2, 640x360 
0x1382CA98, 37353942457595688, 89286940, 89286944, 4, 640x360 
0x1382CA98, 37353942457927912, 89286977, 89286980, 3, 640x360 
0x1382CA98, 37353942458245056, 89287016, 89287021, 5, 640x360 
0x1382CA98, 37353942458702992, 89287061, 89287064, 3, 640x360 
0x1382CA98, 37353942459027456, 89287094, 89287098, 4, 640x360 
0x1382CA98, 37353942459348928, 89287124, 89287128, 4, 640x360 
0x1382CA98, 37353942459671232, 89287156, 89287159, 3, 640x360 
0x1382CA98, 37353942459987528, 89287178, 89287183, 5, 640x360 
0x1382CA98, 37353942460303320, 89287204, 89287207, 3, 640x360 
0x1382CA98, 37353942460627680, 89287242, 89287244, 2, 640x360 
0x1382CA98, 37353942460943432, 89287274, 89287282, 8, 640x360 
0x1382CA98, 37353942461264208, 89287306, 89287314, 8, 640x360 
0x1382CA98, 37353942461591224, 89287332, 89287336, 4, 640x360 
0x1382CA98, 37353942461921304, 89287365, 89287368, 3, 640x360 
0x1382CA98, 37353942462228264, 89287398, 89287402, 4, 640x360 
0x1382CA98, 37353942462702784, 89287446, 89287449, 3, 640x360 
0x1382CA98, 37353942463035080, 89287478, 89287481, 3, 640x360 
0x1382CA98, 37353942463347816, 89287510, 89287513, 3, 640x360 
0x1382CA98, 37353942463667272, 89287545, 89287548, 3, 640x360 
0x1382CA98, 37353942463993448, 89287590, 89287595, 5, 640x360 
0x1382CA98, 37353942464324120, 89287610, 89287619, 9, 640x360 
0x1382CA98, 37353942464623832, 89287644, 89287646, 2, 640x360 
0x1382CA98, 37353942464948504, 89287682, 89287684, 2, 640x360 
0x1382CA98, 37353942465267440, 89287706, 89287708, 2, 640x360 
0x1382CA98, 37353942465584008, 89287731, 89287734, 3, 640x360 
0x1382CA98, 37353942465914696, 89287768, 89287777, 9, 640x360 
0x1382CA98, 37353942466224200, 89287800, 89287803, 3, 640x360 
0x1382CA98, 37353942466543960, 89287837, 89287847, 10, 640x360 
0x1382CA98, 37353942467028728, 89287888, 89287897, 9, 640x360 
0x1382CA98, 37353942467343136, 89287915, 89287917, 2, 640x360 
0x1382CA98, 37353942467663152, 89287942, 89287945, 3, 640x360 
0x1382CA98, 37353942467988032, 89287983, 89287986, 3, 640x360 
0x1382CA98, 37353942468303232, 89288004, 89288006, 2, 640x360 
0x1382CA98, 37353942468627464, 89288041, 89288044, 3, 640x360 
0x1382CA98, 37353942468944184, 89288076, 89288079, 3, 640x360 
0x1382CA98, 37353942469264384, 89288102, 89288108, 6, 640x360 
0x1382CA98, 37353942469590696, 89288133, 89288146, 13, 640x360 
0x1382CA98, 37353942469909072, 89288167, 89288183, 16, 640x360 
0x1382CA98, 37353942470224216, 89288226, 89288256, 30, 640x360 
0x1382CA98, 37353942470623320, 89288256, 89288283, 27, 640x360 
0x1382CA98, 37353942471031728, 89288300, 89288322, 22, 640x360 
0x1382CA98, 37353942471354840, 89288333, 89288337, 4, 640x360 
0x1382CA98, 37353942471673496, 89288366, 89288375, 9, 640x360 
0x1382CA98, 37353942472020632, 89288383, 89288395, 12, 640x360 
0x1382CA98, 37353942472312368, 89288418, 89288423, 5, 640x360 
0x1382CA98, 37353942472627328, 89288449, 89288451, 2, 640x360 
0x1382CA98, 37353942472943176, 89288470, 89288474, 4, 640x360 
0x1382CA98, 37353942473263352, 89288511, 89288514, 3, 640x360 
0x1382CA98, 37353942473604392, 89288542, 89288544, 2, 640x360 
0x1382CA98, 37353942473921480, 89288575, 89288576, 1, 640x360 
0x1382CA98, 37353942474229680, 89288611, 89288613, 2, 640x360 
0x1382CA98, 37353942474547040, 89288639, 89288642, 3, 640x360 
0x1382CA98, 37353942475022848, 89288678, 89288681, 3, 640x360 
0x1382CA98, 37353942475345344, 89288715, 89288717, 2, 640x360 
0x1382CA98, 37353942475670096, 89288757, 89288759, 2, 640x360 
0x1382CA98, 37353942475988056, 89288775, 89288781, 6, 640x360 
0x1382CA98, 37353942476307064, 89288807, 89288816, 9, 640x360 
0x1382CA98, 37353942476625832, 89288845, 89288846, 1, 640x360 
0x1382CA98, 37353942476947160, 89288876, 89288878, 2, 640x360 
0x1382CA98, 37353942477264576, 89288909, 89288911, 2, 640x360 
0x1382CA98, 37353942477587232, 89288932, 89288936, 4, 640x360 
0x1382CA98, 37353942477904176, 89288971, 89288973, 2, 640x360 
0x1382CA98, 37353942478229200, 89289003, 89289007, 4, 640x360 
0x1382CA98, 37353942478543440, 89289034, 89289039, 5, 640x360 
0x1382CA98, 37353942479027896, 89289080, 89289083, 3, 640x360 
0x1382CA98, 37353942479343624, 89289107, 89289109, 2, 640x360 
0x1382CA98, 37353942479663496, 89289140, 89289143, 3, 640x360 
0x1382CA98, 37353942479992968, 89289176, 89289178, 2, 640x360 
0x1382CA98, 37353942480303928, 89289208, 89289211, 3, 640x360 
0x1382CA98, 37353942480623608, 89289245, 89289252, 7, 640x360 
0x1382CA98, 37353942480943952, 89289266, 89289269, 3, 640x360 
0x1382CA98, 37353942481264192, 89289299, 89289301, 2, 640x360 
0x1382CA98, 37353942481583960, 89289330, 89289333, 3, 640x360 
0x1382CA98, 37353942481922992, 89289366, 89289371, 5, 640x360 
0x1382CA98, 37353942482224256, 89289410, 89289411, 1, 640x360 
0x1382CA98, 37353942482544192, 89289430, 89289433, 3, 640x360 
0x1382CA98, 37353942483023728, 89289481, 89289485, 4, 640x360 
0x1382CA98, 37353942483343424, 89289515, 89289517, 2, 640x360 
0x1382CA98, 37353942483666896, 89289545, 89289548, 3, 640x360 
0x1382CA98, 37353942483987528, 89289576, 89289580, 4, 640x360 
0x1382CA98, 37353942484308488, 89289609, 89289611, 2, 640x360 
0x1382CA98, 37353942484623424, 89289639, 89289642, 3, 640x360 
0x1382CA98, 37353942484945744, 89289676, 89289678, 2, 640x360 
0x1382CA98, 37353942485303584, 89289710, 89289713, 3, 640x360 
0x1382CA98, 37353942485585880, 89289739, 89289742, 3, 640x360 
0x1382CA98, 37353942485906680, 89289766, 89289770, 4, 640x360 
0x1382CA98, 37353942486227872, 89289797, 89289799, 2, 640x360 
0x1382CA98, 37353942486565248, 89289834, 89289835, 1, 640x360 
0x1382CA98, 37353942487023440, 89289882, 89289885, 3, 640x360 
0x1382CA98, 37353942487347760, 89289912, 89289916, 4, 640x360 
0x1382CA98, 37353942487664152, 89289943, 89289945, 2, 640x360 
0x1382CA98, 37353942487987992, 89289988, 89289990, 2, 640x360 
0x1382CA98, 37353942488303400, 89290017, 89290019, 2, 640x360 
0x1382CA98, 37353942488631840, 89290044, 89290046, 2, 640x360 
0x1382CA98, 37353942488962712, 89290078, 89290081, 3, 640x360 
0x1382CA98, 37353942489284640, 89290104, 89290108, 4, 640x360 
0x1382CA98, 37353942489591952, 89290142, 89290146, 4, 640x360 
0x1382CA98, 37353942489904112, 89290165, 89290168, 3, 640x360 
0x1382CA98, 37353942490224400, 89290198, 89290201, 3, 640x360 
0x1382CA98, 37353942490543064, 89290235, 89290239, 4, 640x360 
0x1382CA98, 37353942491022216, 89290283, 89290286, 3, 640x360 
0x1382CA98, 37353942491342504, 89290310, 89290313, 3, 640x360 
0x1382CA98, 37353942491667816, 89290342, 89290347, 5, 640x360 
0x1382CA98, 37353942491982968, 89290377, 89290379, 2, 640x360 
0x1382CA98, 37353942492319640, 89290418, 89290436, 18, 640x360 
0x1382CA98, 37353942492638032, 89290459, 89290461, 2, 640x360 
0x1382CA98, 37353942492943840, 89290477, 89290480, 3, 640x360 
0x1382CA98, 37353942493273552, 89290513, 89290524, 11, 640x360 
0x1382CA98, 37353942493633680, 89290562, 89290565, 3, 640x360 
0x1382CA98, 37353942493963136, 89290583, 89290588, 5, 640x360 
0x1382CA98, 37353942494244600, 89290616, 89290619, 3, 640x360 
0x1382CA98, 37353942494544072, 89290644, 89290647, 3, 640x360 
0x1382CA98, 37353942494873848, 89290668, 89290672, 4, 640x360 
0x1382CA98, 37353942495342128, 89290709, 89290713, 4, 640x360 
0x1382CA98, 37353942495666576, 89290746, 89290755, 9, 640x360 
0x1382CA98, 37353942495986408, 89290778, 89290792, 14, 640x360 
0x1382CA98, 37353942496310904, 89290804, 89290807, 3, 640x360 
0x1382CA98, 37353942496622688, 89290837, 89290841, 4, 640x360 
0x1382CA98, 37353942496942768, 89290870, 89290881, 11, 640x360 
0x1382CA98, 37353942497266120, 89290903, 89290911, 8, 640x360 
0x1382CA98, 37353942497588336, 89290936, 89290943, 7, 640x360 
0x1382CA98, 37353942497909152, 89290966, 89290969, 3, 640x360 
0x1382CA98, 37353942498227136, 89291005, 89291008, 3, 640x360 
0x1382CA98, 37353942498567672, 89291032, 89291034, 2, 640x360 
0x1382CA98, 37353942498876952, 89291064, 89291068, 4, 640x360 
0x1382CA98, 37353942499342448, 89291110, 89291128, 18, 640x360 
0x1382CA98, 37353942499666192, 89291144, 89291150, 6, 640x360 
0x1382CA98, 37353942499982752, 89291175, 89291181, 6, 640x360 
0x1382CA98, 37353942500302944, 89291207, 89291210, 3, 640x360 
0x1382CA98, 37353942500622160, 89291239, 89291242, 3, 640x360 
0x1382CA98, 37353942500942224, 89291275, 89291279, 4, 640x360 
0x1382CA98, 37353942501265712, 89291309, 89291311, 2, 640x360 
0x1382CA98, 37353942501590912, 89291335, 89291343, 8, 640x360 
0x1382CA98, 37353942501919088, 89291374, 89291376, 2, 640x360 
0x1382CA98, 37353942502230040, 89291401, 89291406, 5, 640x360 
0x1382CA98, 37353942502546184, 89291427, 89291429, 2, 640x360 
0x1382CA98, 37353942502866584, 89291458, 89291464, 6, 640x360 
0x1382CA98, 37353942503346240, 89291515, 89291517, 2, 640x360 
0x1382CA98, 37353942503663192, 89291553, 89291556, 3, 640x360 
0x1382CA98, 37353942503992064, 89291577, 89291587, 10, 640x360 
0x1382CA98, 37353942504310656, 89291611, 89291615, 4, 640x360 
0x1382CA98, 37353942504623568, 89291642, 89291646, 4, 640x360 
0x1382CA98, 37353942504942376, 89291677, 89291681, 4, 640x360 
0x1382CA98, 37353942505263008, 89291713, 89291715, 2, 640x360 
0x1382CA98, 37353942505584504, 89291746, 89291756, 10, 640x360 
0x1382CA98, 37353942505915936, 89291782, 89291792, 10, 640x360 
0x1382CA98, 37353942506254048, 89291800, 89291804, 4, 640x360 
0x1382CA98, 37353942506543720, 89291837, 89291840, 3, 640x360 
0x1382CA98, 37353942506891120, 89291871, 89291875, 4, 640x360 
0x1382CA98, 37353942507341832, 89291911, 89291915, 4, 640x360 
0x1382CA98, 37353942507662208, 89291943, 89291953, 10, 640x360 
0x1382CA98, 37353942507990224, 89291980, 89291984, 4, 640x360 
0x1382CA98, 37353942508359832, 89292015, 89292017, 2, 640x360 
0x1382CA98, 37353942508638208, 89292044, 89292046, 2, 640x360 
0x1382CA98, 37353942508965664, 89292079, 89292082, 3, 640x360 
0x1382CA98, 37353942509262224, 89292102, 89292114, 12, 640x360 
0x1382CA98, 37353942509588696, 89292133, 89292136, 3, 640x360 
0x1382CA98, 37353942509907824, 89292164, 89292166, 2, 640x360 
0x1382CA98, 37353942510225736, 89292203, 89292212, 9, 640x360 
0x1382CA98, 37353942510542904, 89292246, 89292249, 3, 640x360 
0x1382CA98, 37353942510863360, 89292267, 89292277, 10, 640x360 
0x1382CA98, 37353942511346064, 89292314, 89292316, 2, 640x360 
0x1382CA98, 37353942511662152, 89292356, 89292359, 3, 640x360 
0x1382CA98, 37353942511990288, 89292378, 89292383, 5, 640x360 
0x1382CA98, 37353942512302328, 89292415, 89292418, 3, 640x360 
0x1382CA98, 37353942512623176, 89292446, 89292449, 3, 640x360 
0x1382CA98, 37353942512943424, 89292474, 89292476, 2, 640x360 
0x1382CA98, 37353942513263784, 89292515, 89292518, 3, 640x360 
0x1382CA98, 37353942513599704, 89292544, 89292547, 3, 640x360 
0x1382CA98, 37353942513916280, 89292578, 89292586, 8, 640x360 
0x1382CA98, 37353942514223344, 89292607, 89292610, 3, 640x360 
0x1382CA98, 37353942514546632, 89292635, 89292645, 10, 640x360 
0x1382CA98, 37353942514863032, 89292670, 89292673, 3, 640x360 
0x1382CA98, 37353942515341464, 89292716, 89292725, 9, 640x360 
0x1382CA98, 37353942515693304, 89292748, 89292750, 2, 640x360 
0x1382CA98, 37353942515993688, 89292783, 89292798, 15, 640x360 
0x1382CA98, 37353942516322312, 89292819, 89292826, 7, 640x360 
0x1382CA98, 37353942516627824, 89292845, 89292854, 9, 640x360 
0x1382CA98, 37353942516944384, 89292879, 89292890, 11, 640x360 
0x1382CA98, 37353942517277240, 89292913, 89292915, 2, 640x360 
0x1382CA98, 37353942517601144, 89292936, 89292941, 5, 640x360 
0x1382CA98, 37353942517907088, 89292978, 89292981, 3, 640x360 
0x1382CA98, 37353942518260264, 89293007, 89293015, 8, 640x360 
0x1382CA98, 37353942518542736, 89293041, 89293049, 8, 640x360 
0x1382CA98, 37353942518862824, 89293069, 89293078, 9, 640x360 
0x1382CA98, 37353942519186400, 89293106, 89293114, 8, 640x360 
0x1382CA98, 37353942519664856, 89293147, 89293161, 14, 640x360 
0x1382CA98, 37353942520013624, 89293183, 89293213, 30, 640x360 
0x1382CA98, 37353942520320184, 89293241, 89293254, 13, 640x360 
0x1382CA98, 37353942520662136, 89293265, 89293293, 28, 640x360 
0x1382CA98, 37353942521030080, 89293305, 89293311, 6, 640x360 
0x1382CA98, 37353942521284200, 89293328, 89293331, 3, 640x360 
0x1382CA98, 37353942521594624, 89293351, 89293360, 9, 640x360 
0x1382CA98, 37353942521949792, 89293383, 89293393, 10, 640x360 
0x1382CA98, 37353942522285688, 89293411, 89293424, 13, 640x360 
0x1382CA98, 37353942522553608, 89293435, 89293446, 11, 640x360 
0x1382CA98, 37353942522867400, 89293477, 89293499, 22, 640x360 
0x1382CA98, 37353942523195168, 89293504, 89293514, 10, 640x360 
0x1382CA98, 37353942523685456, 89293555, 89293592, 37, 640x360 
0x1382CA98, 37353942524022624, 89293612, 89293615, 3, 640x360 
0x1382CA98, 37353942524310776, 89293624, 89293630, 6, 640x360 
0x1382CA98, 37353942524644400, 89293657, 89293661, 4, 640x360 
0x1382CA98, 37353942524946624, 89293695, 89293700, 5, 640x360 
0x1382CA98, 37353942525269392, 89293721, 89293756, 35, 640x360 
0x1382CA98, 37353942525608896, 89293773, 89293792, 19, 640x360 
0x1382CA98, 37353942525956744, 89293793, 89293795, 2, 640x360 
0x1382CA98, 37353942526329176, 89293829, 89293836, 7, 640x360 
0x1382CA98, 37353942526547200, 89293863, 89293878, 15, 640x360 
0x1382CA98, 37353942526880984, 89293878, 89293893, 15, 640x360 
0x1382CA98, 37353942527208640, 89293912, 89293923, 11, 640x360 
0x1382CA98, 37353942527679960, 89293966, 89293981, 15, 640x360 
0x1382CA98, 37353942528006552, 89293990, 89293995, 5, 640x360 
0x1382CA98, 37353942528315096, 89294018, 89294030, 12, 640x360 
0x1382CA98, 37353942528631032, 89294057, 89294063, 6, 640x360 
0x1382CA98, 37353942528957816, 89294080, 89294082, 2, 640x360 
0x1382CA98, 37353942529293680, 89294115, 89294119, 4, 640x360 
0x1382CA98, 37353942529613224, 89294149, 89294152, 3, 640x360 
0x1382CA98, 37353942529913160, 89294170, 89294176, 6, 640x360 
0x1382CA98, 37353942530231528, 89294204, 89294213, 9, 640x360 
0x1382CA98, 37353942530546152, 89294237, 89294243, 6, 640x360 
0x1382CA98, 37353942530868960, 89294274, 89294276, 2, 640x360 
0x1382CA98, 37353942531182896, 89294300, 89294303, 3, 640x360 
0x1382CA98, 37353942531665048, 89294350, 89294356, 6, 640x360 
0x1382CA98, 37353942531992216, 89294378, 89294379, 1, 640x360 
0x1382CA98, 37353942532312904, 89294415, 89294417, 2, 640x360 
0x1382CA98, 37353942532621792, 89294444, 89294458, 14, 640x360 
0x1382CA98, 37353942532942352, 89294477, 89294479, 2, 640x360 
0x1382CA98, 37353942533265216, 89294500, 89294503, 3, 640x360 
0x1382CA98, 37353942533587504, 89294542, 89294551, 9, 640x360 
0x1382CA98, 37353942533921184, 89294573, 89294576, 3, 640x360 
0x1382CA98, 37353942534222112, 89294600, 89294608, 8, 640x360 
0x1382CA98, 37353942534541552, 89294642, 89294644, 2, 640x360 
0x1382CA98, 37353942534861600, 89294667, 89294674, 7, 640x360 
0x1382CA98, 37353942535181688, 89294700, 89294705, 5, 640x360 
0x1382CA98, 37353942535663448, 89294743, 89294746, 3, 640x360 
0x1382CA98, 37353942535992192, 89294775, 89294778, 3, 640x360 
0x1382CA98, 37353942536301256, 89294804, 89294807, 3, 640x360 
0x1382CA98, 37353942536631944, 89294848, 89294851, 3, 640x360 
0x1382CA98, 37353942536944792, 89294879, 89294882, 3, 640x360 
0x1382CA98, 37353942537265944, 89294911, 89294913, 2, 640x360 
0x1382CA98, 37353942537597232, 89294949, 89294951, 2, 640x360 
0x1382CA98, 37353942537902368, 89294972, 89294976, 4, 640x360 
0x1382CA98, 37353942538224368, 89295004, 89295011, 7, 640x360 
0x1382CA98, 37353942538545088, 89295037, 89295046, 9, 640x360 
0x1382CA98, 37353942538866992, 89295066, 89295068, 2, 640x360 
0x1382CA98, 37353942539187200, 89295100, 89295103, 3, 640x360 
0x1382CA98, 37353942539660888, 89295150, 89295154, 4, 640x360 
0x1382CA98, 37353942539984848, 89295180, 89295182, 2, 640x360 
0x1382CA98, 37353942540301896, 89295208, 89295211, 3, 640x360 
0x1382CA98, 37353942540621600, 89295241, 89295243, 2, 640x360 
0x1382CA98, 37353942540943376, 89295269, 89295272, 3, 640x360 
0x1382CA98, 37353942541265760, 89295301, 89295304, 3, 640x360 
0x1382CA98, 37353942541585080, 89295333, 89295336, 3, 640x360 
0x1382CA98, 37353942541916032, 89295371, 89295374, 3, 640x360 
0x1382CA98, 37353942542226344, 89295405, 89295413, 8, 640x360 
0x1382CA98, 37353942542545968, 89295439, 89295441, 2, 640x360 
0x1382CA98, 37353942542866080, 89295471, 89295480, 9, 640x360 
0x1382CA98, 37353942543186592, 89295499, 89295502, 3, 640x360 
0x1382CA98, 37353942543661280, 89295543, 89295547, 4, 640x360 
0x1382CA98, 37353942543986232, 89295578, 89295583, 5, 640x360 
0x1382CA98, 37353942544301608, 89295607, 89295616, 9, 640x360 
0x1382CA98, 37353942544621376, 89295642, 89295645, 3, 640x360 
0x1382CA98, 37353942544941328, 89295678, 89295680, 2, 640x360 
0x1382CA98, 37353942545261848, 89295705, 89295708, 3, 640x360 
0x1382CA98, 37353942545582960, 89295734, 89295741, 7, 640x360 
0x1382CA98, 37353942545911744, 89295765, 89295767, 2, 640x360 
0x1382CA98, 37353942546222064, 89295803, 89295812, 9, 640x360 
0x1382CA98, 37353942546542200, 89295841, 89295844, 3, 640x360 
0x1382CA98, 37353942546864520, 89295873, 89295875, 2, 640x360 
0x1382CA98, 37353942547184320, 89295911, 89295914, 3, 640x360 
0x1382CA98, 37353942547507088, 89295931, 89295932, 1, 640x360 
0x1382CA98, 37353942547983792, 89295978, 89295980, 2, 640x360 
0x1382CA98, 37353942548310768, 89296010, 89296016, 6, 640x360 
0x1382CA98, 37353942548670888, 89296043, 89296045, 2, 640x360 
0x1382CA98, 37353942548947192, 89296076, 89296085, 9, 640x360 
0x1382CA98, 37353942549270584, 89296111, 89296114, 3, 640x360 
0x1382CA98, 37353942549594192, 89296139, 89296147, 8, 640x360 
0x1382CA98, 37353942549913408, 89296176, 89296180, 4, 640x360 
0x1382CA98, 37353942550221288, 89296202, 89296212, 10, 640x360 
0x1382CA98, 37353942550541736, 89296232, 89296235, 3, 640x360 
0x1382CA98, 37353942550861536, 89296265, 89296267, 2, 640x360 
0x1382CA98, 37353942551190528, 89296299, 89296301, 2, 640x360 
0x1382CA98, 37353942551504800, 89296325, 89296333, 8, 640x360 
0x1382CA98, 37353942551983104, 89296384, 89296389, 5, 640x360 
0x1382CA98, 37353942552300704, 89296410, 89296417, 7, 640x360 
0x1382CA98, 37353942552621976, 89296438, 89296442, 4, 640x360 
0x1382CA98, 37353942552941696, 89296466, 89296469, 3, 640x360 
0x1382CA98, 37353942553265816, 89296500, 89296505, 5, 640x360 
0x1382CA98, 37353942553587184, 89296540, 89296552, 12, 640x360 
0x1382CA98, 37353942553902592, 89296566, 89296568, 2, 640x360 
0x1382CA98, 37353942554222112, 89296610, 89296612, 2, 640x360 
0x1382CA98, 37353942554541360, 89296630, 89296634, 4, 640x360 
0x1382CA98, 37353942554865152, 89296666, 89296669, 3, 640x360 
0x1382CA98, 37353942555181856, 89296698, 89296700, 2, 640x360 
0x1382CA98, 37353942555502928, 89296728, 89296733, 5, 640x360 
0x1382CA98, 37353942555981128, 89296777, 89296780, 3, 640x360 
0x1382CA98, 37353942556306336, 89296809, 89296818, 9, 640x360 
0x1382CA98, 37353942556621280, 89296844, 89296846, 2, 640x360 
0x1382CA98, 37353942556946368, 89296888, 89296892, 4, 640x360 
0x1382CA98, 37353942557297576, 89296909, 89296912, 3, 640x360 
0x1382CA98, 37353942557587880, 89296932, 89296935, 3, 640x360 
0x1382CA98, 37353942557905864, 89296969, 89296973, 4, 640x360 
0x1382CA98, 37353942558225200, 89297000, 89297002, 2, 640x360 
0x1382CA98, 37353942558541928, 89297035, 89297039, 4, 640x360 
0x1382CA98, 37353942558862120, 89297062, 89297064, 2, 640x360 
0x1382CA98, 37353942559188016, 89297098, 89297100, 2, 640x360 
0x1382CA98, 37353942559507688, 89297133, 89297137, 4, 640x360 
0x1382CA98, 37353942559981920, 89297184, 89297189, 5, 640x360 
0x1382CA98, 37353942560305440, 89297215, 89297217, 2, 640x360 
0x1382CA98, 37353942560621488, 89297242, 89297244, 2, 640x360 
0x1382CA98, 37353942560941344, 89297275, 89297281, 6, 640x360 
0x1382CA98, 37353942561265200, 89297305, 89297307, 2, 640x360 
0x1382CA98, 37353942561584112, 89297337, 89297339, 2, 640x360 
0x1382CA98, 37353942561905552, 89297369, 89297376, 7, 640x360 
0x1382CA98, 37353942562293016, 89297413, 89297415, 2, 640x360 
0x1382CA98, 37353942562546456, 89297454, 89297456, 2, 640x360 
0x1382CA98, 37353942562862048, 89297473, 89297475, 2, 640x360 
0x1382CA98, 37353942563184792, 89297496, 89297499, 3, 640x360 
0x1382CA98, 37353942563506272, 89297528, 89297531, 3, 640x360 
0x1382CA98, 37353942563981544, 89297591, 89297594, 3, 640x360 
0x1382CA98, 37353942564305424, 89297615, 89297617, 2, 640x360 
0x1382CA98, 37353942564633048, 89297648, 89297650, 2, 640x360 
0x1382CA98, 37353942564944584, 89297678, 89297680, 2, 640x360 
0x1382CA98, 37353942565263400, 89297704, 89297715, 11, 640x360 
0x1382CA98, 37353942565603560, 89297737, 89297745, 8, 640x360 
0x1382CA98, 37353942565911160, 89297774, 89297780, 6, 640x360 
0x1382CA98, 37353942566221168, 89297800, 89297803, 3, 640x360 
0x1382CA98, 37353942566541296, 89297832, 89297835, 3, 640x360 
0x1382CA98, 37353942566860536, 89297867, 89297870, 3, 640x360 
0x1382CA98, 37353942567187272, 89297898, 89297900, 2, 640x360 
0x1382CA98, 37353942567501152, 89297924, 89297931, 7, 640x360 
0x1382CA98, 37353942567985096, 89297976, 89297982, 6, 640x360 
0x1382CA98, 37353942568302528, 89298008, 89298010, 2, 640x360 
0x1382CA98, 37353942568621032, 89298035, 89298039, 4, 640x360 
0x1382CA98, 37353942568940640, 89298067, 89298070, 3, 640x360 
0x1382CA98, 37353942569261744, 89298098, 89298100, 2, 640x360 
0x1382CA98, 37353942569581568, 89298133, 89298137, 4, 640x360 
0x1382CA98, 37353942569905720, 89298164, 89298166, 2, 640x360 
0x1382CA98, 37353942570224152, 89298195, 89298197, 2, 640x360 
0x1382CA98, 37353942570541712, 89298226, 89298229, 3, 640x360 
0x1382CA98, 37353942570861856, 89298262, 89298264, 2, 640x360 
0x1382CA98, 37353942571184320, 89298301, 89298304, 3, 640x360 
0x1382CA98, 37353942571502624, 89298329, 89298332, 3, 640x360 
0x1382CA98, 37353942571980712, 89298375, 89298378, 3, 640x360 
0x1382CA98, 37353942572304552, 89298414, 89298416, 2, 640x360 
0x1382CA98, 37353942572622896, 89298437, 89298440, 3, 640x360 
0x1382CA98, 37353942572941232, 89298466, 89298470, 4, 640x360 
0x1382CA98, 37353942573264856, 89298503, 89298507, 4, 640x360 
0x1382CA98, 37353942573582040, 89298550, 89298554, 4, 640x360 
0x1382CA98, 37353942573904088, 89298565, 89298569, 4, 640x360 
0x1382CA98, 37353942574222496, 89298601, 89298603, 2, 640x360 
0x1382CA98, 37353942574548392, 89298640, 89298642, 2, 640x360 
0x1382CA98, 37353942574915456, 89298664, 89298667, 3, 640x360 
0x1382CA98, 37353942575184632, 89298691, 89298697, 6, 640x360 
0x1382CA98, 37353942575501216, 89298724, 89298730, 6, 640x360 
0x1382CA98, 37353942575825152, 89298761, 89298763, 2, 640x360 
0x1382CA98, 37353942576304240, 89298806, 89298810, 4, 640x360 
0x1382CA98, 37353942576620784, 89298841, 89298851, 10, 640x360 
0x1382CA98, 37353942576941704, 89298872, 89298875, 3, 640x360 
0x1382CA98, 37353942577261256, 89298902, 89298906, 4, 640x360 
0x1382CA98, 37353942577592896, 89298935, 89298946, 11, 640x360 
0x1382CA98, 37353942577914320, 89298976, 89298979, 3, 640x360 
0x1382CA98, 37353942578227520, 89299001, 89299004, 3, 640x360 
0x1382CA98, 37353942578541144, 89299028, 89299031, 3, 640x360 
0x1382CA98, 37353942578865088, 89299059, 89299061, 2, 640x360 
0x1382CA98, 37353942579188768, 89299091, 89299094, 3, 640x360 
0x1382CA98, 37353942579505320, 89299129, 89299139, 10, 640x360 
0x1382CA98, 37353942579824264, 89299181, 89299184, 3, 640x360 
0x1382CA98, 37353942580309696, 89299210, 89299220, 10, 640x360 
0x1382CA98, 37353942580622680, 89299243, 89299255, 12, 640x360 
0x1382CA98, 37353942580940024, 89299298, 89299301, 3, 640x360 
0x1382CA98, 37353942581271872, 89299311, 89299327, 16, 640x360 
0x1382CA98, 37353942581595216, 89299364, 89299366, 2, 640x360 
0x1382CA98, 37353942581931136, 89299378, 89299381, 3, 640x360 
0x1382CA98, 37353942582221536, 89299401, 89299414, 13, 640x360 
0x1382CA98, 37353942582545240, 89299443, 89299448, 5, 640x360 
0x1382CA98, 37353942582864336, 89299466, 89299468, 2, 640x360 
0x1382CA98, 37353942583180584, 89299492, 89299495, 3, 640x360 
0x1382CA98, 37353942583501000, 89299530, 89299532, 2, 640x360 
0x1382CA98, 37353942583821032, 89299561, 89299562, 1, 640x360 
0x1382CA98, 37353942584299864, 89299615, 89299617, 2, 640x360 
0x1382CA98, 37353942584620040, 89299649, 89299652, 3, 640x360 
0x1382CA98, 37353942584940344, 89299677, 89299682, 5, 640x360 
0x1382CA98, 37353942585272032, 89299710, 89299713, 3, 640x360 
0x1382CA98, 37353942585585296, 89299734, 89299750, 16, 640x360 
0x1382CA98, 37353942585907400, 89299772, 89299775, 3, 640x360 
0x1382CA98, 37353942586227888, 89299806, 89299808, 2, 640x360 
0x1382CA98, 37353942586543320, 89299839, 89299841, 2, 640x360 
0x1382CA98, 37353942586860424, 89299868, 89299874, 6, 640x360 
0x1382CA98, 37353942587180512, 89299899, 89299901, 2, 640x360 
0x1382CA98, 37353942587504304, 89299926, 89299929, 3, 640x360 
0x1382CA98, 37353942587822712, 89299959, 89299962, 3, 640x360 
0x1382CA98, 37353942588304864, 89300012, 89300014, 2, 640x360 
0x1382CA98, 37353942588627576, 89300044, 89300046, 2, 640x360 
0x1382CA98, 37353942588942712, 89300072, 89300081, 9, 640x360 
0x1382CA98, 37353942589271872, 89300109, 89300115, 6, 640x360 
0x1382CA98, 37353942589613760, 89300150, 89300158, 8, 640x360 
0x1382CA98, 37353942589908168, 89300183, 89300186, 3, 640x360 
0x1382CA98, 37353942590232464, 89300209, 89300216, 7, 640x360 
0x1382CA98, 37353942590542000, 89300235, 89300239, 4, 640x360 
0x1382CA98, 37353942590860072, 89300263, 89300266, 3, 640x360 
0x1382CA98, 37353942591183432, 89300294, 89300296, 2, 640x360 
0x1382CA98, 37353942591504072, 89300325, 89300331, 6, 640x360 
0x1382CA98, 37353942591821184, 89300359, 89300362, 3, 640x360 
0x1382CA98, 37353942592304144, 89300410, 89300416, 6, 640x360 
0x1382CA98, 37353942592622144, 89300442, 89300444, 2, 640x360 
0x1382CA98, 37353942592940616, 89300471, 89300479, 8, 640x360 
0x1382CA98, 37353942593268240, 89300501, 89300507, 6, 640x360 
0x1382CA98, 37353942593585120, 89300532, 89300535, 3, 640x360 
0x1382CA98, 37353942593908264, 89300568, 89300578, 10, 640x360 
0x1382CA98, 37353942594220576, 89300600, 89300604, 4, 640x360 
0x1382CA98, 37353942594540504, 89300634, 89300639, 5, 640x360 
0x1382CA98, 37353942594860816, 89300660, 89300662, 2, 640x360 
0x1382CA98, 37353942595185352, 89300691, 89300694, 3, 640x360 
0x1382CA98, 37353942595500888, 89300734, 89300738, 4, 640x360 
0x1382CA98, 37353942595824952, 89300763, 89300772, 9, 640x360 
0x1382CA98, 37353942596303080, 89300816, 89300820, 4, 640x360 
0x1382CA98, 37353942596623912, 89300854, 89300863, 9, 640x360 
0x1382CA98, 37353942596944384, 89300877, 89300880, 3, 640x360 
0x1382CA98, 37353942597263664, 89300907, 89300914, 7, 640x360 
0x1382CA98, 37353942597588952, 89300949, 89300956, 7, 640x360 
0x1382CA98, 37353942597925088, 89300972, 89300978, 6, 640x360 
0x1382CA98, 37353942598223920, 89301005, 89301008, 3, 640x360 
0x1382CA98, 37353942598550560, 89301032, 89301034, 2, 640x360 
0x1382CA98, 37353942598860112, 89301068, 89301073, 5, 640x360 
0x1382CA98, 37353942599184968, 89301092, 89301093, 1, 640x360 
0x1382CA98, 37353942599509600, 89301138, 89301141, 3, 640x360 
0x1382CA98, 37353942599824024, 89301157, 89301159, 2, 640x360 
0x1382CA98, 37353942600142376, 89301192, 89301194, 2, 640x360 
0x1382CA98, 37353942600622480, 89301247, 89301254, 7, 640x360 
0x1382CA98, 37353942600959944, 89301276, 89301278, 2, 640x360 
0x1382CA98, 37353942601260640, 89301308, 89301310, 2, 640x360 
0x1382CA98, 37353942601588872, 89301335, 89301348, 13, 640x360 
0x1382CA98, 37353942601924696, 89301371, 89301378, 7, 640x360 
0x1382CA98, 37353942602220088, 89301403, 89301407, 4, 640x360 
0x1382CA98, 37353942602544672, 89301429, 89301431, 2, 640x360 
0x1382CA98, 37353942602864992, 89301467, 89301472, 5, 640x360 
0x1382CA98, 37353942603183088, 89301496, 89301498, 2, 640x360 
0x1382CA98, 37353942603501896, 89301533, 89301536, 3, 640x360 
0x1382CA98, 37353942603827280, 89301568, 89301574, 6, 640x360 
0x1382CA98, 37353942604140120, 89301595, 89301596, 1, 640x360 
0x1382CA98, 37353942604621984, 89301649, 89301652, 3, 640x360 
0x1382CA98, 37353942605007456, 89301677, 89301679, 2, 640x360 
0x1382CA98, 37353942605293176, 89301714, 89301716, 2, 640x360 
0x1382CA98, 37353942605584912, 89301742, 89301744, 2, 640x360 
0x1382CA98, 37353942605907960, 89301777, 89301779, 2, 640x360 
0x1382CA98, 37353942606219720, 89301804, 89301806, 2, 640x360 
0x1382CA98, 37353942606549080, 89301834, 89301839, 5, 640x360 
0x1382CA98, 37353942606859472, 89301874, 89301877, 3, 640x360 
0x1382CA98, 37353942607183432, 89301897, 89301900, 3, 640x360 
0x1382CA98, 37353942607500536, 89301925, 89301927, 2, 640x360 
0x1382CA98, 37353942607821168, 89301961, 89301963, 2, 640x360 
0x1382CA98, 37353942608140600, 89301994, 89301997, 3, 640x360 
0x1382CA98, 37353942608623608, 89302048, 89302050, 2, 640x360 
0x1382CA98, 37353942608942648, 89302083, 89302085, 2, 640x360 
0x1382CA98, 37353942609268128, 89302105, 89302112, 7, 640x360 
0x1382CA98, 37353942609586776, 89302146, 89302154, 8, 640x360 
0x1382CA98, 37353942609913296, 89302167, 89302183, 16, 640x360 
0x1382CA98, 37353942610220112, 89302199, 89302206, 7, 640x360 
0x1382CA98, 37353942610539896, 89302228, 89302230, 2, 640x360 
0x1382CA98, 37353942610859384, 89302265, 89302269, 4, 640x360 
0x1382CA98, 37353942611179624, 89302302, 89302306, 4, 640x360 
0x1382CA98, 37353942611499832, 89302328, 89302330, 2, 640x360 
0x1382CA98, 37353942611819672, 89302358, 89302361, 3, 640x360 
0x1382CA98, 37353942612143728, 89302391, 89302394, 3, 640x360 
0x1382CA98, 37353942612624392, 89302437, 89302439, 2, 640x360 
0x1382CA98, 37353942612940880, 89302475, 89302477, 2, 640x360 
0x1382CA98, 37353942613259624, 89302500, 89302507, 7, 640x360 
0x1382CA98, 37353942613587584, 89302531, 89302533, 2, 640x360 
0x1382CA98, 37353942613905752, 89302565, 89302579, 14, 640x360 
0x1382CA98, 37353942614220056, 89302599, 89302606, 7, 640x360 
0x1382CA98, 37353942614544160, 89302636, 89302642, 6, 640x360 
0x1382CA98, 37353942614867352, 89302675, 89302682, 7, 640x360 
0x1382CA98, 37353942615187216, 89302710, 89302721, 11, 640x360 
0x1382CA98, 37353942615501560, 89302731, 89302732, 1, 640x360 
0x1382CA98, 37353942615837128, 89302766, 89302771, 5, 640x360 
0x1382CA98, 37353942616155176, 89302795, 89302798, 3, 640x360 
0x1382CA98, 37353942616623464, 89302853, 89302863, 10, 640x360 
0x1382CA98, 37353942616938928, 89302887, 89302897, 10, 640x360 
0x1382CA98, 37353942617288000, 89302910, 89302913, 3, 640x360 
0x1382CA98, 37353942617584216, 89302934, 89302940, 6, 640x360 
0x1382CA98, 37353942617918568, 89302965, 89302968, 3, 640x360 
0x1382CA98, 37353942618220208, 89302997, 89303005, 8, 640x360 
0x1382CA98, 37353942618539232, 89303039, 89303046, 7, 640x360 
0x1382CA98, 37353942618859800, 89303070, 89303077, 7, 640x360 
0x1382CA98, 37353942619180072, 89303105, 89303112, 7, 640x360 
0x1382CA98, 37353942619503536, 89303136, 89303139, 3, 640x360 
0x1382CA98, 37353942619822656, 89303163, 89303166, 3, 640x360 
0x1382CA98, 37353942620144664, 89303199, 89303202, 3, 640x360 
0x1382CA98, 37353942620619304, 89303245, 89303253, 8, 640x360 
0x1382CA98, 37353942620945056, 89303270, 89303276, 6, 640x360 
0x1382CA98, 37353942621263696, 89303304, 89303314, 10, 640x360 
0x1382CA98, 37353942621599864, 89303337, 89303344, 7, 640x360 
0x1382CA98, 37353942621911704, 89303367, 89303372, 5, 640x360 
0x1382CA98, 37353942622223960, 89303400, 89303404, 4, 640x360 
0x1382CA98, 37353942622547328, 89303433, 89303435, 2, 640x360 
0x1382CA98, 37353942622859200, 89303460, 89303465, 5, 640x360 
0x1382CA98, 37353942623179112, 89303493, 89303498, 5, 640x360 
0x1382CA98, 37353942623499472, 89303527, 89303533, 6, 640x360 
0x1382CA98, 37353942623819704, 89303562, 89303568, 6, 640x360 
0x1382CA98, 37353942624143928, 89303589, 89303591, 2, 640x360 
0x1382CA98, 37353942624619744, 89303644, 89303656, 12, 640x360 
0x1382CA98, 37353942624939872, 89303667, 89303674, 7, 640x360 
0x1382CA98, 37353942625267040, 89303706, 89303713, 7, 640x360 
0x1382CA98, 37353942625585832, 89303747, 89303748, 1, 640x360 
0x1382CA98, 37353942625918576, 89303768, 89303778, 10, 640x360 
0x1382CA98, 37353942626220432, 89303807, 89303814, 7, 640x360 
0x1382CA98, 37353942626542688, 89303831, 89303834, 3, 640x360 
0x1382CA98, 37353942626860440, 89303860, 89303862, 2, 640x360 
0x1382CA98, 37353942627182800, 89303893, 89303896, 3, 640x360 
0x1382CA98, 37353942627502656, 89303932, 89303934, 2, 640x360 
0x1382CA98, 37353942627819232, 89303968, 89303974, 6, 640x360 
0x1382CA98, 37353942628140512, 89303994, 89304000, 6, 640x360 
0x1382CA98, 37353942628938968, 89304067, 89304071, 4, 640x360 
0x1382CA98, 37353942629270376, 89304107, 89304109, 2, 640x360 
0x1382CA98, 37353942629594120, 89304131, 89304134, 3, 640x360 
0x1382CA98, 37353942629911680, 89304178, 89304181, 3, 640x360 
0x1382CA98, 37353942630221464, 89304198, 89304202, 4, 640x360 
0x1382CA98, 37353942630538928, 89304231, 89304233, 2, 640x360 
0x1382CA98, 37353942630859064, 89304262, 89304264, 2, 640x360 
0x1382CA98, 37353942631179112, 89304291, 89304300, 9, 640x360 
0x1382CA98, 37353942631502488, 89304325, 89304332, 7, 640x360 
0x1382CA98, 37353942631818912, 89304359, 89304362, 3, 640x360 
0x1382CA98, 37353942632139320, 89304393, 89304395, 2, 640x360 
0x1382CA98, 37353942632459424, 89304426, 89304427, 1, 640x360 
0x1382CA98, 37353942632939312, 89304478, 89304480, 2, 640x360 
0x1382CA98, 37353942633263352, 89304505, 89304512, 7, 640x360 
0x1382CA98, 37353942633599168, 89304544, 89304547, 3, 640x360 
0x1382CA98, 37353942633904888, 89304575, 89304577, 2, 640x360 
0x1382CA98, 37353942634236312, 89304605, 89304614, 9, 640x360 
0x1382CA98, 37353942634539120, 89304633, 89304636, 3, 640x360 
0x1382CA98, 37353942634859016, 89304669, 89304673, 4, 640x360 
0x1382CA98, 37353942635178920, 89304700, 89304701, 1, 640x360 
0x1382CA98, 37353942635502312, 89304730, 89304732, 2, 640x360 
0x1382CA98, 37353942635829744, 89304761, 89304763, 2, 640x360 
0x1382CA98, 37353942636140120, 89304795, 89304797, 2, 640x360 
0x1382CA98, 37353942636464584, 89304827, 89304830, 3, 640x360 
0x1382CA98, 37353942636942112, 89304868, 89304874, 6, 640x360 
0x1382CA98, 37353942637262096, 89304899, 89304902, 3, 640x360 
0x1382CA98, 37353942637584840, 89304939, 89304942, 3, 640x360 
0x1382CA98, 37353942637902688, 89304964, 89304966, 2, 640x360 
0x1382CA98, 37353942638219608, 89305001, 89305004, 3, 640x360 
0x1382CA98, 37353942638539440, 89305040, 89305043, 3, 640x360 
0x1382CA98, 37353942638859864, 89305066, 89305068, 2, 640x360 
0x1382CA98, 37353942639179688, 89305098, 89305101, 3, 640x360 
0x1382CA98, 37353942639521096, 89305134, 89305138, 4, 640x360 
0x1382CA98, 37353942639821304, 89305167, 89305174, 7, 640x360 
0x1382CA98, 37353942640152456, 89305201, 89305206, 5, 640x360 
0x1382CA98, 37353942640459144, 89305233, 89305238, 5, 640x360 
0x1382CA98, 37353942640942224, 89305274, 89305280, 6, 640x360 
0x1382CA98, 37353942641260040, 89305308, 89305313, 5, 640x360 
0x1382CA98, 37353942641589728, 89305336, 89305346, 10, 640x360 
0x1382CA98, 37353942641915848, 89305382, 89305386, 4, 640x360 
0x1382CA98, 37353942642219872, 89305400, 89305405, 5, 640x360 
0x1382CA98, 37353942642542528, 89305440, 89305446, 6, 640x360 
0x1382CA98, 37353942642859344, 89305468, 89305474, 6, 640x360 
0x1382CA98, 37353942643184176, 89305494, 89305497, 3, 640x360 
0x1382CA98, 37353942643498592, 89305534, 89305536, 2, 640x360 
0x1382CA98, 37353942643823672, 89305563, 89305566, 3, 640x360 
0x1382CA98, 37353942644142400, 89305593, 89305599, 6, 640x360 
0x1382CA98, 37353942644459608, 89305627, 89305630, 3, 640x360 
0x1382CA98, 37353942644938680, 89305681, 89305683, 2, 640x360 
0x1382CA98, 37353942645263552, 89305703, 89305708, 5, 640x360 
0x1382CA98, 37353942645582576, 89305735, 89305740, 5, 640x360 
0x1382CA98, 37353942645903768, 89305765, 89305767, 2, 640x360 
0x1382CA98, 37353942646223312, 89305807, 89305809, 2, 640x360 
0x1382CA98, 37353942646568920, 89305834, 89305837, 3, 640x360 
0x1382CA98, 37353942646863992, 89305868, 89305871, 3, 640x360 
0x1382CA98, 37353942647179144, 89305894, 89305908, 14, 640x360 
0x1382CA98, 37353942647507288, 89305931, 89305933, 2, 640x360 
0x1382CA98, 37353942647818856, 89305961, 89305963, 2, 640x360 
0x1382CA98, 37353942648152120, 89305994, 89305996, 2, 640x360 
0x1382CA98, 37353942648476280, 89306026, 89306029, 3, 640x360 
0x1382CA98, 37353942648938632, 89306072, 89306082, 10, 640x360 
0x1382CA98, 37353942649265144, 89306113, 89306120, 7, 640x360 
0x1382CA98, 37353942649586504, 89306135, 89306139, 4, 640x360 
0x1382CA98, 37353942649916536, 89306168, 89306174, 6, 640x360 
0x1382CA98, 37353942650219864, 89306201, 89306207, 6, 640x360 
0x1382CA98, 37353942650539040, 89306230, 89306232, 2, 640x360 
0x1382CA98, 37353942650858952, 89306264, 89306266, 2, 640x360 
0x1382CA98, 37353942651179832, 89306297, 89306299, 2, 640x360 
0x1382CA98, 37353942651501680, 89306327, 89306330, 3, 640x360 
0x1382CA98, 37353942651820720, 89306360, 89306363, 3, 640x360 
0x1382CA98, 37353942652150832, 89306394, 89306397, 3, 640x360 
0x1382CA98, 37353942652478280, 89306428, 89306430, 2, 640x360 
0x1382CA98, 37353942652938312, 89306470, 89306486, 16, 640x360 
0x1382CA98, 37353942925417200, 89333719, 89333734, 15, 640x360 
0x1382CA98, 37353942925731848, 89333754, 89333765, 11, 640x360 
0x1382CA98, 37353942926052568, 89333791, 89333794, 3, 640x360 
0x1382CA98, 37353942926378944, 89333828, 89333839, 11, 640x360 
0x1382CA98, 37353942926767176, 89333866, 89333870, 4, 640x360 
0x1382CA98, 37353942927016536, 89333899, 89333907, 8, 640x360 
0x1382CA98, 37353942927338592, 89333942, 89333946, 4, 640x360 
0x1382CA98, 37353942927670496, 89333956, 89333958, 2, 640x360 
0x1382CA98, 37353942927980200, 89333990, 89333999, 9, 640x360 
0x1382CA98, 37353942928506632, 89334049, 89334066, 17, 640x360 
0x1382CA98, 37353942928834152, 89334089, 89334100, 11, 640x360 
0x1382CA98, 37353942929111152, 89334118, 89334142, 24, 640x360 
0x1382CA98, 37353942929440824, 89334142, 89334157, 15, 640x360 
0x1382CA98, 37353942929787704, 89334180, 89334199, 19, 640x360 
0x1382CA98, 37353942930110480, 89334226, 89334228, 2, 640x360 
0x1382CA98, 37353942930463424, 89334249, 89334256, 7, 640x360 
0x1382CA98, 37353942930779112, 89334282, 89334292, 10, 640x360 
0x1382CA98, 37353942931119672, 89334313, 89334322, 9, 640x360 
0x1382CA98, 37353942931364576, 89334322, 89334328, 6, 640x360 
0x1382CA98, 37353942931653640, 89334351, 89334360, 9, 640x360 
0x1382CA98, 37353942931973576, 89334379, 89334381, 2, 640x360 
0x1382CA98, 37353942932450616, 89334423, 89334425, 2, 640x360 
0x1382CA98, 37353942932772328, 89334453, 89334464, 11, 640x360 
0x1382CA98, 37353942933095304, 89334485, 89334494, 9, 640x360 
0x1382CA98, 37353942933416776, 89334521, 89334525, 4, 640x360 
0x1382CA98, 37353942933749880, 89334554, 89334563, 9, 640x360 
0x1382CA98, 37353942934051960, 89334583, 89334585, 2, 640x360 
0x1382CA98, 37353942934375384, 89334621, 89334630, 9, 640x360 
0x1382CA98, 37353942934691192, 89334648, 89334650, 2, 640x360 
0x1382CA98, 37353942935017352, 89334692, 89334723, 31, 640x360 
0x1382CA98, 37353942935357352, 89334723, 89334725, 2, 640x360 
0x1382CA98, 37353942935651128, 89334746, 89334748, 2, 640x360 
0x1382CA98, 37353942935978648, 89334778, 89334780, 2, 640x360 
0x1382CA98, 37353942936452616, 89334824, 89334826, 2, 640x360 
0x1382CA98, 37353942936771000, 89334860, 89334862, 2, 640x360 
0x1382CA98, 37353942937091520, 89334890, 89334893, 3, 640x360 
0x1382CA98, 37353942937412248, 89334923, 89334925, 2, 640x360 
0x1382CA98, 37353942937731224, 89334955, 89334958, 3, 640x360 
0x1382CA98, 37353942938051504, 89334990, 89334992, 2, 640x360 
0x1382CA98, 37353942938375224, 89335013, 89335015, 2, 640x360 
0x1382CA98, 37353942938691960, 89335046, 89335049, 3, 640x360 
0x1382CA98, 37353942939012024, 89335076, 89335083, 7, 640x360 
0x1382CA98, 37353942939332152, 89335108, 89335110, 2, 640x360 
0x1382CA98, 37353942939659216, 89335145, 89335148, 3, 640x360 
0x1382CA98, 37353942939986784, 89335175, 89335178, 3, 640x360 
0x1382CA98, 37353942940451248, 89335220, 89335223, 3, 640x360 
0x1382CA98, 37353942940775320, 89335251, 89335254, 3, 640x360 
0x1382CA98, 37353942941097168, 89335288, 89335292, 4, 640x360 
0x1382CA98, 37353942941412664, 89335320, 89335325, 5, 640x360 
0x1382CA98, 37353942941733144, 89335355, 89335357, 2, 640x360 
0x1382CA98, 37353942942052112, 89335380, 89335382, 2, 640x360 
0x1382CA98, 37353942942370952, 89335416, 89335420, 4, 640x360 
0x1382CA98, 37353942942695808, 89335450, 89335452, 2, 640x360 
0x1382CA98, 37353942943014168, 89335476, 89335482, 6, 640x360 
0x1382CA98, 37353942943331016, 89335508, 89335515, 7, 640x360 
0x1382CA98, 37353942943676184, 89335545, 89335547, 2, 640x360 
0x1382CA98, 37353942943976504, 89335578, 89335580, 2, 640x360 
0x1382CA98, 37353942944450488, 89335618, 89335621, 3, 640x360 
0x1382CA98, 37353942944776248, 89335654, 89335660, 6, 640x360 
0x1382CA98, 37353942945102344, 89335689, 89335691, 2, 640x360 
0x1382CA98, 37353942945422392, 89335715, 89335717, 2, 640x360 
0x1382CA98, 37353942945739200, 89335751, 89335760, 9, 640x360 
0x1382CA98, 37353942946063152, 89335782, 89335786, 4, 640x360 
0x1382CA98, 37353942946371296, 89335818, 89335826, 8, 640x360 
0x1382CA98, 37353942946694648, 89335848, 89335851, 3, 640x360 
0x1382CA98, 37353942947014392, 89335882, 89335884, 2, 640x360 
0x1382CA98, 37353942947330928, 89335910, 89335912, 2, 640x360 
0x1382CA98, 37353942947655792, 89335940, 89335942, 2, 640x360 
0x1382CA98, 37353942947971968, 89335976, 89335979, 3, 640x360 
0x1382CA98, 37353942948450608, 89336023, 89336027, 4, 640x360 
0x1382CA98, 37353942948770944, 89336052, 89336055, 3, 640x360 
0x1382CA98, 37353942949094904, 89336088, 89336096, 8, 640x360 
0x1382CA98, 37353942949421472, 89336119, 89336133, 14, 640x360 
0x1382CA98, 37353942949737552, 89336155, 89336162, 7, 640x360 
0x1382CA98, 37353942950052600, 89336180, 89336182, 2, 640x360 
0x1382CA98, 37353942950374744, 89336215, 89336217, 2, 640x360 
0x1382CA98, 37353942950690840, 89336248, 89336250, 2, 640x360 
0x1382CA98, 37353942951010648, 89336281, 89336284, 3, 640x360 
0x1382CA98, 37353942951331120, 89336313, 89336316, 3, 640x360 
0x1382CA98, 37353942951650704, 89336347, 89336349, 2, 640x360 
0x1382CA98, 37353942951975888, 89336379, 89336381, 2, 640x360 
0x1382CA98, 37353942952295456, 89336404, 89336406, 2, 640x360 
0x1382CA98, 37353942952781976, 89336456, 89336459, 3, 640x360 
0x1382CA98, 37353942953096656, 89336489, 89336492, 3, 640x360 
0x1382CA98, 37353942953416912, 89336521, 89336525, 4, 640x360 
0x1382CA98, 37353942953745888, 89336555, 89336558, 3, 640x360 
0x1382CA98, 37353942954052856, 89336586, 89336592, 6, 640x360 
0x1382CA98, 37353942954370896, 89336618, 89336628, 10, 640x360 
0x1382CA98, 37353942954694456, 89336650, 89336653, 3, 640x360 
0x1382CA98, 37353942955013984, 89336682, 89336684, 2, 640x360 
0x1382CA98, 37353942955330856, 89336711, 89336713, 2, 640x360 
0x1382CA98, 37353942955654360, 89336748, 89336750, 2, 640x360 
0x1382CA98, 37353942955971008, 89336780, 89336783, 3, 640x360 
0x1382CA98, 37353942956291040, 89336808, 89336811, 3, 640x360 
0x1382CA98, 37353942956778376, 89336862, 89336867, 5, 640x360 
0x1382CA98, 37353942957098248, 89336884, 89336888, 4, 640x360 
0x1382CA98, 37353942957417968, 89336916, 89336924, 8, 640x360 
0x1382CA98, 37353942957752848, 89336948, 89336950, 2, 640x360 
0x1382CA98, 37353942958054848, 89336984, 89336998, 14, 640x360 
0x1382CA98, 37353942958376416, 89337028, 89337031, 3, 640x360 
0x1382CA98, 37353942958690224, 89337051, 89337054, 3, 640x360 
0x1382CA98, 37353942959017048, 89337084, 89337089, 5, 640x360 
0x1382CA98, 37353942959330896, 89337111, 89337114, 3, 640x360 
0x1382CA98, 37353942959651376, 89337148, 89337150, 2, 640x360 
0x1382CA98, 37353942959971368, 89337180, 89337182, 2, 640x360 
0x1382CA98, 37353942960290416, 89337211, 89337214, 3, 640x360 
0x1382CA98, 37353942960815000, 89337268, 89337281, 13, 640x360 
0x1382CA98, 37353942961110504, 89337294, 89337300, 6, 640x360 
0x1382CA98, 37353942961417440, 89337321, 89337330, 9, 640x360 
0x1382CA98, 37353942961731680, 89337348, 89337350, 2, 640x360 
0x1382CA98, 37353942962051416, 89337380, 89337382, 2, 640x360 
0x1382CA98, 37353942962369912, 89337418, 89337421, 3, 640x360 
0x1382CA98, 37353942962695896, 89337446, 89337448, 2, 640x360 
0x1382CA98, 37353942963022656, 89337479, 89337483, 4, 640x360 
0x1382CA98, 37353942963334432, 89337511, 89337515, 4, 640x360 
0x1382CA98, 37353942963653440, 89337543, 89337545, 2, 640x360 
0x1382CA98, 37353942963972920, 89337579, 89337592, 13, 640x360 
0x1382CA98, 37353942964291984, 89337616, 89337618, 2, 640x360 
0x1382CA98, 37353942964769808, 89337656, 89337665, 9, 640x360 
0x1382CA98, 37353942965097896, 89337689, 89337697, 8, 640x360 
0x1382CA98, 37353942965435976, 89337721, 89337728, 7, 640x360 
0x1382CA98, 37353942965733872, 89337754, 89337763, 9, 640x360 
0x1382CA98, 37353942966049976, 89337785, 89337796, 11, 640x360 
0x1382CA98, 37353942966369872, 89337817, 89337827, 10, 640x360 
0x1382CA98, 37353942966690072, 89337843, 89337845, 2, 640x360 
0x1382CA98, 37353942967014040, 89337879, 89337881, 2, 640x360 
0x1382CA98, 37353942967330360, 89337911, 89337914, 3, 640x360 
0x1382CA98, 37353942967656392, 89337951, 89337954, 3, 640x360 
0x1382CA98, 37353942967974448, 89337976, 89337984, 8, 640x360 
0x1382CA98, 37353942968290328, 89338007, 89338010, 3, 640x360 
0x1382CA98, 37353942968770640, 89338053, 89338057, 4, 640x360 
0x1382CA98, 37353942969089968, 89338085, 89338097, 12, 640x360 
0x1382CA98, 37353942969416944, 89338118, 89338121, 3, 640x360 
0x1382CA98, 37353942969737296, 89338161, 89338163, 2, 640x360 
0x1382CA98, 37353942970050256, 89338186, 89338191, 5, 640x360 
0x1382CA98, 37353942970372992, 89338213, 89338215, 2, 640x360 
0x1382CA98, 37353942970700016, 89338250, 89338253, 3, 640x360 
0x1382CA98, 37353942971011000, 89338277, 89338282, 5, 640x360 
0x1382CA98, 37353942971346984, 89338312, 89338315, 3, 640x360 
0x1382CA98, 37353942971650824, 89338344, 89338350, 6, 640x360 
0x1382CA98, 37353942971975416, 89338375, 89338377, 2, 640x360 
0x1382CA98, 37353942972291272, 89338407, 89338410, 3, 640x360 
0x1382CA98, 37353942972770648, 89338453, 89338457, 4, 640x360 
0x1382CA98, 37353942973090272, 89338485, 89338493, 8, 640x360 
0x1382CA98, 37353942973426088, 89338517, 89338523, 6, 640x360 
0x1382CA98, 37353942973734184, 89338555, 89338563, 8, 640x360 
0x1382CA98, 37353942974052272, 89338580, 89338582, 2, 640x360 
0x1382CA98, 37353942974370760, 89338621, 89338625, 4, 640x360 
0x1382CA98, 37353942974692024, 89338649, 89338651, 2, 640x360 
0x1382CA98, 37353942975010024, 89338681, 89338685, 4, 640x360 
0x1382CA98, 37353942975330912, 89338709, 89338712, 3, 640x360 
0x1382CA98, 37353942975653568, 89338747, 89338749, 2, 640x360 
0x1382CA98, 37353942975975112, 89338776, 89338778, 2, 640x360 
0x1382CA98, 37353942976290784, 89338808, 89338813, 5, 640x360 
0x1382CA98, 37353942976769568, 89338855, 89338859, 4, 640x360 
0x1382CA98, 37353942977092408, 89338883, 89338885, 2, 640x360 
0x1382CA98, 37353942977420616, 89338919, 89338924, 5, 640x360 
0x1382CA98, 37353942977749248, 89338952, 89338957, 5, 640x360 
0x1382CA98, 37353942978050752, 89338983, 89338986, 3, 640x360 
0x1382CA98, 37353942978369584, 89339014, 89339016, 2, 640x360 
0x1382CA98, 37353942978709368, 89339054, 89339061, 7, 640x360 
0x1382CA98, 37353942979010280, 89339086, 89339094, 8, 640x360 
0x1382CA98, 37353942979329904, 89339115, 89339117, 2, 640x360 
0x1382CA98, 37353942979658776, 89339144, 89339146, 2, 640x360 
0x1382CA98, 37353942979970432, 89339175, 89339178, 3, 640x360 
0x1382CA98, 37353942980302072, 89339211, 89339215, 4, 640x360 
0x1382CA98, 37353942980610792, 89339242, 89339244, 2, 640x360 
0x1382CA98, 37353942981093056, 89339283, 89339285, 2, 640x360 
0x1382CA98, 37353942981414552, 89339314, 89339316, 2, 640x360 
0x1382CA98, 37353942981730720, 89339351, 89339358, 7, 640x360 
0x1382CA98, 37353942982059720, 89339388, 89339403, 15, 640x360 
0x1382CA98, 37353942982374696, 89339432, 89339435, 3, 640x360 
0x1382CA98, 37353942982692464, 89339454, 89339456, 2, 640x360 
0x1382CA98, 37353942983011496, 89339482, 89339488, 6, 640x360 
0x1382CA98, 37353942983330264, 89339520, 89339536, 16, 640x360 
0x1382CA98, 37353942983682160, 89339556, 89339565, 9, 640x360 
0x1382CA98, 37353942983980200, 89339584, 89339586, 2, 640x360 
0x1382CA98, 37353942984308720, 89339620, 89339634, 14, 640x360 
0x1382CA98, 37353942984621064, 89339646, 89339648, 2, 640x360 
0x1382CA98, 37353942985097944, 89339688, 89339696, 8, 640x360 
0x1382CA98, 37353942985437088, 89339760, 89339764, 4, 640x360 
0x1382CA98, 37353942986049392, 89339794, 89339800, 6, 640x360 
0x1382CA98, 37353942986371560, 89339820, 89339827, 7, 640x360 
0x1382CA98, 37353942986690208, 89339854, 89339865, 11, 640x360 
0x1382CA98, 37353942987016328, 89339885, 89339889, 4, 640x360 
0x1382CA98, 37353942987330984, 89339912, 89339918, 6, 640x360 
0x1382CA98, 37353942987656784, 89339946, 89339948, 2, 640x360 
0x1382CA98, 37353942987975080, 89339981, 89339987, 6, 640x360 
0x1382CA98, 37353942988298624, 89340009, 89340021, 12, 640x360 
0x1382CA98, 37353942988610672, 89340035, 89340037, 2, 640x360 
0x1382CA98, 37353942989094384, 89340087, 89340095, 8, 640x360 
0x1382CA98, 37353942989425936, 89340128, 89340134, 6, 640x360 
0x1382CA98, 37353942989791648, 89340157, 89340161, 4, 640x360 
0x1382CA98, 37353942990049656, 89340183, 89340185, 2, 640x360 
0x1382CA98, 37353942990381024, 89340214, 89340216, 2, 640x360 
0x1382CA98, 37353942990694464, 89340246, 89340249, 3, 640x360 
0x1382CA98, 37353942991013024, 89340280, 89340283, 3, 640x360 
0x1382CA98, 37353942991334160, 89340314, 89340317, 3, 640x360 
0x1382CA98, 37353942991656736, 89340346, 89340350, 4, 640x360 
0x1382CA98, 37353942991970056, 89340377, 89340379, 2, 640x360 
0x1382CA98, 37353942992293944, 89340414, 89340420, 6, 640x360 
0x1382CA98, 37353942992614888, 89340446, 89340450, 4, 640x360 
0x1382CA98, 37353942993093032, 89340489, 89340500, 11, 640x360 
0x1382CA98, 37353942993424216, 89340522, 89340533, 11, 640x360 
0x1382CA98, 37353942993733488, 89340569, 89340576, 7, 640x360 
0x1382CA98, 37353942994049000, 89340594, 89340598, 4, 640x360 
0x1382CA98, 37353942994376328, 89340622, 89340632, 10, 640x360 
0x1382CA98, 37353942994689848, 89340657, 89340667, 10, 640x360 
0x1382CA98, 37353942995010240, 89340679, 89340688, 9, 640x360 
0x1382CA98, 37353942995329224, 89340715, 89340718, 3, 640x360 
0x1382CA98, 37353942995649464, 89340748, 89340751, 3, 640x360 
0x1382CA98, 37353942995985856, 89340795, 89340807, 12, 640x360 
0x1382CA98, 37353942996294944, 89340839, 89340855, 16, 640x360 
0x1382CA98, 37353942996630936, 89340865, 89340867, 2, 640x360 
0x1382CA98, 37353942997095464, 89340892, 89340900, 8, 640x360 
0x1382CA98, 37353942997415560, 89340928, 89340934, 6, 640x360 
0x1382CA98, 37353942997732936, 89340962, 89340964, 2, 640x360 
0x1382CA98, 37353942998052952, 89340989, 89341007, 18, 640x360 
0x1382CA98, 37353942998379648, 89341021, 89341029, 8, 640x360 
0x1382CA98, 37353942998689848, 89341058, 89341065, 7, 640x360 
0x1382CA98, 37353942999011136, 89341091, 89341101, 10, 640x360 
0x1382CA98, 37353942999332392, 89341123, 89341130, 7, 640x360 
0x1382CA98, 37353942999673976, 89341162, 89341182, 20, 640x360 
0x1382CA98, 37353943000031136, 89341198, 89341203, 5, 640x360 
0x1382CA98, 37353943000315448, 89341222, 89341227, 5, 640x360 
0x1382CA98, 37353943000623072, 89341251, 89341258, 7, 640x360 
0x1382CA98, 37353943001111904, 89341301, 89341315, 14, 640x360 
0x1382CA98, 37353943001435664, 89341327, 89341333, 6, 640x360 
0x1382CA98, 37353943001733896, 89341360, 89341363, 3, 640x360 
0x1382CA98, 37353943002057688, 89341384, 89341386, 2, 640x360 
0x1382CA98, 37353943002375080, 89341417, 89341420, 3, 640x360 
0x1382CA98, 37353943002690120, 89341445, 89341447, 2, 640x360 
0x1382CA98, 37353943003013632, 89341483, 89341485, 2, 640x360 
0x1382CA98, 37353943003335232, 89341517, 89341520, 3, 640x360 
0x1382CA98, 37353943003649664, 89341544, 89341550, 6, 640x360 
0x1382CA98, 37353943003969904, 89341572, 89341575, 3, 640x360 
0x1382CA98, 37353943004294384, 89341604, 89341615, 11, 640x360 
0x1382CA98, 37353943004609808, 89341635, 89341639, 4, 640x360 
0x1382CA98, 37353943004929928, 89341671, 89341678, 7, 640x360 
0x1382CA98, 37353943005415872, 89341722, 89341725, 3, 640x360 
0x1382CA98, 37353943005730256, 89341748, 89341750, 2, 640x360 
0x1382CA98, 37353943006057064, 89341784, 89341786, 2, 640x360 
0x1382CA98, 37353943006376240, 89341816, 89341820, 4, 640x360 
0x1382CA98, 37353943006689560, 89341851, 89341858, 7, 640x360 
0x1382CA98, 37353943007009120, 89341881, 89341884, 3, 640x360 
0x1382CA98, 37353943007334520, 89341918, 89341921, 3, 640x360 
0x1382CA98, 37353943007653176, 89341946, 89341948, 2, 640x360 
0x1382CA98, 37353943007975288, 89341978, 89341986, 8, 640x360 
0x1382CA98, 37353943008290752, 89342016, 89342018, 2, 640x360 
0x1382CA98, 37353943008627200, 89342049, 89342054, 5, 640x360 
0x1382CA98, 37353943008929072, 89342075, 89342081, 6, 640x360 
0x1382CA98, 37353943009415352, 89342127, 89342130, 3, 640x360 
0x1382CA98, 37353943009739336, 89342159, 89342171, 12, 640x360 
0x1382CA98, 37353943010050064, 89342200, 89342204, 4, 640x360 
0x1382CA98, 37353943010373032, 89342231, 89342237, 6, 640x360 
0x1382CA98, 37353943010696216, 89342260, 89342263, 3, 640x360 
0x1382CA98, 37353943011009328, 89342296, 89342306, 10, 640x360 
0x1382CA98, 37353943011349144, 89342342, 89342349, 7, 640x360 
0x1382CA98, 37353943011662440, 89342353, 89342356, 3, 640x360 
0x1382CA98, 37353943011984376, 89342385, 89342398, 13, 640x360 
0x1382CA98, 37353943012312136, 89342419, 89342429, 10, 640x360 
0x1382CA98, 37353943012618008, 89342453, 89342465, 12, 640x360 
0x1382CA98, 37353943012953096, 89342476, 89342478, 2, 640x360 
0x1382CA98, 37353943013437080, 89342526, 89342533, 7, 640x360 
0x1382CA98, 37353943013764552, 89342558, 89342565, 7, 640x360 
0x1382CA98, 37353943014053584, 89342604, 89342608, 4, 640x360 
0x1382CA98, 37353943014383976, 89342629, 89342640, 11, 640x360 
0x1382CA98, 37353943014705920, 89342656, 89342665, 9, 640x360 
0x1382CA98, 37353943015009072, 89342689, 89342694, 5, 640x360 
0x1382CA98, 37353943015334136, 89342718, 89342725, 7, 640x360 
0x1382CA98, 37353943015652960, 89342750, 89342754, 4, 640x360 
0x1382CA98, 37353943015972488, 89342812, 89342816, 4, 640x360 
0x1382CA98, 37353943016303408, 89342816, 89342818, 2, 640x360 
0x1382CA98, 37353943016622712, 89342852, 89342871, 19, 640x360 
0x1382CA98, 37353943016977224, 89342882, 89342884, 2, 640x360 
0x1382CA98, 37353943017412192, 89342930, 89342944, 14, 640x360 
0x1382CA98, 37353943017739752, 89342962, 89342968, 6, 640x360 
0x1382CA98, 37353943018049720, 89342994, 89342999, 5, 640x360 
0x1382CA98, 37353943018373880, 89343022, 89343034, 12, 640x360 
0x1382CA98, 37353943018702112, 89343056, 89343064, 8, 640x360 
0x1382CA98, 37353943019009408, 89343090, 89343099, 9, 640x360 
0x1382CA98, 37353943019335032, 89343118, 89343125, 7, 640x360 
0x1382CA98, 37353943019648632, 89343145, 89343153, 8, 640x360 
0x1382CA98, 37353943019968648, 89343174, 89343184, 10, 640x360 
0x1382CA98, 37353943020292592, 89343211, 89343215, 4, 640x360 
0x1382CA98, 37353943020612624, 89343240, 89343249, 9, 640x360 
0x1382CA98, 37353943020930248, 89343267, 89343272, 5, 640x360 
0x1382CA98, 37353943021450848, 89343332, 89343336, 4, 640x360 
0x1382CA98, 37353943021772872, 89343368, 89343374, 6, 640x360 
0x1382CA98, 37353943022049240, 89343398, 89343401, 3, 640x360 
0x1382CA98, 37353943022370008, 89343425, 89343450, 25, 640x360 
0x1382CA98, 37353943022698800, 89343462, 89343467, 5, 640x360 
0x1382CA98, 37353943023019296, 89343490, 89343493, 3, 640x360 
0x1382CA98, 37353943023334152, 89343517, 89343524, 7, 640x360 
0x1382CA98, 37353943023652248, 89343549, 89343552, 3, 640x360 
0x1382CA98, 37353943023973760, 89343576, 89343584, 8, 640x360 
0x1382CA98, 37353943024300704, 89343613, 89343616, 3, 640x360 
0x1382CA98, 37353943024621320, 89343641, 89343649, 8, 640x360 
0x1382CA98, 37353943024938088, 89343674, 89343679, 5, 640x360 
0x1382CA98, 37353943025417552, 89343724, 89343731, 7, 640x360 
0x1382CA98, 37353943025733840, 89343758, 89343767, 9, 640x360 
0x1382CA98, 37353943026050168, 89343791, 89343794, 3, 640x360 
0x1382CA98, 37353943026378200, 89343818, 89343821, 3, 640x360 
0x1382CA98, 37353943026692648, 89343849, 89343852, 3, 640x360 
0x1382CA98, 37353943027008976, 89343878, 89343884, 6, 640x360 
0x1382CA98, 37353943027329912, 89343912, 89343916, 4, 640x360 
0x1382CA98, 37353943027652248, 89343948, 89343952, 4, 640x360 
0x1382CA98, 37353943027974632, 89343980, 89343987, 7, 640x360 
0x1382CA98, 37353943028291504, 89344008, 89344012, 4, 640x360 
0x1382CA98, 37353943028610768, 89344039, 89344047, 8, 640x360 
0x1382CA98, 37353943028932504, 89344077, 89344080, 3, 640x360 
0x1382CA98, 37353943029414296, 89344128, 89344136, 8, 640x360 
0x1382CA98, 37353943029729696, 89344163, 89344171, 8, 640x360 
0x1382CA98, 37353943030049320, 89344188, 89344195, 7, 640x360 
0x1382CA98, 37353943030375280, 89344226, 89344229, 3, 640x360 
0x1382CA98, 37353943030695920, 89344252, 89344259, 7, 640x360 
0x1382CA98, 37353943031008360, 89344283, 89344285, 2, 640x360 
0x1382CA98, 37353943031328720, 89344311, 89344313, 2, 640x360 
0x1382CA98, 37353943031648696, 89344346, 89344348, 2, 640x360 
0x1382CA98, 37353943031977328, 89344378, 89344380, 2, 640x360 
0x1382CA98, 37353943032291232, 89344415, 89344417, 2, 640x360 
0x1382CA98, 37353943032610704, 89344442, 89344444, 2, 640x360 
0x1382CA98, 37353943032935624, 89344475, 89344477, 2, 640x360 
0x1382CA98, 37353943033248728, 89344502, 89344506, 4, 640x360 
0x1382CA98, 37353943033732824, 89344548, 89344550, 2, 640x360 
0x1382CA98, 37353943034049792, 89344590, 89344593, 3, 640x360 
0x1382CA98, 37353943034376640, 89344618, 89344624, 6, 640x360 
0x1382CA98, 37353943034692408, 89344657, 89344661, 4, 640x360 
0x1382CA98, 37353943035009136, 89344683, 89344686, 3, 640x360 
0x1382CA98, 37353943035328616, 89344710, 89344716, 6, 640x360 
0x1382CA98, 37353943035648728, 89344746, 89344755, 9, 640x360 
0x1382CA98, 37353943035972280, 89344778, 89344781, 3, 640x360 
0x1382CA98, 37353943036295792, 89344812, 89344821, 9, 640x360 
0x1382CA98, 37353943036608592, 89344849, 89344855, 6, 640x360 
0x1382CA98, 37353943036947992, 89344877, 89344884, 7, 640x360 
0x1382CA98, 37353943037262672, 89344908, 89344911, 3, 640x360 
0x1382CA98, 37353943037748184, 89344949, 89344952, 3, 640x360 
0x1382CA98, 37353943038052032, 89344996, 89345009, 13, 640x360 
0x1382CA98, 37353943038377648, 89345025, 89345027, 2, 640x360 
0x1382CA98, 37353943038688520, 89345058, 89345061, 3, 640x360 
0x1382CA98, 37353943039008840, 89345089, 89345094, 5, 640x360 
0x1382CA98, 37353943039328992, 89345118, 89345131, 13, 640x360 
0x1382CA98, 37353943039665264, 89345150, 89345157, 7, 640x360 
0x1382CA98, 37353943039986744, 89345189, 89345202, 13, 640x360 
0x1382CA98, 37353943040306256, 89345220, 89345234, 14, 640x360 
0x1382CA98, 37353943040612824, 89345246, 89345250, 4, 640x360 
0x1382CA98, 37353943040956104, 89345279, 89345281, 2, 640x360 
0x1382CA98, 37353943041263296, 89345311, 89345321, 10, 640x360 
0x1382CA98, 37353943041728136, 89345357, 89345360, 3, 640x360 
0x1382CA98, 37353943042068216, 89345385, 89345393, 8, 640x360 
0x1382CA98, 37353943042371888, 89345419, 89345432, 13, 640x360 
0x1382CA98, 37353943042691880, 89345450, 89345453, 3, 640x360 
0x1382CA98, 37353943043007808, 89345480, 89345487, 7, 640x360 
0x1382CA98, 37353943043331920, 89345511, 89345518, 7, 640x360 
0x1382CA98, 37353943043650576, 89345555, 89345562, 7, 640x360 
0x1382CA98, 37353943043969592, 89345578, 89345580, 2, 640x360 
0x1382CA98, 37353943044288648, 89345613, 89345615, 2, 640x360 
0x1382CA98, 37353943044619504, 89345640, 89345648, 8, 640x360 
0x1382CA98, 37353943044929032, 89345680, 89345687, 7, 640x360 
0x1382CA98, 37353943045273352, 89345706, 89345714, 8, 640x360 
0x1382CA98, 37353943045728832, 89345755, 89345763, 8, 640x360 
0x1382CA98, 37353943046047544, 89345789, 89345793, 4, 640x360 
0x1382CA98, 37353943046367544, 89345816, 89345819, 3, 640x360 
0x1382CA98, 37353943046688552, 89345851, 89345855, 4, 640x360 
0x1382CA98, 37353943047009120, 89345879, 89345887, 8, 640x360 
0x1382CA98, 37353943047338384, 89345915, 89345922, 7, 640x360 
0x1382CA98, 37353943047647832, 89345943, 89345945, 2, 640x360 
0x1382CA98, 37353943047972848, 89345976, 89345980, 4, 640x360 
0x1382CA98, 37353943048292952, 89346010, 89346021, 11, 640x360 
0x1382CA98, 37353943048614112, 89346041, 89346050, 9, 640x360 
0x1382CA98, 37353943048928008, 89346068, 89346074, 6, 640x360 
0x1382CA98, 37353943049263616, 89346100, 89346102, 2, 640x360 
0x1382CA98, 37353943049731232, 89346152, 89346154, 2, 640x360 
0x1382CA98, 37353943050047528, 89346185, 89346187, 2, 640x360 
0x1382CA98, 37353943050371944, 89346217, 89346220, 3, 640x360 
0x1382CA98, 37353943050690392, 89346252, 89346257, 5, 640x360 
0x1382CA98, 37353943051007528, 89346279, 89346282, 3, 640x360 
0x1382CA98, 37353943051328560, 89346310, 89346318, 8, 640x360 
0x1382CA98, 37353943051649904, 89346344, 89346352, 8, 640x360 
0x1382CA98, 37353943051972720, 89346377, 89346380, 3, 640x360 
0x1382CA98, 37353943052291688, 89346412, 89346418, 6, 640x360 
0x1382CA98, 37353943052624680, 89346445, 89346449, 4, 640x360 
0x1382CA98, 37353943052945376, 89346479, 89346484, 5, 640x360 
0x1382CA98, 37353943053267336, 89346513, 89346515, 2, 640x360 
0x1382CA98, 37353943053727632, 89346550, 89346558, 8, 640x360 
0x1382CA98, 37353943054048160, 89346584, 89346588, 4, 640x360 
0x1382CA98, 37353943054367248, 89346615, 89346617, 2, 640x360 
0x1382CA98, 37353943054691672, 89346649, 89346651, 2, 640x360 
0x1382CA98, 37353943055011400, 89346677, 89346684, 7, 640x360 
0x1382CA98, 37353943055342936, 89346715, 89346717, 2, 640x360 
0x1382CA98, 37353943055648656, 89346753, 89346765, 12, 640x360 
0x1382CA98, 37353943055973536, 89346783, 89346785, 2, 640x360 
0x1382CA98, 37353943056315528, 89346811, 89346813, 2, 640x360 
0x1382CA98, 37353943056622576, 89346846, 89346847, 1, 640x360 
0x1382CA98, 37353943056932688, 89346878, 89346881, 3, 640x360 
0x1382CA98, 37353943057260328, 89346901, 89346905, 4, 640x360 
0x1382CA98, 37353943057727800, 89346953, 89346963, 10, 640x360 
0x1382CA98, 37353943058048808, 89346989, 89346993, 4, 640x360 
0x1382CA98, 37353943058368048, 89347017, 89347020, 3, 640x360 
0x1382CA98, 37353943058688496, 89347047, 89347051, 4, 640x360 
0x1382CA98, 37353943059007592, 89347084, 89347089, 5, 640x360 
0x1382CA98, 37353943059331504, 89347110, 89347114, 4, 640x360 
0x1382CA98, 37353943059648560, 89347141, 89347143, 2, 640x360 
0x1382CA98, 37353943059967632, 89347179, 89347182, 3, 640x360 
0x1382CA98, 37353943060289240, 89347217, 89347221, 4, 640x360 
0x1382CA98, 37353943060613280, 89347250, 89347256, 6, 640x360 
0x1382CA98, 37353943060932736, 89347277, 89347298, 21, 640x360 
0x1382CA98, 37353943061347536, 89347321, 89347333, 12, 640x360 
0x1382CA98, 37353943061569536, 89347346, 89347355, 9, 640x360 
0x1382CA98, 37353943062047560, 89347391, 89347393, 2, 640x360 
0x1382CA98, 37353943062372200, 89347429, 89347433, 4, 640x360 
0x1382CA98, 37353943062689080, 89347451, 89347454, 3, 640x360 
0x1382CA98, 37353943063021248, 89347483, 89347485, 2, 640x360 
0x1382CA98, 37353943063329024, 89347511, 89347518, 7, 640x360 
0x1382CA98, 37353943063648608, 89347546, 89347554, 8, 640x360 
0x1382CA98, 37353943063971208, 89347576, 89347580, 4, 640x360 
0x1382CA98, 37353943064290360, 89347608, 89347618, 10, 640x360 
0x1382CA98, 37353943064608104, 89347640, 89347643, 3, 640x360 
0x1382CA98, 37353943064934528, 89347669, 89347681, 12, 640x360 
0x1382CA98, 37353943065251000, 89347705, 89347709, 4, 640x360 
0x1382CA98, 37353943065571224, 89347736, 89347748, 12, 640x360 
0x1382CA98, 37353943066047696, 89347780, 89347782, 2, 640x360 
0x1382CA98, 37353943066369880, 89347818, 89347823, 5, 640x360 
0x1382CA98, 37353943066699240, 89347847, 89347849, 2, 640x360 
0x1382CA98, 37353943067007792, 89347883, 89347886, 3, 640x360 
0x1382CA98, 37353943067333488, 89347916, 89347920, 4, 640x360 
0x1382CA98, 37353943067650624, 89347946, 89347953, 7, 640x360 
0x1382CA98, 37353943067968136, 89347978, 89347980, 2, 640x360 
0x1382CA98, 37353943068292384, 89348015, 89348018, 3, 640x360 
0x1382CA98, 37353943068617992, 89348048, 89348053, 5, 640x360 
0x1382CA98, 37353943068941888, 89348082, 89348089, 7, 640x360 
0x1382CA98, 37353943069251072, 89348105, 89348110, 5, 640x360 
0x1382CA98, 37353943069577336, 89348147, 89348149, 2, 640x360 
0x1382CA98, 37353943070047248, 89348196, 89348201, 5, 640x360 
0x1382CA98, 37353943070368680, 89348223, 89348232, 9, 640x360 
0x1382CA98, 37353943070699296, 89348258, 89348261, 3, 640x360 
0x1382CA98, 37353943071014200, 89348285, 89348300, 15, 640x360 
0x1382CA98, 37353943071352256, 89348318, 89348322, 4, 640x360 
0x1382CA98, 37353943071656032, 89348345, 89348349, 4, 640x360 
0x1382CA98, 37353943071992472, 89348383, 89348386, 3, 640x360 
0x1382CA98, 37353943072292136, 89348419, 89348427, 8, 640x360 
0x1382CA98, 37353943072613208, 89348447, 89348458, 11, 640x360 
0x1382CA98, 37353943072939344, 89348479, 89348484, 5, 640x360 
0x1382CA98, 37353943073272824, 89348509, 89348518, 9, 640x360 
0x1382CA98, 37353943073581312, 89348544, 89348554, 10, 640x360 
0x1382CA98, 37353943074050944, 89348593, 89348595, 2, 640x360 
0x1382CA98, 37353943074367200, 89348624, 89348626, 2, 640x360 
0x1382CA98, 37353943074691760, 89348660, 89348662, 2, 640x360 
0x1382CA98, 37353943075011072, 89348695, 89348698, 3, 640x360 
0x1382CA98, 37353943075330744, 89348721, 89348740, 19, 640x360 
0x1382CA98, 37353943075650576, 89348755, 89348760, 5, 640x360 
0x1382CA98, 37353943075972584, 89348776, 89348779, 3, 640x360 
0x1382CA98, 37353943076292192, 89348808, 89348811, 3, 640x360 
0x1382CA98, 37353943076607224, 89348848, 89348851, 3, 640x360 
0x1382CA98, 37353943076947016, 89348885, 89348894, 9, 640x360 
0x1382CA98, 37353943077282736, 89348915, 89348918, 3, 640x360 
0x1382CA98, 37353943077604704, 89348951, 89348955, 4, 640x360 
0x1382CA98, 37353943078047952, 89348992, 89349005, 13, 640x360 
0x1382CA98, 37353943078370864, 89349045, 89349047, 2, 640x360 
0x1382CA98, 37353943078700160, 89349052, 89349063, 11, 640x360 
0x1382CA98, 37353943079018544, 89349095, 89349108, 13, 640x360 
0x1382CA98, 37353943079333224, 89349125, 89349128, 3, 640x360 
0x1382CA98, 37353943079651104, 89349162, 89349167, 5, 640x360 
0x1382CA98, 37353943079974736, 89349217, 89349249, 32, 640x360 
0x1382CA98, 37353943080343248, 89349249, 89349275, 26, 640x360 
0x1382CA98, 37353943080723960, 89349276, 89349283, 7, 640x360 
0x1382CA98, 37353943080997496, 89349301, 89349329, 28, 640x360 
0x1382CA98, 37353943081274360, 89349330, 89349344, 14, 640x360 
0x1382CA98, 37353943081633720, 89349358, 89349364, 6, 640x360 
0x1382CA98, 37353943082080448, 89349385, 89349389, 4, 640x360 
0x1382CA98, 37353943082378408, 89349428, 89349443, 15, 640x360 
0x1382CA98, 37353943082711504, 89349462, 89349465, 3, 640x360 
0x1382CA98, 37353943083010856, 89349485, 89349490, 5, 640x360 
0x1382CA98, 37353943083337680, 89349514, 89349516, 2, 640x360 
0x1382CA98, 37353943083666976, 89349547, 89349549, 2, 640x360 
0x1382CA98, 37353943083971976, 89349578, 89349582, 4, 640x360 
0x1382CA98, 37353943084292328, 89349612, 89349620, 8, 640x360 
0x1382CA98, 37353943084612400, 89349646, 89349648, 2, 640x360 
0x1382CA98, 37353943084928272, 89349669, 89349672, 3, 640x360 
0x1382CA98, 37353943085253704, 89349703, 89349707, 4, 640x360 
0x1382CA98, 37353943085579504, 89349738, 89349742, 4, 640x360 
0x1382CA98, 37353943085893104, 89349769, 89349776, 7, 640x360 
0x1382CA98, 37353943086366536, 89349816, 89349818, 2, 640x360 
0x1382CA98, 37353943086695544, 89349855, 89349859, 4, 640x360 
0x1382CA98, 37353943087009912, 89349878, 89349884, 6, 640x360 
0x1382CA98, 37353943087327152, 89349910, 89349913, 3, 640x360 
0x1382CA98, 37353943087651792, 89349947, 89349951, 4, 640x360 
0x1382CA98, 37353943087973464, 89349981, 89349987, 6, 640x360 
0x1382CA98, 37353943088288376, 89350008, 89350012, 4, 640x360 
0x1382CA98, 37353943088614184, 89350044, 89350052, 8, 640x360 
0x1382CA98, 37353943088945504, 89350073, 89350075, 2, 640x360 
0x1382CA98, 37353943089270400, 89350107, 89350112, 5, 640x360 
0x1382CA98, 37353943089572824, 89350139, 89350149, 10, 640x360 
0x1382CA98, 37353943089938048, 89350175, 89350180, 5, 640x360 
0x1382CA98, 37353943090366192, 89350216, 89350220, 4, 640x360 
0x1382CA98, 37353943090691424, 89350245, 89350247, 2, 640x360 
0x1382CA98, 37353943091006624, 89350283, 89350285, 2, 640x360 
0x1382CA98, 37353943091338440, 89350312, 89350314, 2, 640x360 
0x1382CA98, 37353943091660880, 89350350, 89350368, 18, 640x360 
0x1382CA98, 37353943091975032, 89350383, 89350390, 7, 640x360 
0x1382CA98, 37353943092289384, 89350407, 89350411, 4, 640x360 
0x1382CA98, 37353943092617528, 89350446, 89350455, 9, 640x360 
0x1382CA98, 37353943092928680, 89350472, 89350477, 5, 640x360 
0x1382CA98, 37353943093248688, 89350501, 89350504, 3, 640x360 
0x1382CA98, 37353943093574312, 89350539, 89350550, 11, 640x360 
0x1382CA98, 37353943093905032, 89350572, 89350582, 10, 640x360 
0x1382CA98, 37353943094366184, 89350616, 89350619, 3, 640x360 
0x1382CA98, 37353943094686872, 89350647, 89350650, 3, 640x360 
0x1382CA98, 37353943095012800, 89350689, 89350692, 3, 640x360 
0x1382CA98, 37353943095336352, 89350710, 89350713, 3, 640x360 
0x1382CA98, 37353943095650792, 89350748, 89350758, 10, 640x360 
0x1382CA98, 37353943096007312, 89350800, 89350804, 4, 640x360 
0x1382CA98, 37353943096322768, 89350821, 89350830, 9, 640x360 
0x1382CA98, 37353943096632904, 89350860, 89350866, 6, 640x360 
0x1382CA98, 37353943096970200, 89350886, 89350898, 12, 640x360 
0x1382CA98, 37353943097270024, 89350915, 89350918, 3, 640x360 
0x1382CA98, 37353943097574280, 89350952, 89350955, 3, 640x360 
0x1382CA98, 37353943097892360, 89350974, 89350978, 4, 640x360 
0x1382CA98, 37353943098366080, 89351016, 89351022, 6, 640x360 
0x1382CA98, 37353943098686168, 89351051, 89351055, 4, 640x360 
0x1382CA98, 37353943099006544, 89351077, 89351083, 6, 640x360 
0x1382CA98, 37353943099327272, 89351109, 89351118, 9, 640x360 
0x1382CA98, 37353943099646840, 89351142, 89351144, 2, 640x360 
0x1382CA98, 37353943099967568, 89351173, 89351177, 4, 640x360 
0x1382CA98, 37353943100290888, 89351207, 89351215, 8, 640x360 
0x1382CA98, 37353943100609096, 89351247, 89351256, 9, 640x360 
0x1382CA98, 37353943100928712, 89351283, 89351285, 2, 640x360 
0x1382CA98, 37353943101276032, 89351312, 89351314, 2, 640x360 
0x1382CA98, 37353943101579584, 89351349, 89351356, 7, 640x360 
0x1382CA98, 37353943101888696, 89351369, 89351375, 6, 640x360 
0x1382CA98, 37353943102366464, 89351423, 89351427, 4, 640x360 
0x1382CA98, 37353943102687064, 89351450, 89351453, 3, 640x360 
0x1382CA98, 37353943103006080, 89351481, 89351483, 2, 640x360 
0x1382CA98, 37353943103326240, 89351509, 89351514, 5, 640x360 
0x1382CA98, 37353943103646208, 89351542, 89351549, 7, 640x360 
0x1382CA98, 37353943103966936, 89351576, 89351579, 3, 640x360 
0x1382CA98, 37353943104288000, 89351603, 89351607, 4, 640x360 
0x1382CA98, 37353943104611328, 89351639, 89351643, 4, 640x360 
0x1382CA98, 37353943104926528, 89351673, 89351676, 3, 640x360 
0x1382CA98, 37353943105249568, 89351700, 89351702, 2, 640x360 
0x1382CA98, 37353943105573120, 89351733, 89351735, 2, 640x360 
0x1382CA98, 37353943105901464, 89351769, 89351781, 12, 640x360 
0x1382CA98, 37353943106366496, 89351816, 89351819, 3, 640x360 
0x1382CA98, 37353943106691016, 89351848, 89351851, 3, 640x360 
0x1382CA98, 37353943107006672, 89351882, 89351891, 9, 640x360 
0x1382CA98, 37353943107330352, 89351910, 89351913, 3, 640x360 
0x1382CA98, 37353943107646536, 89351948, 89351951, 3, 640x360 
0x1382CA98, 37353943108006088, 89351983, 89351985, 2, 640x360 
0x1382CA98, 37353943108294192, 89352012, 89352014, 2, 640x360 
0x1382CA98, 37353943108612200, 89352038, 89352043, 5, 640x360 
0x1382CA98, 37353943108938952, 89352077, 89352082, 5, 640x360 
0x1382CA98, 37353943109270016, 89352106, 89352115, 9, 640x360 
0x1382CA98, 37353943109573992, 89352138, 89352143, 5, 640x360 
0x1382CA98, 37353943109889008, 89352176, 89352179, 3, 640x360 
0x1382CA98, 37353943110369776, 89352217, 89352220, 3, 640x360 
0x1382CA98, 37353943110685776, 89352249, 89352251, 2, 640x360 
0x1382CA98, 37353943111013664, 89352281, 89352289, 8, 640x360 
0x1382CA98, 37353943111329192, 89352310, 89352316, 6, 640x360 
0x1382CA98, 37353943111650352, 89352343, 89352354, 11, 640x360 
0x1382CA98, 37353943111977808, 89352383, 89352387, 4, 640x360 
0x1382CA98, 37353943112289672, 89352415, 89352418, 3, 640x360 
0x1382CA98, 37353943112613136, 89352441, 89352444, 3, 640x360 
0x1382CA98, 37353943112947256, 89352485, 89352492, 7, 640x360 
0x1382CA98, 37353943113283240, 89352511, 89352513, 2, 640x360 
0x1382CA98, 37353943113609304, 89352551, 89352560, 9, 640x360 
0x1382CA98, 37353943113891992, 89352577, 89352580, 3, 640x360 
0x1382CA98, 37353943114206472, 89352603, 89352616, 13, 640x360 
0x1382CA98, 37353943114686096, 89352649, 89352651, 2, 640x360 
0x1382CA98, 37353943115008104, 89352686, 89352691, 5, 640x360 
0x1382CA98, 37353943115348408, 89352718, 89352722, 4, 640x360 
0x1382CA98, 37353943115664648, 89352750, 89352754, 4, 640x360 
0x1382CA98, 37353943115967848, 89352779, 89352782, 3, 640x360 
0x1382CA98, 37353943116286936, 89352806, 89352811, 5, 640x360 
0x1382CA98, 37353943116606520, 89352843, 89352851, 8, 640x360 
0x1382CA98, 37353943116934024, 89352873, 89352882, 9, 640x360 
0x1382CA98, 37353943117253760, 89352906, 89352915, 9, 640x360 
0x1382CA98, 37353943117572288, 89352936, 89352949, 13, 640x360 
0x1382CA98, 37353943117887720, 89352966, 89352971, 5, 640x360 
0x1382CA98, 37353943118208600, 89353004, 89353017, 13, 640x360 
0x1382CA98, 37353943118685616, 89353050, 89353053, 3, 640x360 
0x1382CA98, 37353943119010000, 89353078, 89353085, 7, 640x360 
0x1382CA98, 37353943119326808, 89353112, 89353118, 6, 640x360 
0x1382CA98, 37353943119657472, 89353143, 89353146, 3, 640x360 
0x1382CA98, 37353943119973000, 89353179, 89353184, 5, 640x360 
0x1382CA98, 37353943120286952, 89353217, 89353221, 4, 640x360 
0x1382CA98, 37353943120612584, 89353245, 89353253, 8, 640x360 
0x1382CA98, 37353943120951688, 89353280, 89353283, 3, 640x360 
0x1382CA98, 37353943121257224, 89353306, 89353316, 10, 640x360 
0x1382CA98, 37353943121593600, 89353339, 89353349, 10, 640x360 
0x1382CA98, 37353943121887600, 89353383, 89353394, 11, 640x360 
0x1382CA98, 37353943122262592, 89353423, 89353435, 12, 640x360 
0x1382CA98, 37353943122720168, 89353474, 89353478, 4, 640x360 
0x1382CA98, 37353943123015616, 89353504, 89353521, 17, 640x360 
0x1382CA98, 37353943123366760, 89353539, 89353543, 4, 640x360 
0x1382CA98, 37353943123665064, 89353572, 89353626, 54, 640x360 
0x1382CA98, 37353943123970448, 89353626, 89353634, 8, 640x360 
0x1382CA98, 37353943124618192, 89353646, 89353661, 15, 640x360 
0x1382CA98, 37353943124939296, 89353685, 89353700, 15, 640x360 
0x1382CA98, 37353943125276896, 89353719, 89353725, 6, 640x360 
0x1382CA98, 37353943125576112, 89353746, 89353750, 4, 640x360 
0x1382CA98, 37353943125887088, 89353773, 89353778, 5, 640x360 
0x1382CA98, 37353943126206720, 89353808, 89353815, 7, 640x360 
0x1382CA98, 37353943126685560, 89353848, 89353852, 4, 640x360 
0x1382CA98, 37353943127010776, 89353886, 89353892, 6, 640x360 
0x1382CA98, 37353943127329320, 89353919, 89353925, 6, 640x360 
0x1382CA98, 37353943127656784, 89353947, 89353958, 11, 640x360 
0x1382CA98, 37353943127999800, 89353984, 89353995, 11, 640x360 
0x1382CA98, 37353943128332784, 89354021, 89354032, 11, 640x360 
0x1382CA98, 37353943128700816, 89354061, 89354074, 13, 640x360 
0x1382CA98, 37353943128949392, 89354114, 89354130, 16, 640x360 
0x1382CA98, 37353943129451304, 89354134, 89354142, 8, 640x360 
0x1382CA98, 37353943129647760, 89354162, 89354165, 3, 640x360 
0x1382CA98, 37353943129924736, 89354178, 89354180, 2, 640x360 
0x1382CA98, 37353943130206688, 89354209, 89354212, 3, 640x360 
0x1382CA98, 37353943130685552, 89354263, 89354266, 3, 640x360 
0x1382CA98, 37353943131018392, 89354288, 89354291, 3, 640x360 
0x1382CA98, 37353943131329256, 89354327, 89354335, 8, 640x360 
0x1382CA98, 37353943131647024, 89354356, 89354361, 5, 640x360 
0x1382CA98, 37353943131972104, 89354396, 89354412, 16, 640x360 
0x1382CA98, 37353943132296336, 89354441, 89354455, 14, 640x360 
0x1382CA98, 37353943132625376, 89354461, 89354466, 5, 640x360 
0x1382CA98, 37353943132935272, 89354502, 89354512, 10, 640x360 
0x1382CA98, 37353943133269352, 89354527, 89354530, 3, 640x360 
0x1382CA98, 37353943133589512, 89354551, 89354575, 24, 640x360 
0x1382CA98, 37353943133989856, 89354584, 89354601, 17, 640x360 
0x1382CA98, 37353943134232784, 89354622, 89354634, 12, 640x360 
0x1382CA98, 37353943134708072, 89354650, 89354656, 6, 640x360 
0x1382CA98, 37353943135008904, 89354682, 89354684, 2, 640x360 
0x1382CA98, 37353943135341928, 89354715, 89354717, 2, 640x360 
0x1382CA98, 37353943135647792, 89354748, 89354756, 8, 640x360 
0x1382CA98, 37353943135966344, 89354780, 89354783, 3, 640x360 
0x1382CA98, 37353943136290600, 89354812, 89354821, 9, 640x360 
0x1382CA98, 37353943136608840, 89354844, 89354847, 3, 640x360 
0x1382CA98, 37353943136925640, 89354866, 89354868, 2, 640x360 
0x1382CA98, 37353943137250872, 89354908, 89354918, 10, 640x360 
0x1382CA98, 37353943137575056, 89354940, 89354943, 3, 640x360 
0x1382CA98, 37353943137897928, 89354972, 89354975, 3, 640x360 
0x1382CA98, 37353943138209800, 89355003, 89355008, 5, 640x360 
0x1382CA98, 37353943138689568, 89355045, 89355050, 5, 640x360 
0x1382CA98, 37353943139005536, 89355077, 89355083, 6, 640x360 
0x1382CA98, 37353943139326200, 89355109, 89355117, 8, 640x360 
0x1382CA98, 37353943139649920, 89355147, 89355149, 2, 640x360 
0x1382CA98, 37353943139965592, 89355175, 89355184, 9, 640x360 
0x1382CA98, 37353943140288384, 89355216, 89355218, 2, 640x360 
0x1382CA98, 37353943140607912, 89355249, 89355252, 3, 640x360 
0x1382CA98, 37353943140932120, 89355281, 89355283, 2, 640x360 
0x1382CA98, 37353943141273888, 89355312, 89355316, 4, 640x360 
0x1382CA98, 37353943141566240, 89355334, 89355340, 6, 640x360 
0x1382CA98, 37353943141886776, 89355371, 89355376, 5, 640x360 
0x1382CA98, 37353943142205592, 89355405, 89355415, 10, 640x360 
0x1382CA98, 37353943142526800, 89355430, 89355432, 2, 640x360 
0x1382CA98, 37353943143006040, 89355485, 89355491, 6, 640x360 
0x1382CA98, 37353943143339104, 89355522, 89355531, 9, 640x360 
0x1382CA98, 37353943143678960, 89355550, 89355552, 2, 640x360 
0x1382CA98, 37353943143971120, 89355582, 89355585, 3, 640x360 
0x1382CA98, 37353943144285856, 89355607, 89355615, 8, 640x360 
0x1382CA98, 37353943144605360, 89355640, 89355647, 7, 640x360 
0x1382CA98, 37353943144928648, 89355671, 89355679, 8, 640x360 
0x1382CA98, 37353943145262136, 89355701, 89355704, 3, 640x360 
0x1382CA98, 37353943145572120, 89355737, 89355744, 7, 640x360 
0x1382CA98, 37353943145885760, 89355771, 89355775, 4, 640x360 
0x1382CA98, 37353943146211408, 89355801, 89355805, 4, 640x360 
0x1382CA98, 37353943146529424, 89355829, 89355832, 3, 640x360 
0x1382CA98, 37353943147005040, 89355875, 89355880, 5, 640x360 
0x1382CA98, 37353943147330504, 89355913, 89355917, 4, 640x360 
0x1382CA98, 37353943147645760, 89355944, 89355951, 7, 640x360 
0x1382CA98, 37353943147968216, 89355972, 89355975, 3, 640x360 
0x1382CA98, 37353943148295360, 89356013, 89356022, 9, 640x360 
0x1382CA98, 37353943148613784, 89356045, 89356052, 7, 640x360 
0x1382CA98, 37353943148951048, 89356079, 89356081, 2, 640x360 
0x1382CA98, 37353943149253176, 89356102, 89356104, 2, 640x360 
0x1382CA98, 37353943149571128, 89356145, 89356159, 14, 640x360 
0x1382CA98, 37353943149898456, 89356177, 89356179, 2, 640x360 
0x1382CA98, 37353943150205464, 89356205, 89356216, 11, 640x360 
0x1382CA98, 37353943150527368, 89356233, 89356235, 2, 640x360 
0x1382CA98, 37353943151004648, 89356275, 89356280, 5, 640x360 
0x1382CA98, 37353943151330664, 89356312, 89356318, 6, 640x360 
0x1382CA98, 37353943151649976, 89356351, 89356360, 9, 640x360 
0x1382CA98, 37353943151967688, 89356376, 89356390, 14, 640x360 
0x1382CA98, 37353943152285280, 89356407, 89356410, 3, 640x360 
0x1382CA98, 37353943152615520, 89356438, 89356442, 4, 640x360 
0x1382CA98, 37353943152925440, 89356472, 89356481, 9, 640x360 
0x1382CA98, 37353943153255472, 89356500, 89356502, 2, 640x360 
0x1382CA98, 37353943153568192, 89356539, 89356549, 10, 640x360 
0x1382CA98, 37353943153885928, 89356572, 89356581, 9, 640x360 
0x1382CA98, 37353943154206432, 89356608, 89356615, 7, 640x360 
0x1382CA98, 37353943154535160, 89356639, 89356648, 9, 640x360 
0x1382CA98, 37353943155004912, 89356682, 89356687, 5, 640x360 
0x1382CA98, 37353943155325008, 89356709, 89356716, 7, 640x360 
0x1382CA98, 37353943155670304, 89356748, 89356752, 4, 640x360 
0x1382CA98, 37353943155964768, 89356778, 89356785, 7, 640x360 
0x1382CA98, 37353943156286624, 89356811, 89356813, 2, 640x360 
0x1382CA98, 37353943156604912, 89356838, 89356841, 3, 640x360 
0x1382CA98, 37353943156931272, 89356874, 89356879, 5, 640x360 
0x1382CA98, 37353943157250936, 89356904, 89356909, 5, 640x360 
0x1382CA98, 37353943157579720, 89356937, 89356944, 7, 640x360 
0x1382CA98, 37353943157896616, 89356969, 89356972, 3, 640x360 
0x1382CA98, 37353943158214872, 89357006, 89357011, 5, 640x360 
0x1382CA98, 37353943158531432, 89357039, 89357049, 10, 640x360 
0x1382CA98, 37353943159015856, 89357101, 89357104, 3, 640x360 
0x1382CA98, 37353943159334656, 89357119, 89357122, 3, 640x360 
0x1382CA98, 37353943159674792, 89357162, 89357174, 12, 640x360 
0x1382CA98, 37353943159978008, 89357190, 89357193, 3, 640x360 
0x1382CA98, 37353943160288832, 89357213, 89357215, 2, 640x360 
0x1382CA98, 37353943160605424, 89357239, 89357248, 9, 640x360 
0x1382CA98, 37353943160929264, 89357274, 89357282, 8, 640x360 
0x1382CA98, 37353943161252776, 89357303, 89357308, 5, 640x360 
0x1382CA98, 37353943161572040, 89357336, 89357349, 13, 640x360 
0x1382CA98, 37353943161885792, 89357369, 89357381, 12, 640x360 
0x1382CA98, 37353943162204976, 89357400, 89357402, 2, 640x360 
0x1382CA98, 37353943162525008, 89357432, 89357435, 3, 640x360 
0x1382CA98, 37353943163012024, 89357488, 89357495, 7, 640x360 
0x1382CA98, 37353943163326616, 89357518, 89357522, 4, 640x360 
0x1382CA98, 37353943163645272, 89357554, 89357560, 6, 640x360 
0x1382CA98, 37353943163965496, 89357580, 89357582, 2, 640x360 
0x1382CA98, 37353943164285112, 89357610, 89357613, 3, 640x360 
0x1382CA98, 37353943164605296, 89357646, 89357648, 2, 640x360 
0x1382CA98, 37353943164929800, 89357678, 89357680, 2, 640x360 
0x1382CA98, 37353943165248752, 89357704, 89357708, 4, 640x360 
0x1382CA98, 37353943165565256, 89357736, 89357742, 6, 640x360 
0x1382CA98, 37353943165885888, 89357769, 89357776, 7, 640x360 
0x1382CA98, 37353943166205256, 89357803, 89357808, 5, 640x360 
0x1382CA98, 37353943166529112, 89357830, 89357832, 2, 640x360 
0x1382CA98, 37353943166847480, 89357861, 89357867, 6, 640x360 
0x1382CA98, 37353943167329584, 89357913, 89357919, 6, 640x360 
0x1382CA98, 37353943167645432, 89357945, 89357956, 11, 640x360 
0x1382CA98, 37353943167968264, 89357972, 89357974, 2, 640x360 
0x1382CA98, 37353943168285064, 89358010, 89358023, 13, 640x360 
0x1382CA98, 37353943168612456, 89358047, 89358051, 4, 640x360 
0x1382CA98, 37353943168928136, 89358072, 89358079, 7, 640x360 
0x1382CA98, 37353943169249896, 89358104, 89358112, 8, 640x360 
0x1382CA98, 37353943169572144, 89358139, 89358146, 7, 640x360 
0x1382CA98, 37353943169885480, 89358170, 89358180, 10, 640x360 
0x1382CA98, 37353943170208528, 89358200, 89358202, 2, 640x360 
0x1382CA98, 37353943170524968, 89358232, 89358234, 2, 640x360 
0x1382CA98, 37353943170849560, 89358263, 89358267, 4, 640x360 
0x1382CA98, 37353943171329232, 89358309, 89358312, 3, 640x360 
0x1382CA98, 37353943171649856, 89358346, 89358348, 2, 640x360 
0x1382CA98, 37353943171968992, 89358377, 89358379, 2, 640x360 
0x1382CA98, 37353943172294040, 89358408, 89358412, 4, 640x360 
0x1382CA98, 37353943172605192, 89358441, 89358443, 2, 640x360 
0x1382CA98, 37353943172925632, 89358473, 89358478, 5, 640x360 
0x1382CA98, 37353943173245784, 89358502, 89358508, 6, 640x360 
0x1382CA98, 37353943173569208, 89358533, 89358536, 3, 640x360 
0x1382CA98, 37353943173893480, 89358569, 89358575, 6, 640x360 
0x1382CA98, 37353943174215304, 89358601, 89358604, 3, 640x360 
0x1382CA98, 37353943174529448, 89358629, 89358631, 2, 640x360 
0x1382CA98, 37353943174849712, 89358663, 89358668, 5, 640x360 
0x1382CA98, 37353943175329680, 89358710, 89358713, 3, 640x360 
0x1382CA98, 37353943175654056, 89358746, 89358751, 5, 640x360 
0x1382CA98, 37353943175964552, 89358777, 89358785, 8, 640x360 
0x1382CA98, 37353943176288256, 89358810, 89358815, 5, 640x360 
0x1382CA98, 37353943176608552, 89358837, 89358843, 6, 640x360 
0x1382CA98, 37353943176925840, 89358868, 89358871, 3, 640x360 
0x1382CA98, 37353943177249696, 89358899, 89358901, 2, 640x360 
0x1382CA98, 37353943177572056, 89358935, 89358938, 3, 640x360 
0x1382CA98, 37353943177885528, 89358969, 89358973, 4, 640x360 
0x1382CA98, 37353943178205240, 89359000, 89359002, 2, 640x360 
0x1382CA98, 37353943178525552, 89359032, 89359035, 3, 640x360 
0x1382CA98, 37353943178851160, 89359063, 89359065, 2, 640x360 
0x1382CA98, 37353943179325248, 89359109, 89359116, 7, 640x360 
0x1382CA98, 37353943179645456, 89359145, 89359147, 2, 640x360 
0x1382CA98, 37353943179969560, 89359177, 89359180, 3, 640x360 
0x1382CA98, 37353943180289232, 89359208, 89359212, 4, 640x360 
0x1382CA98, 37353943180605232, 89359235, 89359238, 3, 640x360 
0x1382CA98, 37353943180925048, 89359272, 89359277, 5, 640x360 
0x1382CA98, 37353943181246056, 89359304, 89359309, 5, 640x360 
0x1382CA98, 37353943181567136, 89359345, 89359347, 2, 640x360 
0x1382CA98, 37353943181890296, 89359366, 89359368, 2, 640x360 
0x1382CA98, 37353943182205280, 89359401, 89359403, 2, 640x360 
0x1382CA98, 37353943182524488, 89359428, 89359430, 2, 640x360 
0x1382CA98, 37353943182849400, 89359469, 89359474, 5, 640x360 
0x1382CA98, 37353943183325008, 89359510, 89359516, 6, 640x360 
0x1382CA98, 37353943183644624, 89359544, 89359546, 2, 640x360 
0x1382CA98, 37353943183969000, 89359577, 89359580, 3, 640x360 
0x1382CA98, 37353943184285024, 89359608, 89359611, 3, 640x360 
0x1382CA98, 37353943184604456, 89359641, 89359643, 2, 640x360 
0x1382CA98, 37353943184924600, 89359667, 89359669, 2, 640x360 
0x1382CA98, 37353943185244840, 89359705, 89359709, 4, 640x360 
0x1382CA98, 37353943185566680, 89359736, 89359744, 8, 640x360 
0x1382CA98, 37353943185884776, 89359768, 89359774, 6, 640x360 
0x1382CA98, 37353943186205144, 89359799, 89359802, 3, 640x360 
0x1382CA98, 37353943186525296, 89359832, 89359834, 2, 640x360 
0x1382CA98, 37353943186870664, 89359864, 89359867, 3, 640x360 
0x1382CA98, 37353943187324248, 89359915, 89359918, 3, 640x360 
0x1382CA98, 37353943187652736, 89359944, 89359953, 9, 640x360 
0x1382CA98, 37353943187969672, 89359979, 89359991, 12, 640x360 
0x1382CA98, 37353943188284888, 89360013, 89360023, 10, 640x360 
0x1382CA98, 37353943188604736, 89360039, 89360043, 4, 640x360 
0x1382CA98, 37353943188929248, 89360068, 89360071, 3, 640x360 
0x1382CA98, 37353943189274272, 89360103, 89360106, 3, 640x360 
0x1382CA98, 37353943189566048, 89360140, 89360147, 7, 640x360 
0x1382CA98, 37353943189887040, 89360166, 89360168, 2, 640x360 
0x1382CA98, 37353943190208440, 89360202, 89360206, 4, 640x360 
0x1382CA98, 37353943190528808, 89360239, 89360247, 8, 640x360 
0x1382CA98, 37353943190851624, 89360271, 89360275, 4, 640x360 
0x1382CA98, 37353943191324112, 89360315, 89360322, 7, 640x360 
0x1382CA98, 37353943191643824, 89360348, 89360351, 3, 640x360 
0x1382CA98, 37353943191974888, 89360385, 89360393, 8, 640x360 
0x1382CA98, 37353943192287352, 89360422, 89360428, 6, 640x360 
0x1382CA98, 37353943192613288, 89360448, 89360450, 2, 640x360 
0x1382CA98, 37353943192930784, 89360475, 89360486, 11, 640x360 
0x1382CA98, 37353943193273264, 89360507, 89360514, 7, 640x360 
0x1382CA98, 37353943193579808, 89360540, 89360549, 9, 640x360 
0x1382CA98, 37353943193884000, 89360567, 89360571, 4, 640x360 
0x1382CA98, 37353943194204856, 89360601, 89360604, 3, 640x360 
0x1382CA98, 37353943194524160, 89360628, 89360630, 2, 640x360 
0x1382CA98, 37353943194854000, 89360670, 89360675, 5, 640x360 
0x1382CA98, 37353943195165144, 89360698, 89360701, 3, 640x360 
0x1382CA98, 37353943195645992, 89360747, 89360752, 5, 640x360 
0x1382CA98, 37353943195968272, 89360778, 89360783, 5, 640x360 
0x1382CA98, 37353943196288568, 89360810, 89360816, 6, 640x360 
0x1382CA98, 37353943196614600, 89360847, 89360850, 3, 640x360 
0x1382CA98, 37353943196926448, 89360873, 89360876, 3, 640x360 
0x1382CA98, 37353943197250000, 89360906, 89360908, 2, 640x360 
0x1382CA98, 37353943197565352, 89360939, 89360942, 3, 640x360 
0x1382CA98, 37353943197889888, 89360967, 89360970, 3, 640x360 
0x1382CA98, 37353943198208912, 89361006, 89361017, 11, 640x360 
0x1382CA98, 37353943198536168, 89361034, 89361037, 3, 640x360 
0x1382CA98, 37353943198844096, 89361065, 89361069, 4, 640x360 
0x1382CA98, 37353943199164112, 89361098, 89361102, 4, 640x360 
0x1382CA98, 37353943199643936, 89361144, 89361150, 6, 640x360 
0x1382CA98, 37353943199964800, 89361171, 89361173, 2, 640x360 
0x1382CA98, 37353943200284168, 89361207, 89361210, 3, 640x360 
0x1382CA98, 37353943200604120, 89361239, 89361242, 3, 640x360 
0x1382CA98, 37353943200924272, 89361271, 89361281, 10, 640x360 
0x1382CA98, 37353943201260296, 89361301, 89361304, 3, 640x360 
0x1382CA98, 37353943201565496, 89361334, 89361338, 4, 640x360 
0x1382CA98, 37353943201887856, 89361367, 89361373, 6, 640x360 
0x1382CA98, 37353943202204608, 89361400, 89361402, 2, 640x360 
0x1382CA98, 37353943202527328, 89361431, 89361433, 2, 640x360 
0x1382CA98, 37353943202848776, 89361469, 89361475, 6, 640x360 
0x1382CA98, 37353943203167728, 89361496, 89361498, 2, 640x360 
0x1382CA98, 37353943203648192, 89361542, 89361549, 7, 640x360 
0x1382CA98, 37353943203963992, 89361573, 89361579, 6, 640x360 
0x1382CA98, 37353943204288208, 89361603, 89361610, 7, 640x360 
0x1382CA98, 37353943204604832, 89361635, 89361637, 2, 640x360 
0x1382CA98, 37353943204925832, 89361672, 89361680, 8, 640x360 
0x1382CA98, 37353943205259320, 89361706, 89361716, 10, 640x360 
0x1382CA98, 37353943205612704, 89361748, 89361758, 10, 640x360 
0x1382CA98, 37353943205892552, 89361766, 89361769, 3, 640x360 
0x1382CA98, 37353943206204160, 89361800, 89361803, 3, 640x360 
0x1382CA98, 37353943206523880, 89361831, 89361833, 2, 640x360 
0x1382CA98, 37353943206843872, 89361865, 89361868, 3, 640x360 
0x1382CA98, 37353943207171800, 89361904, 89361913, 9, 640x360 
0x1382CA98, 37353943207645144, 89361952, 89361955, 3, 640x360 
0x1382CA98, 37353943207969144, 89361980, 89361982, 2, 640x360 
0x1382CA98, 37353943208287200, 89362011, 89362015, 4, 640x360 
0x1382CA98, 37353943208628704, 89362040, 89362048, 8, 640x360 
0x1382CA98, 37353943208931864, 89362074, 89362083, 9, 640x360 
0x1382CA98, 37353943209252800, 89362106, 89362117, 11, 640x360 
0x1382CA98, 37353943209564624, 89362140, 89362143, 3, 640x360 
0x1382CA98, 37353943209895248, 89362168, 89362170, 2, 640x360 
0x1382CA98, 37353943210205568, 89362210, 89362218, 8, 640x360 
0x1382CA98, 37353943210527568, 89362240, 89362243, 3, 640x360 
0x1382CA98, 37353943210844208, 89362266, 89362269, 3, 640x360 
0x1382CA98, 37353943211163824, 89362296, 89362299, 3, 640x360 
0x1382CA98, 37353943211644864, 89362350, 89362352, 2, 640x360 
0x1382CA98, 37353943211965272, 89362380, 89362387, 7, 640x360 
0x1382CA98, 37353943212283304, 89362413, 89362421, 8, 640x360 
0x1382CA98, 37353943212621968, 89362445, 89362447, 2, 640x360 
0x1382CA98, 37353943212924352, 89362470, 89362476, 6, 640x360 
0x1382CA98, 37353943213256776, 89362499, 89362501, 2, 640x360 
0x1382CA98, 37353943213573128, 89362540, 89362542, 2, 640x360 
0x1382CA98, 37353943213887688, 89362571, 89362577, 6, 640x360 
0x1382CA98, 37353943214206736, 89362602, 89362606, 4, 640x360 
0x1382CA98, 37353943214525272, 89362639, 89362650, 11, 640x360 
0x1382CA98, 37353943214863112, 89362672, 89362676, 4, 640x360 
0x1382CA98, 37353943215164600, 89362700, 89362702, 2, 640x360 
0x1382CA98, 37353943215647608, 89362744, 89362752, 8, 640x360 
0x1382CA98, 37353943215963736, 89362774, 89362777, 3, 640x360 
0x1382CA98, 37353943216283016, 89362806, 89362817, 11, 640x360 
0x1382CA98, 37353943216605280, 89362839, 89362846, 7, 640x360 
0x1382CA98, 37353943216926968, 89362872, 89362880, 8, 640x360 
0x1382CA98, 37353943217252704, 89362904, 89362914, 10, 640x360 
0x1382CA98, 37353943217564632, 89362934, 89362936, 2, 640x360 
0x1382CA98, 37353943217888264, 89362972, 89362980, 8, 640x360 
0x1382CA98, 37353943218208648, 89363002, 89363004, 2, 640x360 
0x1382CA98, 37353943218523640, 89363029, 89363031, 2, 640x360 
0x1382CA98, 37353943218845528, 89363068, 89363071, 3, 640x360 
0x1382CA98, 37353943219172464, 89363105, 89363108, 3, 640x360 
0x1382CA98, 37353943219643320, 89363151, 89363154, 3, 640x360 
0x1382CA98, 37353943219972856, 89363188, 89363201, 13, 640x360 
0x1382CA98, 37353943220303544, 89363223, 89363228, 5, 640x360 
0x1382CA98, 37353943220608384, 89363249, 89363256, 7, 640x360 
0x1382CA98, 37353943220923800, 89363279, 89363284, 5, 640x360 
0x1382CA98, 37353943221273608, 89363313, 89363317, 4, 640x360 
0x1382CA98, 37353943221588176, 89363348, 89363359, 11, 640x360 
0x1382CA98, 37353943221928520, 89363382, 89363385, 3, 640x360 
0x1382CA98, 37353943222211248, 89363413, 89363423, 10, 640x360 
0x1382CA98, 37353943222543008, 89363445, 89363458, 13, 640x360 
0x1382CA98, 37353943222847048, 89363477, 89363481, 4, 640x360 
0x1382CA98, 37353943223173912, 89363501, 89363504, 3, 640x360 
0x1382CA98, 37353943223493856, 89363535, 89363539, 4, 640x360 
0x1382CA98, 37353943223964816, 89363584, 89363587, 3, 640x360 
0x1382CA98, 37353943224283504, 89363615, 89363617, 2, 640x360 
0x1382CA98, 37353943224604368, 89363641, 89363649, 8, 640x360 
0x1382CA98, 37353943224944312, 89363681, 89363688, 7, 640x360 
0x1382CA98, 37353943225245448, 89363708, 89363716, 8, 640x360 
0x1382CA98, 37353943225565600, 89363741, 89363750, 9, 640x360 
0x1382CA98, 37353943225884704, 89363778, 89363783, 5, 640x360 
0x1382CA98, 37353943226206072, 89363811, 89363816, 5, 640x360 
0x1382CA98, 37353943226526944, 89363835, 89363838, 3, 640x360 
0x1382CA98, 37353943226845408, 89363867, 89363872, 5, 640x360 
0x1382CA98, 37353943227164048, 89363907, 89363911, 4, 640x360 
0x1382CA98, 37353943227484264, 89363940, 89363944, 4, 640x360 
0x1382CA98, 37353943227963312, 89363985, 89363987, 2, 640x360 
0x1382CA98, 37353943228283080, 89364018, 89364023, 5, 640x360 
0x1382CA98, 37353943228621336, 89364051, 89364058, 7, 640x360 
0x1382CA98, 37353943228931832, 89364078, 89364087, 9, 640x360 
0x1382CA98, 37353943229271240, 89364113, 89364115, 2, 640x360 
0x1382CA98, 37353943229564448, 89364157, 89364173, 16, 640x360 
0x1382CA98, 37353943229885424, 89364181, 89364183, 2, 640x360 
0x1382CA98, 37353943230203840, 89364208, 89364213, 5, 640x360 
0x1382CA98, 37353943230523832, 89364243, 89364258, 15, 640x360 
0x1382CA98, 37353943230861840, 89364277, 89364281, 4, 640x360 
0x1382CA98, 37353943231174352, 89364308, 89364324, 16, 640x360 
0x1382CA98, 37353943231496352, 89364345, 89364348, 3, 640x360 
0x1382CA98, 37353943231978376, 89364384, 89364390, 6, 640x360 
0x1382CA98, 37353943232283848, 89364421, 89364433, 12, 640x360 
0x1382CA98, 37353943232617728, 89364453, 89364459, 6, 640x360 
0x1382CA98, 37353943232938112, 89364482, 89364492, 10, 640x360 
0x1382CA98, 37353943233263608, 89364512, 89364527, 15, 640x360 
0x1382CA98, 37353943233574864, 89364544, 89364551, 7, 640x360 
0x1382CA98, 37353943233890344, 89364578, 89364582, 4, 640x360 
0x1382CA98, 37353943234204904, 89364609, 89364618, 9, 640x360 
0x1382CA98, 37353943234536624, 89364645, 89364648, 3, 640x360 
0x1382CA98, 37353943234846112, 89364666, 89364669, 3, 640x360 
0x1382CA98, 37353943235178352, 89364707, 89364710, 3, 640x360 
0x1382CA98, 37353943235483568, 89364737, 89364749, 12, 640x360 
0x1382CA98, 37353943235967704, 89364795, 89364797, 2, 640x360 
0x1382CA98, 37353943236283048, 89364809, 89364812, 3, 640x360 
0x1382CA98, 37353943236623688, 89364850, 89364852, 2, 640x360 
0x1382CA98, 37353943236959016, 89364880, 89364884, 4, 640x360 
0x1382CA98, 37353943237265520, 89364913, 89364915, 2, 640x360 
0x1382CA98, 37353943237568488, 89364944, 89364960, 16, 640x360 
0x1382CA98, 37353943237883704, 89364969, 89364975, 6, 640x360 
0x1382CA98, 37353943238202720, 89365009, 89365015, 6, 640x360 
0x1382CA98, 37353943238526984, 89365036, 89365039, 3, 640x360 
0x1382CA98, 37353943238843712, 89365068, 89365073, 5, 640x360 
0x1382CA98, 37353943239173152, 89365108, 89365118, 10, 640x360 
0x1382CA98, 37353943239501728, 89365144, 89365147, 3, 640x360 
0x1382CA98, 37353943239975680, 89365190, 89365198, 8, 640x360 
0x1382CA98, 37353943240283168, 89365212, 89365217, 5, 640x360 
0x1382CA98, 37353943240604848, 89365241, 89365251, 10, 640x360 
0x1382CA98, 37353943240933048, 89365273, 89365281, 8, 640x360 
0x1382CA98, 37353943241247208, 89365310, 89365318, 8, 640x360 
0x1382CA98, 37353943241564208, 89365340, 89365349, 9, 640x360 
0x1382CA98, 37353943241882712, 89365368, 89365372, 4, 640x360 
0x1382CA98, 37353943242206840, 89365406, 89365416, 10, 640x360 
0x1382CA98, 37353943242522904, 89365440, 89365447, 7, 640x360 
0x1382CA98, 37353943242844880, 89365466, 89365468, 2, 640x360 
0x1382CA98, 37353943243170920, 89365494, 89365496, 2, 640x360 
0x1382CA98, 37353943243486840, 89365528, 89365533, 5, 640x360 
0x1382CA98, 37353943243966272, 89365579, 89365581, 2, 640x360 
0x1382CA98, 37353943244286880, 89365613, 89365615, 2, 640x360 
0x1382CA98, 37353943244603064, 89365643, 89365646, 3, 640x360 
0x1382CA98, 37353943244924248, 89365674, 89365676, 2, 640x360 
0x1382CA98, 37353943245247888, 89365700, 89365702, 2, 640x360 
0x1382CA98, 37353943245564048, 89365739, 89365746, 7, 640x360 
0x1382CA98, 37353943245883360, 89365772, 89365775, 3, 640x360 
0x1382CA98, 37353943246204248, 89365802, 89365805, 3, 640x360 
0x1382CA98, 37353943246527632, 89365835, 89365842, 7, 640x360 
0x1382CA98, 37353943246843232, 89365861, 89365869, 8, 640x360 
0x1382CA98, 37353943247166504, 89365895, 89365898, 3, 640x360 
0x1382CA98, 37353943247487080, 89365928, 89365938, 10, 640x360 
0x1382CA98, 37353943247809112, 89365963, 89365966, 3, 640x360 
0x1382CA98, 37353943248282664, 89366013, 89366017, 4, 640x360 
0x1382CA98, 37353943248638480, 89366054, 89366064, 10, 640x360 
0x1382CA98, 37353943248924080, 89366102, 89366113, 11, 640x360 
0x1382CA98, 37353943249258912, 89366124, 89366129, 5, 640x360 
0x1382CA98, 37353943249595648, 89366165, 89366169, 4, 640x360 
0x1382CA98, 37353943249968488, 89366191, 89366206, 15, 640x360 
0x1382CA98, 37353943250208016, 89366216, 89366230, 14, 640x360 
0x1382CA98, 37353943250530480, 89366249, 89366257, 8, 640x360 
0x1382CA98, 37353943250853656, 89366271, 89366283, 12, 640x360 
0x1382CA98, 37353943251179816, 89366302, 89366305, 3, 640x360 
0x1382CA98, 37353943251487792, 89366333, 89366335, 2, 640x360 
0x1382CA98, 37353943251810880, 89366369, 89366383, 14, 640x360 
0x1382CA98, 37353943252378096, 89366445, 89366462, 17, 640x360 
0x1382CA98, 37353943252627816, 89366462, 89366474, 12, 640x360 
0x1382CA98, 37353943252982120, 89366494, 89366498, 4, 640x360 
0x1382CA98, 37353943253278088, 89366520, 89366526, 6, 640x360 
0x1382CA98, 37353943253579880, 89366551, 89366559, 8, 640x360 
0x1382CA98, 37353943253916408, 89366580, 89366582, 2, 640x360 
0x1382CA98, 37353943254209168, 89366608, 89366622, 14, 640x360 
0x1382CA98, 37353943254577208, 89366645, 89366652, 7, 640x360 
0x1382CA98, 37353943254856592, 89366672, 89366685, 13, 640x360 
0x1382CA98, 37353943255178112, 89366723, 89366726, 3, 640x360 
0x1382CA98, 37353943255532360, 89366745, 89366749, 4, 640x360 
0x1382CA98, 37353943255804072, 89366767, 89366769, 2, 640x360 
0x1382CA98, 37353943256343064, 89366827, 89366834, 7, 640x360 
0x1382CA98, 37353943256608728, 89366847, 89366851, 4, 640x360 
0x1382CA98, 37353943256972168, 89366879, 89366882, 3, 640x360 
0x1382CA98, 37353943257258680, 89366909, 89366911, 2, 640x360 
0x1382CA98, 37353943257574480, 89366940, 89366950, 10, 640x360 
0x1382CA98, 37353943257885368, 89366974, 89366979, 5, 640x360 
0x1382CA98, 37353943258207792, 89367010, 89367016, 6, 640x360 
0x1382CA98, 37353943258524608, 89367036, 89367054, 18, 640x360 
0x1382CA98, 37353943258872216, 89367073, 89367077, 4, 640x360 
0x1382CA98, 37353943259164240, 89367102, 89367108, 6, 640x360 
0x1382CA98, 37353943259495696, 89367134, 89367136, 2, 640x360 
0x1382CA98, 37353943259814744, 89367169, 89367175, 6, 640x360 
0x1382CA98, 37353943260282208, 89367217, 89367224, 7, 640x360 
0x1382CA98, 37353943260612392, 89367251, 89367274, 23, 640x360 
0x1382CA98, 37353943260951552, 89367284, 89367291, 7, 640x360 
0x1382CA98, 37353943261249616, 89367306, 89367317, 11, 640x360 
0x1382CA98, 37353943261568136, 89367341, 89367344, 3, 640x360 
0x1382CA98, 37353943261889488, 89367369, 89367372, 3, 640x360 
0x1382CA98, 37353943262246600, 89367401, 89367403, 2, 640x360 
0x1382CA98, 37353943262525240, 89367441, 89367443, 2, 640x360 
0x1382CA98, 37353943262848528, 89367468, 89367472, 4, 640x360 
0x1382CA98, 37353943263175032, 89367500, 89367502, 2, 640x360 
0x1382CA98, 37353943263505248, 89367535, 89367541, 6, 640x360 
0x1382CA98, 37353943263846104, 89367568, 89367580, 12, 640x360 
0x1382CA98, 37353943264281904, 89367614, 89367616, 2, 640x360 
0x1382CA98, 37353943264603024, 89367646, 89367648, 2, 640x360 
0x1382CA98, 37353943264938376, 89367681, 89367683, 2, 640x360 
0x1382CA98, 37353943265242088, 89367707, 89367712, 5, 640x360 
0x1382CA98, 37353943265568224, 89367740, 89367751, 11, 640x360 
0x1382CA98, 37353943265891640, 89367778, 89367785, 7, 640x360 
0x1382CA98, 37353943266204488, 89367809, 89367811, 2, 640x360 
0x1382CA98, 37353943266522184, 89367836, 89367850, 14, 640x360 
0x1382CA98, 37353943266843856, 89367864, 89367866, 2, 640x360 
0x1382CA98, 37353943267194528, 89367910, 89367915, 5, 640x360 
0x1382CA98, 37353943267514336, 89367945, 89367949, 4, 640x360 
0x1382CA98, 37353943267803704, 89367966, 89367968, 2, 640x360 
0x1382CA98, 37353943268281616, 89368004, 89368014, 10, 640x360 
0x1382CA98, 37353943268603080, 89368041, 89368044, 3, 640x360 
0x1382CA98, 37353943268933176, 89368079, 89368087, 8, 640x360 
0x1382CA98, 37353943269248936, 89368110, 89368113, 3, 640x360 
0x1382CA98, 37353943269563016, 89368146, 89368151, 5, 640x360 
0x1382CA98, 37353943269884992, 89368173, 89368181, 8, 640x360 
0x1382CA98, 37353943270202664, 89368201, 89368204, 3, 640x360 
0x1382CA98, 37353943270522176, 89368228, 89368231, 3, 640x360 
0x1382CA98, 37353943270846696, 89368266, 89368269, 3, 640x360 
0x1382CA98, 37353943271162360, 89368292, 89368295, 3, 640x360 
0x1382CA98, 37353943271485104, 89368328, 89368331, 3, 640x360 
0x1382CA98, 37353943271802896, 89368360, 89368363, 3, 640x360 
0x1382CA98, 37353943272283712, 89368407, 89368410, 3, 640x360 
0x1382CA98, 37353943272602192, 89368441, 89368443, 2, 640x360 
0x1382CA98, 37353943272924320, 89368481, 89368483, 2, 640x360 
0x1382CA98, 37353943273243800, 89368512, 89368515, 3, 640x360 
0x1382CA98, 37353943273563048, 89368545, 89368547, 2, 640x360 
0x1382CA98, 37353943273881784, 89368572, 89368576, 4, 640x360 
0x1382CA98, 37353943274202056, 89368609, 89368616, 7, 640x360 
0x1382CA98, 37353943274522656, 89368642, 89368644, 2, 640x360 
0x1382CA98, 37353943274851184, 89368661, 89368666, 5, 640x360 
0x1382CA98, 37353943275162024, 89368693, 89368696, 3, 640x360 
0x1382CA98, 37353943275487200, 89368729, 89368731, 2, 640x360 
0x1382CA98, 37353943275802128, 89368761, 89368763, 2, 640x360 
0x1382CA98, 37353943276606792, 89368838, 89368842, 4, 640x360 
0x1382CA98, 37353943276922600, 89368870, 89368874, 4, 640x360 
0x1382CA98, 37353943277242160, 89368907, 89368911, 4, 640x360 
0x1382CA98, 37353943277574712, 89368939, 89368943, 4, 640x360 
0x1382CA98, 37353943277893984, 89368970, 89368976, 6, 640x360 
0x1382CA98, 37353943278205224, 89369005, 89369017, 12, 640x360 
0x1382CA98, 37353943278524240, 89369034, 89369037, 3, 640x360 
0x1382CA98, 37353943278846136, 89369061, 89369063, 2, 640x360 
0x1382CA98, 37353943279175176, 89369099, 89369103, 4, 640x360 
0x1382CA98, 37353943279482504, 89369131, 89369134, 3, 640x360 
0x1382CA98, 37353943279802256, 89369157, 89369165, 8, 640x360 
0x1382CA98, 37353943280127152, 89369195, 89369197, 2, 640x360 
0x1382CA98, 37353943280602960, 89369236, 89369246, 10, 640x360 
0x1382CA98, 37353943280929120, 89369272, 89369278, 6, 640x360 
0x1382CA98, 37353943281268864, 89369305, 89369311, 6, 640x360 
0x1382CA98, 37353943281573216, 89369338, 89369342, 4, 640x360 
0x1382CA98, 37353943281904872, 89369374, 89369410, 36, 640x360 
0x1382CA98, 37353943282228472, 89369432, 89369437, 5, 640x360 
0x1382CA98, 37353943282609064, 89369460, 89369465, 5, 640x360 
0x1382CA98, 37353943282863768, 89369481, 89369484, 3, 640x360 
0x1382CA98, 37353943283168032, 89369509, 89369511, 2, 640x360 
0x1382CA98, 37353943283494368, 89369534, 89369537, 3, 640x360 
0x1382CA98, 37353943283803944, 89369562, 89369564, 2, 640x360 
0x1382CA98, 37353943284126704, 89369595, 89369604, 9, 640x360 
0x1382CA98, 37353943284601872, 89369640, 89369650, 10, 640x360 
0x1382CA98, 37353943284926632, 89369679, 89369683, 4, 640x360 
0x1382CA98, 37353943285248272, 89369710, 89369717, 7, 640x360 
0x1382CA98, 37353943285579616, 89369738, 89369743, 5, 640x360 
0x1382CA98, 37353943285887360, 89369769, 89369771, 2, 640x360 
0x1382CA98, 37353943286202360, 89369801, 89369803, 2, 640x360 
0x1382CA98, 37353943286533392, 89369834, 89369837, 3, 640x360 
0x1382CA98, 37353943286846048, 89369865, 89369867, 2, 640x360 
0x1382CA98, 37353943287174976, 89369901, 89369903, 2, 640x360 
0x1382CA98, 37353943287485552, 89369931, 89369934, 3, 640x360 
0x1382CA98, 37353943287802600, 89369963, 89369969, 6, 640x360 
0x1382CA98, 37353943288122632, 89369995, 89369997, 2, 640x360 
0x1382CA98, 37353943288603424, 89370040, 89370043, 3, 640x360 
0x1382CA98, 37353943288935840, 89370075, 89370078, 3, 640x360 
0x1382CA98, 37353943289278696, 89370107, 89370116, 9, 640x360 
0x1382CA98, 37353943289586368, 89370138, 89370142, 4, 640x360 
0x1382CA98, 37353943289883128, 89370170, 89370180, 10, 640x360 
0x1382CA98, 37353943290201752, 89370200, 89370203, 3, 640x360 
0x1382CA98, 37353943290521408, 89370234, 89370237, 3, 640x360 
0x1382CA98, 37353943290845472, 89370267, 89370276, 9, 640x360 
0x1382CA98, 37353943291165696, 89370299, 89370303, 4, 640x360 
0x1382CA98, 37353943291482048, 89370327, 89370338, 11, 640x360 
0x1382CA98, 37353943291804856, 89370360, 89370366, 6, 640x360 
0x1382CA98, 37353943292123336, 89370402, 89370404, 2, 640x360 
0x1382CA98, 37353943292601032, 89370438, 89370449, 11, 640x360 
0x1382CA98, 37353943292927000, 89370475, 89370483, 8, 640x360 
0x1382CA98, 37353943293250400, 89370508, 89370517, 9, 640x360 
0x1382CA98, 37353943293562976, 89370548, 89370560, 12, 640x360 
0x1382CA98, 37353943293885288, 89370581, 89370583, 2, 640x360 
0x1382CA98, 37353943294201904, 89370602, 89370618, 16, 640x360 
0x1382CA98, 37353943294527384, 89370639, 89370643, 4, 640x360 
0x1382CA98, 37353943294841240, 89370666, 89370668, 2, 640x360 
0x1382CA98, 37353943295161336, 89370695, 89370697, 2, 640x360 
0x1382CA98, 37353943295485096, 89370726, 89370731, 5, 640x360 
0x1382CA98, 37353943295805920, 89370768, 89370771, 3, 640x360 
0x1382CA98, 37353943296124192, 89370795, 89370797, 2, 640x360 
0x1382CA98, 37353943296601912, 89370837, 89370843, 6, 640x360 
0x1382CA98, 37353943296922504, 89370884, 89370892, 8, 640x360 
0x1382CA98, 37353943297243752, 89370901, 89370903, 2, 640x360 
0x1382CA98, 37353943297568512, 89370934, 89370938, 4, 640x360 
0x1382CA98, 37353943297881240, 89370969, 89370981, 12, 640x360 
0x1382CA98, 37353943298206224, 89371006, 89371013, 7, 640x360 
0x1382CA98, 37353943298527320, 89371035, 89371040, 5, 640x360 
0x1382CA98, 37353943298866088, 89371067, 89371072, 5, 640x360 
0x1382CA98, 37353943299175016, 89371095, 89371097, 2, 640x360 
0x1382CA98, 37353943299493512, 89371128, 89371131, 3, 640x360 
0x1382CA98, 37353943299820832, 89371168, 89371182, 14, 640x360 
0x1382CA98, 37353943300125272, 89371196, 89371198, 2, 640x360 
0x1382CA98, 37353943300605096, 89371244, 89371250, 6, 640x360 
0x1382CA98, 37353943300948624, 89371280, 89371282, 2, 640x360 
0x1382CA98, 37353943301259608, 89371311, 89371313, 2, 640x360 
0x1382CA98, 37353943301567480, 89371340, 89371344, 4, 640x360 
0x1382CA98, 37353943301886864, 89371372, 89371376, 4, 640x360 
0x1382CA98, 37353943302207848, 89371402, 89371405, 3, 640x360 
0x1382CA98, 37353943302524464, 89371432, 89371434, 2, 640x360 
0x1382CA98, 37353943302844944, 89371470, 89371476, 6, 640x360 
0x1382CA98, 37353943303162088, 89371498, 89371501, 3, 640x360 
0x1382CA98, 37353943303486696, 89371534, 89371536, 2, 640x360 
0x1382CA98, 37353943303804312, 89371560, 89371562, 2, 640x360 
0x1382CA98, 37353943304125224, 89371592, 89371594, 2, 640x360 
0x1382CA98, 37353943304441960, 89371619, 89371626, 7, 640x360 
0x1382CA98, 37353943304925824, 89371671, 89371678, 7, 640x360 
0x1382CA98, 37353943305241280, 89371702, 89371705, 3, 640x360 
0x1382CA98, 37353943305574528, 89371734, 89371737, 3, 640x360 
0x1382CA98, 37353943305881848, 89371766, 89371768, 2, 640x360 
0x1382CA98, 37353943306207056, 89371799, 89371801, 2, 640x360 
0x1382CA98, 37353943306521744, 89371831, 89371833, 2, 640x360 
0x1382CA98, 37353943306845736, 89371862, 89371864, 2, 640x360 
0x1382CA98, 37353943307163760, 89371899, 89371902, 3, 640x360 
0x1382CA98, 37353943307481936, 89371925, 89371927, 2, 640x360 
0x1382CA98, 37353943307805536, 89371964, 89371967, 3, 640x360 
0x1382CA98, 37353943308122712, 89371992, 89372004, 12, 640x360 
0x1382CA98, 37353943308444528, 89372022, 89372025, 3, 640x360 
0x1382CA98, 37353943308923672, 89372073, 89372076, 3, 640x360 
0x1382CA98, 37353943309243000, 89372105, 89372111, 6, 640x360 
0x1382CA98, 37353943309573872, 89372145, 89372147, 2, 640x360 
0x1382CA98, 37353943309881720, 89372169, 89372179, 10, 640x360 
0x1382CA98, 37353943310205048, 89372206, 89372209, 3, 640x360 
0x1382CA98, 37353943310525168, 89372231, 89372234, 3, 640x360 
0x1382CA98, 37353943310844912, 89372264, 89372267, 3, 640x360 
0x1382CA98, 37353943311165296, 89372291, 89372294, 3, 640x360 
0x1382CA98, 37353943311481424, 89372327, 89372329, 2, 640x360 
0x1382CA98, 37353943311801664, 89372359, 89372362, 3, 640x360 
0x1382CA98, 37353943312129336, 89372400, 89372407, 7, 640x360 
0x1382CA98, 37353943312442160, 89372421, 89372429, 8, 640x360 
0x1382CA98, 37353943312924872, 89372479, 89372483, 4, 640x360 
0x1382CA98, 37353943313247264, 89372512, 89372514, 2, 640x360 
0x1382CA98, 37353943313565104, 89372545, 89372549, 4, 640x360 
0x1382CA98, 37353943313882808, 89372578, 89372581, 3, 640x360 
0x1382CA98, 37353943314200616, 89372605, 89372614, 9, 640x360 
0x1382CA98, 37353943314521384, 89372640, 89372643, 3, 640x360 
0x1382CA98, 37353943314844200, 89372667, 89372670, 3, 640x360 
0x1382CA98, 37353943315163144, 89372694, 89372696, 2, 640x360 
0x1382CA98, 37353943315488480, 89372731, 89372733, 2, 640x360 
0x1382CA98, 37353943315809744, 89372761, 89372763, 2, 640x360 
0x1382CA98, 37353943316127216, 89372796, 89372798, 2, 640x360 
0x1382CA98, 37353943316446000, 89372826, 89372834, 8, 640x360 
0x1382CA98, 37353943316921376, 89372867, 89372869, 2, 640x360 
0x1382CA98, 37353943317242416, 89372901, 89372903, 2, 640x360 
0x1382CA98, 37353943317561640, 89372934, 89372937, 3, 640x360 
0x1382CA98, 37353943317888416, 89372964, 89372966, 2, 640x360 
0x1382CA98, 37353943318213944, 89373000, 89373002, 2, 640x360 
0x1382CA98, 37353943318525600, 89373026, 89373028, 2, 640x360 
0x1382CA98, 37353943318844624, 89373062, 89373064, 2, 640x360 
0x1382CA98, 37353943319165456, 89373093, 89373095, 2, 640x360 
0x1382CA98, 37353943319481160, 89373125, 89373128, 3, 640x360 
0x1382CA98, 37353943319801608, 89373162, 89373164, 2, 640x360 
0x1382CA98, 37353943320121928, 89373195, 89373198, 3, 640x360 
0x1382CA98, 37353943320441368, 89373228, 89373230, 2, 640x360 
0x1382CA98, 37353943320920928, 89373269, 89373273, 4, 640x360 
0x1382CA98, 37353943321243088, 89373301, 89373305, 4, 640x360 
0x1382CA98, 37353943321593144, 89373339, 89373347, 8, 640x360 
0x1382CA98, 37353943321881624, 89373364, 89373366, 2, 640x360 
0x1382CA98, 37353943322201384, 89373405, 89373414, 9, 640x360 
0x1382CA98, 37353943322523760, 89373428, 89373430, 2, 640x360 
0x1382CA98, 37353943322840720, 89373466, 89373467, 1, 640x360 
0x1382CA98, 37353943323162576, 89373495, 89373497, 2, 640x360 
0x1382CA98, 37353943323484728, 89373527, 89373529, 2, 640x360 
0x1382CA98, 37353943323803712, 89373562, 89373568, 6, 640x360 
0x1382CA98, 37353943324147712, 89373599, 89373603, 4, 640x360 
0x1382CA98, 37353943324446128, 89373622, 89373626, 4, 640x360 
0x1382CA98, 37353943324924104, 89373672, 89373678, 6, 640x360 
0x1382CA98, 37353943325240800, 89373704, 89373709, 5, 640x360 
0x1382CA98, 37353943325566760, 89373736, 89373743, 7, 640x360 
0x1382CA98, 37353943325880608, 89373767, 89373769, 2, 640x360 
0x1382CA98, 37353943326200672, 89373804, 89373809, 5, 640x360 
0x1382CA98, 37353943326524280, 89373837, 89373841, 4, 640x360 
0x1382CA98, 37353943326840536, 89373861, 89373868, 7, 640x360 
0x1382CA98, 37353943327160512, 89373894, 89373901, 7, 640x360 
0x1382CA98, 37353943327480768, 89373927, 89373936, 9, 640x360 
0x1382CA98, 37353943327800904, 89373961, 89373963, 2, 640x360 
0x1382CA98, 37353943328126896, 89373989, 89374000, 11, 640x360 
0x1382CA98, 37353943328441472, 89374027, 89374032, 5, 640x360 
0x1382CA98, 37353943328761928, 89374055, 89374063, 8, 640x360 
0x1382CA98, 37353943329248048, 89374103, 89374108, 5, 640x360 
0x1382CA98, 37353943329564224, 89374136, 89374141, 5, 640x360 
0x1382CA98, 37353943329880656, 89374184, 89374192, 8, 640x360 
0x1382CA98, 37353943330204640, 89374214, 89374217, 3, 640x360 
0x1382CA98, 37353943330532016, 89374250, 89374258, 8, 640x360 
0x1382CA98, 37353943330846384, 89374298, 89374306, 8, 640x360 
0x1382CA98, 37353943331455336, 89374344, 89374363, 19, 640x360 
0x1382CA98, 37353943331902248, 89374423, 89374430, 7, 640x360 
0x1382CA98, 37353943332774568, 89374468, 89374474, 6, 640x360 
0x1382CA98, 37353943333269312, 89374520, 89374535, 15, 640x360 
0x1382CA98, 37353943333615296, 89374560, 89374577, 17, 640x360 
0x1382CA98, 37353943333939696, 89374596, 89374606, 10, 640x360 
0x1382CA98, 37353943334528296, 89374646, 89374651, 5, 640x360 
0x1382CA98, 37353943334850496, 89374676, 89374686, 10, 640x360 
0x1382CA98, 37353943335163360, 89374709, 89374719, 10, 640x360 
0x1382CA98, 37353943335526024, 89374750, 89374755, 5, 640x360 
0x1382CA98, 37353943335870488, 89374798, 89374801, 3, 640x360 
0x1382CA98, 37353943336135904, 89374840, 89374851, 11, 640x360 
0x1382CA98, 37353943336850696, 89374884, 89374903, 19, 640x360 
0x1382CA98, 37353943337280984, 89374928, 89374937, 9, 640x360 
0x1382CA98, 37353943337581744, 89374969, 89374976, 7, 640x360 
0x1382CA98, 37353943338273200, 89375023, 89375050, 27, 640x360 
0x1382CA98, 37353943338525784, 89375073, 89375084, 11, 640x360 
0x1382CA98, 37353943339180000, 89375102, 89375109, 7, 640x360 
0x1382CA98, 37353943339490840, 89375137, 89375143, 6, 640x360 
0x1382CA98, 37353943339818248, 89375167, 89375169, 2, 640x360 
0x1382CA98, 37353943340125592, 89375196, 89375200, 4, 640x360 
0x1382CA98, 37353943340445816, 89375224, 89375228, 4, 640x360 
0x1382CA98, 37353943340766664, 89375255, 89375267, 12, 640x360 
0x1382CA98, 37353943341244656, 89375303, 89375308, 5, 640x360 
0x1382CA98, 37353943341560696, 89375338, 89375344, 6, 640x360 
0x1382CA98, 37353943341879856, 89375376, 89375378, 2, 640x360 
0x1382CA98, 37353943342199976, 89375401, 89375407, 6, 640x360 
0x1382CA98, 37353943342525064, 89375433, 89375435, 2, 640x360 
0x1382CA98, 37353943342855808, 89375468, 89375472, 4, 640x360 
0x1382CA98, 37353943343184440, 89375497, 89375499, 2, 640x360 
0x1382CA98, 37353943343480432, 89375530, 89375533, 3, 640x360 
0x1382CA98, 37353943343803264, 89375563, 89375568, 5, 640x360 
0x1382CA98, 37353943344121472, 89375594, 89375596, 2, 640x360 
0x1382CA98, 37353943344441040, 89375624, 89375633, 9, 640x360 
0x1382CA98, 37353943344767608, 89375656, 89375665, 9, 640x360 
0x1382CA98, 37353943345244048, 89375701, 89375703, 2, 640x360 
0x1382CA98, 37353943345560784, 89375735, 89375739, 4, 640x360 
0x1382CA98, 37353943345880568, 89375783, 89375785, 2, 640x360 
0x1382CA98, 37353943346204096, 89375803, 89375807, 4, 640x360 
0x1382CA98, 37353943346523712, 89375832, 89375834, 2, 640x360 
0x1382CA98, 37353943346846816, 89375865, 89375870, 5, 640x360 
0x1382CA98, 37353943347171000, 89375902, 89375903, 1, 640x360 
0x1382CA98, 37353943347496448, 89375932, 89375936, 4, 640x360 
0x1382CA98, 37353943347814160, 89375965, 89375967, 2, 640x360 
0x1382CA98, 37353943348125800, 89375997, 89376006, 9, 640x360 
0x1382CA98, 37353943348452312, 89376025, 89376028, 3, 640x360 
0x1382CA98, 37353943348764112, 89376053, 89376055, 2, 640x360 
0x1382CA98, 37353943349245200, 89376104, 89376110, 6, 640x360 
0x1382CA98, 37353943349562808, 89376135, 89376138, 3, 640x360 
0x1382CA98, 37353943349880584, 89376167, 89376171, 4, 640x360 
0x1382CA98, 37353943350200584, 89376200, 89376203, 3, 640x360 
0x1382CA98, 37353943350520056, 89376230, 89376238, 8, 640x360 
0x1382CA98, 37353943350851008, 89376273, 89376277, 4, 640x360 
0x1382CA98, 37353943351207272, 89376308, 89376312, 4, 640x360 
0x1382CA98, 37353943351479872, 89376329, 89376332, 3, 640x360 
0x1382CA98, 37353943351800840, 89376362, 89376367, 5, 640x360 
0x1382CA98, 37353943352119928, 89376388, 89376398, 10, 640x360 
0x1382CA98, 37353943352440320, 89376423, 89376432, 9, 640x360 
0x1382CA98, 37353943352767176, 89376455, 89376465, 10, 640x360 
0x1382CA98, 37353943353241856, 89376507, 89376510, 3, 640x360 
0x1382CA98, 37353943353571352, 89376533, 89376535, 2, 640x360 
0x1382CA98, 37353943353887280, 89376580, 89376589, 9, 640x360 
0x1382CA98, 37353943354205304, 89376601, 89376603, 2, 640x360 
0x1382CA98, 37353943354520720, 89376641, 89376646, 5, 640x360 
0x1382CA98, 37353943354858808, 89376678, 89376685, 7, 640x360 
0x1382CA98, 37353943355167208, 89376707, 89376716, 9, 640x360 
0x1382CA98, 37353943355497936, 89376734, 89376739, 5, 640x360 
0x1382CA98, 37353943355810824, 89376762, 89376764, 2, 640x360 
0x1382CA98, 37353943356125096, 89376796, 89376801, 5, 640x360 
0x1382CA98, 37353943356449280, 89376831, 89376834, 3, 640x360 
0x1382CA98, 37353943356766480, 89376854, 89376864, 10, 640x360 
0x1382CA98, 37353943357089656, 89376885, 89376889, 4, 640x360 
0x1382CA98, 37353943357568792, 89376939, 89376944, 5, 640x360 
0x1382CA98, 37353943357902352, 89376967, 89376970, 3, 640x360 
0x1382CA98, 37353943358206784, 89377003, 89377006, 3, 640x360 
0x1382CA98, 37353943358519584, 89377034, 89377036, 2, 640x360 
0x1382CA98, 37353943358840032, 89377060, 89377068, 8, 640x360 
0x1382CA98, 37353943359160792, 89377097, 89377100, 3, 640x360 
0x1382CA98, 37353943359491720, 89377129, 89377136, 7, 640x360 
0x1382CA98, 37353943359804640, 89377162, 89377164, 2, 640x360 
0x1382CA98, 37353943360120040, 89377193, 89377195, 2, 640x360 
0x1382CA98, 37353943360440872, 89377225, 89377228, 3, 640x360 
0x1382CA98, 37353943360765112, 89377258, 89377260, 2, 640x360 
0x1382CA98, 37353943361086928, 89377284, 89377286, 2, 640x360 
0x1382CA98, 37353943361560992, 89377335, 89377346, 11, 640x360 
0x1382CA98, 37353943361882504, 89377383, 89377385, 2, 640x360 
0x1382CA98, 37353943362202768, 89377405, 89377414, 9, 640x360 
0x1382CA98, 37353943362526456, 89377432, 89377435, 3, 640x360 
0x1382CA98, 37353943362844520, 89377467, 89377475, 8, 640x360 
0x1382CA98, 37353943363162936, 89377499, 89377506, 7, 640x360 
0x1382CA98, 37353943363480544, 89377531, 89377533, 2, 640x360 
0x1382CA98, 37353943363805224, 89377564, 89377569, 5, 640x360 
0x1382CA98, 37353943364120568, 89377596, 89377599, 3, 640x360 
0x1382CA98, 37353943364451488, 89377629, 89377638, 9, 640x360 
0x1382CA98, 37353943364772544, 89377654, 89377664, 10, 640x360 
0x1382CA98, 37353943365088520, 89377686, 89377690, 4, 640x360 
0x1382CA98, 37353943365566984, 89377742, 89377745, 3, 640x360 
0x1382CA98, 37353943365885512, 89377770, 89377776, 6, 640x360 
0x1382CA98, 37353943366206240, 89377800, 89377803, 3, 640x360 
0x1382CA98, 37353943366536848, 89377830, 89377832, 2, 640x360 
0x1382CA98, 37353943366843960, 89377871, 89377877, 6, 640x360 
0x1382CA98, 37353943367161656, 89377898, 89377900, 2, 640x360 
0x1382CA98, 37353943367483384, 89377929, 89377936, 7, 640x360 
0x1382CA98, 37353943367799328, 89377962, 89377964, 2, 640x360 
0x1382CA98, 37353943368122288, 89377990, 89378001, 11, 640x360 
0x1382CA98, 37353943368440120, 89378023, 89378031, 8, 640x360 
0x1382CA98, 37353943368764504, 89378056, 89378065, 9, 640x360 
0x1382CA98, 37353943369090520, 89378091, 89378098, 7, 640x360 
0x1382CA98, 37353943369560296, 89378147, 89378150, 3, 640x360 
0x1382CA98, 37353943369879552, 89378177, 89378183, 6, 640x360 
0x1382CA98, 37353943370208240, 89378208, 89378216, 8, 640x360 
0x1382CA98, 37353943370520528, 89378235, 89378238, 3, 640x360 
0x1382CA98, 37353943370842024, 89378263, 89378267, 4, 640x360 
0x1382CA98, 37353943371166688, 89378300, 89378307, 7, 640x360 
0x1382CA98, 37353943371479496, 89378328, 89378331, 3, 640x360 
0x1382CA98, 37353943371799984, 89378365, 89378367, 2, 640x360 
0x1382CA98, 37353943372122744, 89378397, 89378400, 3, 640x360 
0x1382CA98, 37353943372440560, 89378424, 89378431, 7, 640x360 
0x1382CA98, 37353943372762104, 89378457, 89378464, 7, 640x360 
0x1382CA98, 37353943373087416, 89378496, 89378498, 2, 640x360 
0x1382CA98, 37353943373559424, 89378540, 89378548, 8, 640x360 
0x1382CA98, 37353943373883808, 89378574, 89378578, 4, 640x360 
0x1382CA98, 37353943374200208, 89378607, 89378612, 5, 640x360 
0x1382CA98, 37353943374521224, 89378635, 89378637, 2, 640x360 
0x1382CA98, 37353943374845952, 89378664, 89378667, 3, 640x360 
0x1382CA98, 37353943375172480, 89378695, 89378698, 3, 640x360 
0x1382CA98, 37353943375480328, 89378731, 89378737, 6, 640x360 
0x1382CA98, 37353943375800456, 89378763, 89378765, 2, 640x360 
0x1382CA98, 37353943376125208, 89378794, 89378806, 12, 640x360 
0x1382CA98, 37353943376439312, 89378821, 89378827, 6, 640x360 
0x1382CA98, 37353943376759952, 89378865, 89378873, 8, 640x360 
0x1382CA98, 37353943377092312, 89378893, 89378900, 7, 640x360 
0x1382CA98, 37353943377559384, 89378936, 89378938, 2, 640x360 
0x1382CA98, 37353943377879480, 89378981, 89378988, 7, 640x360 
0x1382CA98, 37353943378215144, 89379008, 89379011, 3, 640x360 
0x1382CA98, 37353943378519088, 89379031, 89379033, 2, 640x360 
0x1382CA98, 37353943378838944, 89379062, 89379069, 7, 640x360 
0x1382CA98, 37353943379165464, 89379110, 89379112, 2, 640x360 
0x1382CA98, 37353943379480696, 89379143, 89379156, 13, 640x360 
0x1382CA98, 37353943379815032, 89379168, 89379175, 7, 640x360 
0x1382CA98, 37353943380130584, 89379201, 89379205, 4, 640x360 
0x1382CA98, 37353943380443712, 89379231, 89379234, 3, 640x360 
0x1382CA98, 37353943380767824, 89379263, 89379270, 7, 640x360 
0x1382CA98, 37353943381086216, 89379297, 89379302, 5, 640x360 
0x1382CA98, 37353943381567968, 89379336, 89379342, 6, 640x360 
0x1382CA98, 37353943381879376, 89379369, 89379375, 6, 640x360 
0x1382CA98, 37353943382204904, 89379407, 89379410, 3, 640x360 
0x1382CA98, 37353943382520248, 89379429, 89379434, 5, 640x360 
0x1382CA98, 37353943382838744, 89379462, 89379474, 12, 640x360 
0x1382CA98, 37353943383170880, 89379495, 89379497, 2, 640x360 
0x1382CA98, 37353943383491168, 89379533, 89379538, 5, 640x360 
0x1382CA98, 37353943383807528, 89379560, 89379563, 3, 640x360 
0x1382CA98, 37353943384124024, 89379598, 89379606, 8, 640x360 
0x1382CA98, 37353943384468736, 89379626, 89379628, 2, 640x360 
0x1382CA98, 37353943384776240, 89379665, 89379667, 2, 640x360 
0x1382CA98, 37353943385090720, 89379702, 89379709, 7, 640x360 
0x1382CA98, 37353943385440280, 89379729, 89379732, 3, 640x360 
0x1382CA98, 37353943385878424, 89379773, 89379777, 4, 640x360 
0x1382CA98, 37353943386204288, 89379814, 89379821, 7, 640x360 
0x1382CA98, 37353943386521240, 89379831, 89379840, 9, 640x360 
0x1382CA98, 37353943386838744, 89379863, 89379865, 2, 640x360 
0x1382CA98, 37353943387163920, 89379900, 89379902, 2, 640x360 
0x1382CA98, 37353943387483264, 89379926, 89379928, 2, 640x360 
0x1382CA98, 37353943387800928, 89379959, 89379962, 3, 640x360 
0x1382CA98, 37353943388122624, 89379998, 89380016, 18, 640x360 
0x1382CA98, 37353943388459840, 89380030, 89380035, 5, 640x360 
0x1382CA98, 37353943388776736, 89380063, 89380067, 4, 640x360 
0x1382CA98, 37353943389080192, 89380099, 89380102, 3, 640x360 
0x1382CA98, 37353943389425872, 89380126, 89380132, 6, 640x360 
0x1382CA98, 37353943389880312, 89380172, 89380177, 5, 640x360 
0x1382CA98, 37353943390202496, 89380203, 89380205, 2, 640x360 
0x1382CA98, 37353943390525840, 89380233, 89380235, 2, 640x360 
0x1382CA98, 37353943390845768, 89380271, 89380279, 8, 640x360 
0x1382CA98, 37353943391158736, 89380292, 89380295, 3, 640x360 
0x1382CA98, 37353943391483152, 89380329, 89380332, 3, 640x360 
0x1382CA98, 37353943391806536, 89380361, 89380368, 7, 640x360 
0x1382CA98, 37353943392119768, 89380394, 89380398, 4, 640x360 
0x1382CA98, 37353943392445352, 89380429, 89380434, 5, 640x360 
0x1382CA98, 37353943392771736, 89380465, 89380475, 10, 640x360 
0x1382CA98, 37353943393092832, 89380492, 89380503, 11, 640x360 
0x1382CA98, 37353943393446952, 89380531, 89380542, 11, 640x360 
0x1382CA98, 37353943393878752, 89380567, 89380569, 2, 640x360 
0x1382CA98, 37353943394202368, 89380600, 89380603, 3, 640x360 
0x1382CA98, 37353943394518248, 89380633, 89380635, 2, 640x360 
0x1382CA98, 37353943394839872, 89380670, 89380676, 6, 640x360 
0x1382CA98, 37353943395162432, 89380697, 89380699, 2, 640x360 
0x1382CA98, 37353943395481504, 89380731, 89380733, 2, 640x360 
0x1382CA98, 37353943395801136, 89380763, 89380769, 6, 640x360 
0x1382CA98, 37353943396120184, 89380796, 89380799, 3, 640x360 
0x1382CA98, 37353943396439360, 89380822, 89380826, 4, 640x360 
0x1382CA98, 37353943396758648, 89380856, 89380859, 3, 640x360 
0x1382CA98, 37353943397083208, 89380890, 89380900, 10, 640x360 
0x1382CA98, 37353943397423328, 89380923, 89380931, 8, 640x360 
0x1382CA98, 37353943397878552, 89380972, 89380977, 5, 640x360 
0x1382CA98, 37353943398202144, 89381002, 89381005, 3, 640x360 
0x1382CA98, 37353943398530800, 89381030, 89381032, 2, 640x360 
0x1382CA98, 37353943398850992, 89381074, 89381077, 3, 640x360 
0x1382CA98, 37353943399159464, 89381099, 89381102, 3, 640x360 
0x1382CA98, 37353943399479328, 89381128, 89381131, 3, 640x360 
0x1382CA98, 37353943399805008, 89381166, 89381168, 2, 640x360 
0x1382CA98, 37353943400125352, 89381198, 89381201, 3, 640x360 
0x1382CA98, 37353943400452888, 89381226, 89381228, 2, 640x360 
0x1382CA98, 37353943400767664, 89381259, 89381262, 3, 640x360 
0x1382CA98, 37353943401091544, 89381297, 89381299, 2, 640x360 
0x1382CA98, 37353943401877896, 89381368, 89381373, 5, 640x360 
0x1382CA98, 37353943402198944, 89381404, 89381411, 7, 640x360 
0x1382CA98, 37353943402518168, 89381437, 89381441, 4, 640x360 
0x1382CA98, 37353943402838336, 89381470, 89381476, 6, 640x360 
0x1382CA98, 37353943403159152, 89381495, 89381497, 2, 640x360 
0x1382CA98, 37353943403482776, 89381528, 89381531, 3, 640x360 
0x1382CA98, 37353943403799152, 89381559, 89381569, 10, 640x360 
0x1382CA98, 37353943404122712, 89381590, 89381597, 7, 640x360 
0x1382CA98, 37353943404438488, 89381622, 89381630, 8, 640x360 
0x1382CA98, 37353943404759224, 89381655, 89381663, 8, 640x360 
0x1382CA98, 37353943405085160, 89381690, 89381693, 3, 640x360 
0x1382CA98, 37353943405409048, 89381717, 89381719, 2, 640x360 
0x1382CA98, 37353943405878952, 89381771, 89381777, 6, 640x360 
0x1382CA98, 37353943406199336, 89381803, 89381815, 12, 640x360 
0x1382CA98, 37353943406522216, 89381831, 89381835, 4, 640x360 
0x1382CA98, 37353943406842048, 89381861, 89381866, 5, 640x360 
0x1382CA98, 37353943407162272, 89381894, 89381899, 5, 640x360 
0x1382CA98, 37353943407482288, 89381926, 89381933, 7, 640x360 
0x1382CA98, 37353943407802144, 89381957, 89381960, 3, 640x360 
0x1382CA98, 37353943408122136, 89381989, 89381992, 3, 640x360 
0x1382CA98, 37353943408443816, 89382026, 89382030, 4, 640x360 
0x1382CA98, 37353943408763120, 89382052, 89382054, 2, 640x360 
0x1382CA98, 37353943409079344, 89382090, 89382094, 4, 640x360 
0x1382CA98, 37353943409401416, 89382119, 89382126, 7, 640x360 
0x1382CA98, 37353943409719528, 89382151, 89382155, 4, 640x360 
0x1382CA98, 37353943410203096, 89382199, 89382201, 2, 640x360 
0x1382CA98, 37353943410518664, 89382233, 89382237, 4, 640x360 
0x1382CA98, 37353943410838912, 89382264, 89382267, 3, 640x360 
0x1382CA98, 37353943411158888, 89382296, 89382299, 3, 640x360 
0x1382CA98, 37353943411484104, 89382329, 89382332, 3, 640x360 
0x1382CA98, 37353943411812584, 89382365, 89382368, 3, 640x360 
0x1382CA98, 37353943412124440, 89382396, 89382403, 7, 640x360 
0x1382CA98, 37353943412443072, 89382430, 89382436, 6, 640x360 
0x1382CA98, 37353943412771488, 89382453, 89382458, 5, 640x360 
0x1382CA98, 37353943413089112, 89382489, 89382491, 2, 640x360 
0x1382CA98, 37353943413413376, 89382523, 89382530, 7, 640x360 
0x1382CA98, 37353943413747384, 89382558, 89382567, 9, 640x360 
0x1382CA98, 37353943414202328, 89382601, 89382603, 2, 640x360 
0x1382CA98, 37353943414525840, 89382633, 89382636, 3, 640x360 
0x1382CA98, 37353943414840624, 89382666, 89382668, 2, 640x360 
0x1382CA98, 37353943415162920, 89382696, 89382698, 2, 640x360 
0x1382CA98, 37353943415482016, 89382728, 89382730, 2, 640x360 
0x1382CA98, 37353943415804776, 89382759, 89382773, 14, 640x360 
0x1382CA98, 37353943416123784, 89382794, 89382800, 6, 640x360 
0x1382CA98, 37353943416438600, 89382821, 89382825, 4, 640x360 
0x1382CA98, 37353943416766840, 89382852, 89382855, 3, 640x360 
0x1382CA98, 37353943417090520, 89382896, 89382899, 3, 640x360 
0x1382CA98, 37353943417403824, 89382919, 89382941, 22, 640x360 
0x1382CA98, 37353943417721392, 89382960, 89382973, 13, 640x360 
0x1382CA98, 37353943418198584, 89383008, 89383013, 5, 640x360 
0x1382CA98, 37353943418517952, 89383036, 89383041, 5, 640x360 
0x1382CA98, 37353943418838832, 89383070, 89383092, 22, 640x360 
0x1382CA98, 37353943419178592, 89383128, 89383135, 7, 640x360 
0x1382CA98, 37353943419519856, 89383136, 89383149, 13, 640x360 
0x1382CA98, 37353943419798120, 89383176, 89383195, 19, 640x360 
0x1382CA98, 37353943420124720, 89383195, 89383198, 3, 640x360 
0x1382CA98, 37353943420445720, 89383231, 89383233, 2, 640x360 
0x1382CA98, 37353943420772528, 89383269, 89383272, 3, 640x360 
0x1382CA98, 37353943421084368, 89383297, 89383299, 2, 640x360 
0x1382CA98, 37353943421404712, 89383326, 89383334, 8, 640x360 
0x1382CA98, 37353943421722824, 89383355, 89383364, 9, 640x360 
0x1382CA98, 37353943422203256, 89383404, 89383415, 11, 640x360 
0x1382CA98, 37353943422517680, 89383434, 89383438, 4, 640x360 
0x1382CA98, 37353943422853864, 89383463, 89383472, 9, 640x360 
0x1382CA98, 37353943423157816, 89383499, 89383502, 3, 640x360 
0x1382CA98, 37353943423477880, 89383532, 89383536, 4, 640x360 
0x1382CA98, 37353943423799016, 89383564, 89383573, 9, 640x360 
0x1382CA98, 37353943424117768, 89383591, 89383602, 11, 640x360 
0x1382CA98, 37353943424438624, 89383622, 89383628, 6, 640x360 
0x1382CA98, 37353943424760192, 89383653, 89383656, 3, 640x360 
0x1382CA98, 37353943425110824, 89383691, 89383699, 8, 640x360 
0x1382CA98, 37353943425415104, 89383723, 89383733, 10, 640x360 
0x1382CA98, 37353943425740456, 89383760, 89383765, 5, 640x360 
0x1382CA98, 37353943426201792, 89383802, 89383805, 3, 640x360 
0x1382CA98, 37353943426517400, 89383828, 89383833, 5, 640x360 
0x1382CA98, 37353943426837592, 89383865, 89383868, 3, 640x360 
0x1382CA98, 37353943427163352, 89383901, 89383903, 2, 640x360 
0x1382CA98, 37353943427479328, 89383931, 89383937, 6, 640x360 
0x1382CA98, 37353943427803952, 89383967, 89383973, 6, 640x360 
0x1382CA98, 37353943428122912, 89383999, 89384005, 6, 640x360 
0x1382CA98, 37353943428444648, 89384038, 89384050, 12, 640x360 
0x1382CA98, 37353943428770296, 89384067, 89384078, 11, 640x360 
0x1382CA98, 37353943429124080, 89384108, 89384140, 32, 640x360 
0x1382CA98, 37353943429411888, 89384140, 89384151, 11, 640x360 
0x1382CA98, 37353943429755600, 89384165, 89384169, 4, 640x360 
0x1382CA98, 37353943430204016, 89384208, 89384218, 10, 640x360 
0x1382CA98, 37353943430542152, 89384244, 89384258, 14, 640x360 
0x1382CA98, 37353943430872480, 89384284, 89384296, 12, 640x360 
0x1382CA98, 37353943431159720, 89384312, 89384333, 21, 640x360 
0x1382CA98, 37353943431494928, 89384342, 89384352, 10, 640x360 
0x1382CA98, 37353943431797728, 89384365, 89384373, 8, 640x360 
0x1382CA98, 37353943432118696, 89384399, 89384401, 2, 640x360 
0x1382CA98, 37353943432438784, 89384424, 89384433, 9, 640x360 
0x1382CA98, 37353943432764448, 89384468, 89384470, 2, 640x360 
0x1382CA98, 37353943433090472, 89384496, 89384502, 6, 640x360 
0x1382CA98, 37353943433402456, 89384519, 89384521, 2, 640x360 
0x1382CA98, 37353943433725304, 89384550, 89384552, 2, 640x360 
0x1382CA98, 37353943434197856, 89384601, 89384604, 3, 640x360 
0x1382CA98, 37353943434517728, 89384628, 89384632, 4, 640x360 
0x1382CA98, 37353943434838720, 89384661, 89384668, 7, 640x360 
0x1382CA98, 37353943435161864, 89384695, 89384698, 3, 640x360 
0x1382CA98, 37353943435480832, 89384735, 89384738, 3, 640x360 
0x1382CA98, 37353943435808528, 89384762, 89384773, 11, 640x360 
0x1382CA98, 37353943436133792, 89384799, 89384802, 3, 640x360 
0x1382CA98, 37353943436437912, 89384823, 89384832, 9, 640x360 
0x1382CA98, 37353943436771584, 89384856, 89384867, 11, 640x360 
0x1382CA98, 37353943437090000, 89384893, 89384900, 7, 640x360 
0x1382CA98, 37353943437398840, 89384924, 89384932, 8, 640x360 
0x1382CA98, 37353943437718104, 89384957, 89384966, 9, 640x360 
0x1382CA98, 37353943438038336, 89384985, 89384988, 3, 640x360 
0x1382CA98, 37353943438517224, 89385032, 89385035, 3, 640x360 
0x1382CA98, 37353943438843016, 89385068, 89385071, 3, 640x360 
0x1382CA98, 37353943439157712, 89385096, 89385098, 2, 640x360 
0x1382CA98, 37353943439483784, 89385131, 89385138, 7, 640x360 
0x1382CA98, 37353943439801408, 89385165, 89385168, 3, 640x360 
0x1382CA98, 37353943440117536, 89385193, 89385200, 7, 640x360 
0x1382CA98, 37353943440439568, 89385219, 89385222, 3, 640x360 
0x1382CA98, 37353943440763744, 89385256, 89385264, 8, 640x360 
0x1382CA98, 37353943441090576, 89385290, 89385298, 8, 640x360 
0x1382CA98, 37353943441397848, 89385322, 89385332, 10, 640x360 
0x1382CA98, 37353943441717920, 89385351, 89385354, 3, 640x360 
0x1382CA98, 37353943442037680, 89385385, 89385389, 4, 640x360 
0x1382CA98, 37353943442517456, 89385431, 89385433, 2, 640x360 
0x1382CA98, 37353943442841056, 89385468, 89385474, 6, 640x360 
0x1382CA98, 37353943443158160, 89385501, 89385508, 7, 640x360 
0x1382CA98, 37353943443477256, 89385529, 89385531, 2, 640x360 
0x1382CA98, 37353943443811000, 89385563, 89385570, 7, 640x360 
0x1382CA98, 37353943444123672, 89385601, 89385603, 2, 640x360 
0x1382CA98, 37353943444443672, 89385638, 89385657, 19, 640x360 
0x1382CA98, 37353943444775728, 89385670, 89385677, 7, 640x360 
0x1382CA98, 37353943445081680, 89385703, 89385710, 7, 640x360 
0x1382CA98, 37353943445398672, 89385730, 89385732, 2, 640x360 
0x1382CA98, 37353943445718744, 89385758, 89385762, 4, 640x360 
0x1382CA98, 37353943446038392, 89385796, 89385801, 5, 640x360 
0x1382CA98, 37353943446517712, 89385840, 89385849, 9, 640x360 
0x1382CA98, 37353943446839416, 89385872, 89385878, 6, 640x360 
0x1382CA98, 37353943447160296, 89385901, 89385911, 10, 640x360 
0x1382CA98, 37353943447486504, 89385945, 89385951, 6, 640x360 
0x1382CA98, 37353943447799096, 89385968, 89385978, 10, 640x360 
0x1382CA98, 37353943448128296, 89385993, 89385996, 3, 640x360 
0x1382CA98, 37353943448466096, 89386028, 89386031, 3, 640x360 
0x1382CA98, 37353943448764832, 89386056, 89386065, 9, 640x360 
0x1382CA98, 37353943449088072, 89386084, 89386086, 2, 640x360 
0x1382CA98, 37353943449398104, 89386121, 89386131, 10, 640x360 
0x1382CA98, 37353943449721496, 89386157, 89386173, 16, 640x360 
0x1382CA98, 37353943450123904, 89386196, 89386199, 3, 640x360 
0x1382CA98, 37353943450518360, 89386234, 89386236, 2, 640x360 
0x1382CA98, 37353943450840432, 89386264, 89386267, 3, 640x360 
0x1382CA98, 37353943451160424, 89386297, 89386303, 6, 640x360 
0x1382CA98, 37353943451492072, 89386331, 89386340, 9, 640x360 
0x1382CA98, 37353943451798376, 89386359, 89386368, 9, 640x360 
0x1382CA98, 37353943452123728, 89386400, 89386406, 6, 640x360 
0x1382CA98, 37353943452439760, 89386425, 89386428, 3, 640x360 
0x1382CA98, 37353943452766168, 89386453, 89386467, 14, 640x360 
0x1382CA98, 37353943453089160, 89386492, 89386498, 6, 640x360 
0x1382CA98, 37353943453399200, 89386532, 89386535, 3, 640x360 
0x1382CA98, 37353943453717264, 89386558, 89386561, 3, 640x360 
0x1382CA98, 37353943454037448, 89386587, 89386591, 4, 640x360 
0x1382CA98, 37353943454517552, 89386634, 89386642, 8, 640x360 
0x1382CA98, 37353943454841680, 89386666, 89386668, 2, 640x360 
0x1382CA98, 37353943455172736, 89386700, 89386703, 3, 640x360 
0x1382CA98, 37353943455482096, 89386734, 89386740, 6, 640x360 
0x1382CA98, 37353943455798112, 89386757, 89386771, 14, 640x360 
0x1382CA98, 37353943456117048, 89386795, 89386798, 3, 640x360 
0x1382CA98, 37353943456437720, 89386823, 89386833, 10, 640x360 
0x1382CA98, 37353943456771312, 89386869, 89386882, 13, 640x360 
0x1382CA98, 37353943457106200, 89386906, 89386916, 10, 640x360 
0x1382CA98, 37353943457397728, 89386932, 89386942, 10, 640x360 
0x1382CA98, 37353943457769744, 89386964, 89386975, 11, 640x360 
0x1382CA98, 37353943458047312, 89386997, 89387006, 9, 640x360 
0x1382CA98, 37353943458516608, 89387034, 89387041, 7, 640x360 
0x1382CA98, 37353943458839512, 89387078, 89387083, 5, 640x360 
0x1382CA98, 37353943459184248, 89387107, 89387110, 3, 640x360 
0x1382CA98, 37353943459478296, 89387131, 89387135, 4, 640x360 
0x1382CA98, 37353943459799480, 89387165, 89387167, 2, 640x360 
0x1382CA98, 37353943460118328, 89387197, 89387207, 10, 640x360 
0x1382CA98, 37353943460440824, 89387224, 89387229, 5, 640x360 
0x1382CA98, 37353943460756976, 89387252, 89387266, 14, 640x360 
0x1382CA98, 37353943461093112, 89387288, 89387298, 10, 640x360 
0x1382CA98, 37353943461398456, 89387324, 89387327, 3, 640x360 
0x1382CA98, 37353943461721576, 89387359, 89387363, 4, 640x360 
0x1382CA98, 37353943462037768, 89387385, 89387389, 4, 640x360 
0x1382CA98, 37353943462517080, 89387435, 89387448, 13, 640x360 
0x1382CA98, 37353943462846000, 89387467, 89387469, 2, 640x360 
0x1382CA98, 37353943463178040, 89387497, 89387499, 2, 640x360 
0x1382CA98, 37353943463502960, 89387529, 89387531, 2, 640x360 
0x1382CA98, 37353943463808216, 89387563, 89387565, 2, 640x360 
0x1382CA98, 37353943464146040, 89387599, 89387601, 2, 640x360 
0x1382CA98, 37353943464442360, 89387626, 89387635, 9, 640x360 
0x1382CA98, 37353943464760360, 89387663, 89387670, 7, 640x360 
0x1382CA98, 37353943465087664, 89387691, 89387694, 3, 640x360 
0x1382CA98, 37353943465404216, 89387722, 89387727, 5, 640x360 
0x1382CA98, 37353943465720856, 89387748, 89387750, 2, 640x360 
0x1382CA98, 37353943466037176, 89387784, 89387786, 2, 640x360 
0x1382CA98, 37353943466357768, 89387816, 89387819, 3, 640x360 
0x1382CA98, 37353943466837160, 89387861, 89387864, 3, 640x360 
0x1382CA98, 37353943467159304, 89387892, 89387894, 2, 640x360 
0x1382CA98, 37353943467482176, 89387927, 89387931, 4, 640x360 
0x1382CA98, 37353943467799928, 89387960, 89387967, 7, 640x360 
0x1382CA98, 37353943468118552, 89387994, 89388002, 8, 640x360 
0x1382CA98, 37353943468437936, 89388025, 89388035, 10, 640x360 
0x1382CA98, 37353943468768072, 89388074, 89388077, 3, 640x360 
0x1382CA98, 37353943469102840, 89388102, 89388105, 3, 640x360 
0x1382CA98, 37353943469398608, 89388122, 89388133, 11, 640x360 
0x1382CA98, 37353943469717336, 89388153, 89388156, 3, 640x360 
0x1382CA98, 37353943470038112, 89388186, 89388189, 3, 640x360 
0x1382CA98, 37353943470357480, 89388219, 89388223, 4, 640x360 
0x1382CA98, 37353943470842832, 89388272, 89388281, 9, 640x360 
0x1382CA98, 37353943471166256, 89388304, 89388313, 9, 640x360 
0x1382CA98, 37353943471477792, 89388331, 89388334, 3, 640x360 
0x1382CA98, 37353943471797168, 89388369, 89388383, 14, 640x360 
0x1382CA98, 37353943472118504, 89388402, 89388406, 4, 640x360 
0x1382CA98, 37353943472442640, 89388437, 89388452, 15, 640x360 
0x1382CA98, 37353943472778928, 89388474, 89388478, 4, 640x360 
0x1382CA98, 37353943473094832, 89388498, 89388500, 2, 640x360 
0x1382CA98, 37353943473422376, 89388529, 89388532, 3, 640x360 
0x1382CA98, 37353943473717232, 89388560, 89388563, 3, 640x360 
0x1382CA98, 37353943474041520, 89388595, 89388597, 2, 640x360 
0x1382CA98, 37353943474357176, 89388629, 89388633, 4, 640x360 
0x1382CA98, 37353943474884888, 89388669, 89388674, 5, 640x360 
0x1382CA98, 37353943475174920, 89388702, 89388708, 6, 640x360 
0x1382CA98, 37353943475528688, 89388733, 89388735, 2, 640x360 
0x1382CA98, 37353943475797800, 89388764, 89388766, 2, 640x360 
0x1382CA98, 37353943476124200, 89388802, 89388806, 4, 640x360 
0x1382CA98, 37353943476440544, 89388833, 89388837, 4, 640x360 
0x1382CA98, 37353943476770416, 89388863, 89388871, 8, 640x360 
0x1382CA98, 37353943477085552, 89388890, 89388902, 12, 640x360 
0x1382CA98, 37353943477415392, 89388933, 89388945, 12, 640x360 
0x1382CA98, 37353943477724120, 89388970, 89388985, 15, 640x360 
0x1382CA98, 37353943478037384, 89388990, 89388993, 3, 640x360 
0x1382CA98, 37353943478364096, 89389023, 89389026, 3, 640x360 
0x1382CA98, 37353943478840696, 89389073, 89389078, 5, 640x360 
0x1382CA98, 37353943479160056, 89389104, 89389117, 13, 640x360 
0x1382CA98, 37353943479486176, 89389136, 89389150, 14, 640x360 
0x1382CA98, 37353943479801464, 89389169, 89389185, 16, 640x360 
0x1382CA98, 37353943480127704, 89389197, 89389199, 2, 640x360 
0x1382CA98, 37353943480437912, 89389229, 89389235, 6, 640x360 
0x1382CA98, 37353943480773376, 89389269, 89389279, 10, 640x360 
0x1382CA98, 37353943481118704, 89389300, 89389303, 3, 640x360 
0x1382CA98, 37353943481417368, 89389330, 89389332, 2, 640x360 
0x1382CA98, 37353943481719832, 89389358, 89389361, 3, 640x360 
0x1382CA98, 37353943482052896, 89389392, 89389398, 6, 640x360 
0x1382CA98, 37353943482363416, 89389422, 89389433, 11, 640x360 
0x1382CA98, 37353943482842512, 89389468, 89389470, 2, 640x360 
0x1382CA98, 37353943483165792, 89389508, 89389517, 9, 640x360 
0x1382CA98, 37353943483486672, 89389536, 89389542, 6, 640x360 
0x1382CA98, 37353943483802408, 89389568, 89389577, 9, 640x360 
0x1382CA98, 37353943484119128, 89389601, 89389605, 4, 640x360 
0x1382CA98, 37353943484447176, 89389631, 89389634, 3, 640x360 
0x1382CA98, 37353943484768704, 89389662, 89389667, 5, 640x360 
0x1382CA98, 37353943485084264, 89389692, 89389702, 10, 640x360 
0x1382CA98, 37353943485397728, 89389734, 89389758, 24, 640x360 
0x1382CA98, 37353943485733904, 89389785, 89389795, 10, 640x360 
0x1382CA98, 37353943486145504, 89389828, 89389862, 34, 640x360 
0x1382CA98, 37353943486566360, 89389862, 89389883, 21, 640x360 
0x1382CA98, 37353943487009184, 89389892, 89389897, 5, 640x360 
0x1382CA98, 37353943487213656, 89389915, 89389920, 5, 640x360 
0x1382CA98, 37353943487494448, 89389935, 89389940, 5, 640x360 
0x1382CA98, 37353943487803192, 89389971, 89389974, 3, 640x360 
0x1382CA98, 37353943488119136, 89390007, 89390023, 16, 640x360 
0x1382CA98, 37353943488446000, 89390029, 89390032, 3, 640x360 
0x1382CA98, 37353943488772992, 89390058, 89390068, 10, 640x360 
0x1382CA98, 37353943489102792, 89390098, 89390101, 3, 640x360 
0x1382CA98, 37353943489401592, 89390136, 89390144, 8, 640x360 
0x1382CA98, 37353943489717336, 89390167, 89390174, 7, 640x360 
0x1382CA98, 37353943490044016, 89390193, 89390197, 4, 640x360 
0x1382CA98, 37353943490364608, 89390217, 89390219, 2, 640x360 
0x1382CA98, 37353943490682472, 89390249, 89390251, 2, 640x360 
0x1382CA98, 37353943491162656, 89390301, 89390304, 3, 640x360 
0x1382CA98, 37353943491478696, 89390339, 89390347, 8, 640x360 
0x1382CA98, 37353943491799728, 89390368, 89390371, 3, 640x360 
0x1382CA98, 37353943492122648, 89390403, 89390408, 5, 640x360 
0x1382CA98, 37353943492445056, 89390433, 89390435, 2, 640x360 
0x1382CA98, 37353943492781384, 89390468, 89390472, 4, 640x360 
0x1382CA98, 37353943493082112, 89390496, 89390498, 2, 640x360 
0x1382CA98, 37353943493399856, 89390529, 89390531, 2, 640x360 
0x1382CA98, 37353943493716192, 89390564, 89390567, 3, 640x360 
0x1382CA98, 37353943494037600, 89390592, 89390595, 3, 640x360 
0x1382CA98, 37353943494357232, 89390633, 89390646, 13, 640x360 
0x1382CA98, 37353943494677384, 89390661, 89390663, 2, 640x360 
0x1382CA98, 37353943495164072, 89390702, 89390718, 16, 640x360 
0x1382CA98, 37353943495491808, 89390730, 89390733, 3, 640x360 
0x1382CA98, 37353943495815912, 89390768, 89390774, 6, 640x360 
0x1382CA98, 37353943496121104, 89390798, 89390800, 2, 640x360 
0x1382CA98, 37353943496466760, 89390828, 89390830, 2, 640x360 
0x1382CA98, 37353943496761824, 89390857, 89390868, 11, 640x360 
0x1382CA98, 37353943497078000, 89390889, 89390892, 3, 640x360 
0x1382CA98, 37353943497395904, 89390920, 89390923, 3, 640x360 
0x1382CA98, 37353943497720480, 89390958, 89390960, 2, 640x360 
0x1382CA98, 37353943498040000, 89390989, 89390992, 3, 640x360 
0x1382CA98, 37353943498358312, 89391017, 89391021, 4, 640x360 
0x1382CA98, 37353943498676160, 89391048, 89391050, 2, 640x360 
0x1382CA98, 37353943499159784, 89391097, 89391100, 3, 640x360 
0x1382CA98, 37353943499478008, 89391128, 89391130, 2, 640x360 
0x1382CA98, 37353943499796384, 89391157, 89391162, 5, 640x360 
0x1382CA98, 37353943500123408, 89391192, 89391200, 8, 640x360 
0x1382CA98, 37353943500436504, 89391221, 89391231, 10, 640x360 
0x1382CA98, 37353943500768288, 89391253, 89391259, 6, 640x360 
0x1382CA98, 37353943501092040, 89391290, 89391297, 7, 640x360 
0x1382CA98, 37353943501400408, 89391322, 89391333, 11, 640x360 
0x1382CA98, 37353943501716392, 89391356, 89391360, 4, 640x360 
0x1382CA98, 37353943502042384, 89391384, 89391386, 2, 640x360 
0x1382CA98, 37353943502361584, 89391418, 89391420, 2, 640x360 
0x1382CA98, 37353943502676104, 89391454, 89391459, 5, 640x360 
0x1382CA98, 37353943503160616, 89391495, 89391503, 8, 640x360 
0x1382CA98, 37353943503477384, 89391533, 89391535, 2, 640x360 
0x1382CA98, 37353943503802424, 89391569, 89391571, 2, 640x360 
0x1382CA98, 37353943504116128, 89391597, 89391603, 6, 640x360 
0x1382CA98, 37353943504439720, 89391629, 89391633, 4, 640x360 
0x1382CA98, 37353943504805296, 89391661, 89391666, 5, 640x360 
0x1382CA98, 37353943505103416, 89391690, 89391694, 4, 640x360 
0x1382CA98, 37353943505403576, 89391716, 89391718, 2, 640x360 
0x1382CA98, 37353943505715784, 89391750, 89391752, 2, 640x360 
0x1382CA98, 37353943506036048, 89391784, 89391786, 2, 640x360 
0x1382CA98, 37353943506356624, 89391817, 89391819, 2, 640x360 
0x1382CA98, 37353943506679904, 89391851, 89391854, 3, 640x360 
0x1382CA98, 37353943507165984, 89391908, 89391916, 8, 640x360 
0x1382CA98, 37353943507484232, 89391941, 89391951, 10, 640x360 
0x1382CA98, 37353943507803120, 89391967, 89391970, 3, 640x360 
0x1382CA98, 37353943508116008, 89391997, 89392006, 9, 640x360 
0x1382CA98, 37353943508454664, 89392030, 89392032, 2, 640x360 
0x1382CA98, 37353943508762944, 89392063, 89392069, 6, 640x360 
0x1382CA98, 37353943509093536, 89392096, 89392110, 14, 640x360 
0x1382CA98, 37353943509401112, 89392123, 89392126, 3, 640x360 
0x1382CA98, 37353943509720704, 89392159, 89392166, 7, 640x360 
0x1382CA98, 37353943510035968, 89392184, 89392187, 3, 640x360 
0x1382CA98, 37353943510360736, 89392219, 89392225, 6, 640x360 
0x1382CA98, 37353943510676512, 89392252, 89392255, 3, 640x360 
0x1382CA98, 37353943511163760, 89392308, 89392326, 18, 640x360 
0x1382CA98, 37353943511487208, 89392336, 89392339, 3, 640x360 
0x1382CA98, 37353943511804768, 89392370, 89392372, 2, 640x360 
0x1382CA98, 37353943512116512, 89392398, 89392401, 3, 640x360 
0x1382CA98, 37353943512435768, 89392429, 89392432, 3, 640x360 
0x1382CA98, 37353943512770912, 89392466, 89392479, 13, 640x360 
0x1382CA98, 37353943513104248, 89392496, 89392506, 10, 640x360 
0x1382CA98, 37353943513397216, 89392522, 89392525, 3, 640x360 
0x1382CA98, 37353943513717024, 89392556, 89392561, 5, 640x360 
0x1382CA98, 37353943514062216, 89392588, 89392598, 10, 640x360 
0x1382CA98, 37353943514363240, 89392623, 89392629, 6, 640x360 
0x1382CA98, 37353943514677432, 89392649, 89392651, 2, 640x360 
0x1382CA98, 37353943515155720, 89392707, 89392717, 10, 640x360 
0x1382CA98, 37353943515480384, 89392739, 89392743, 4, 640x360 
0x1382CA98, 37353943515797352, 89392769, 89392772, 3, 640x360 
0x1382CA98, 37353943516123784, 89392800, 89392803, 3, 640x360 
0x1382CA98, 37353943516438760, 89392822, 89392832, 10, 640x360 
0x1382CA98, 37353943516760896, 89392854, 89392860, 6, 640x360 
0x1382CA98, 37353943517082184, 89392899, 89392907, 8, 640x360 
0x1382CA98, 37353943517403768, 89392922, 89392932, 10, 640x360 
0x1382CA98, 37353943517715464, 89392956, 89392964, 8, 640x360 
0x1382CA98, 37353943518039584, 89392987, 89392991, 4, 640x360 
0x1382CA98, 37353943518384456, 89393022, 89393032, 10, 640x360 
0x1382CA98, 37353943518680248, 89393053, 89393055, 2, 640x360 
0x1382CA98, 37353943519478416, 89393130, 89393139, 9, 640x360 
0x1382CA98, 37353943519797832, 89393165, 89393168, 3, 640x360 
0x1382CA98, 37353943520115640, 89393198, 89393203, 5, 640x360 
0x1382CA98, 37353943520452224, 89393233, 89393238, 5, 640x360 
0x1382CA98, 37353943520769448, 89393259, 89393262, 3, 640x360 
0x1382CA98, 37353943521080544, 89393294, 89393301, 7, 640x360 
0x1382CA98, 37353943521399040, 89393335, 89393338, 3, 640x360 
0x1382CA98, 37353943521716064, 89393366, 89393369, 3, 640x360 
0x1382CA98, 37353943522035448, 89393391, 89393394, 3, 640x360 
0x1382CA98, 37353943522362688, 89393418, 89393420, 2, 640x360 
0x1382CA98, 37353943522689808, 89393450, 89393453, 3, 640x360 
0x1382CA98, 37353943522995560, 89393487, 89393490, 3, 640x360 
0x1382CA98, 37353943523477480, 89393528, 89393531, 3, 640x360 
0x1382CA98, 37353943523794864, 89393559, 89393566, 7, 640x360 
0x1382CA98, 37353943524115136, 89393593, 89393601, 8, 640x360 
0x1382CA98, 37353943524440968, 89393621, 89393627, 6, 640x360 
0x1382CA98, 37353943524759304, 89393658, 89393662, 4, 640x360 
0x1382CA98, 37353943525081928, 89393686, 89393688, 2, 640x360 
0x1382CA98, 37353943525406128, 89393724, 89393728, 4, 640x360 
0x1382CA98, 37353943525715376, 89393753, 89393763, 10, 640x360 
0x1382CA98, 37353943526045600, 89393791, 89393795, 4, 640x360 
0x1382CA98, 37353943526355408, 89393818, 89393820, 2, 640x360 
0x1382CA98, 37353943526677216, 89393855, 89393862, 7, 640x360 
0x1382CA98, 37353943527005280, 89393894, 89393898, 4, 640x360 
0x1382CA98, 37353943527474784, 89393941, 89393945, 4, 640x360 
0x1382CA98, 37353943527800064, 89393960, 89393963, 3, 640x360 
0x1382CA98, 37353943528116000, 89393994, 89393998, 4, 640x360 
0x1382CA98, 37353943528434824, 89394021, 89394027, 6, 640x360 
0x1382CA98, 37353943528755168, 89394058, 89394063, 5, 640x360 
0x1382CA98, 37353943529082616, 89394091, 89394099, 8, 640x360 
0x1382CA98, 37353943529396480, 89394127, 89394139, 12, 640x360 
0x1382CA98, 37353943529718400, 89394158, 89394161, 3, 640x360 
0x1382CA98, 37353943530040448, 89394190, 89394200, 10, 640x360 
0x1382CA98, 37353943530357208, 89394216, 89394220, 4, 640x360 
0x1382CA98, 37353943530686280, 89394249, 89394257, 8, 640x360 
0x1382CA98, 37353943530998904, 89394281, 89394283, 2, 640x360 
0x1382CA98, 37353943531479960, 89394327, 89394330, 3, 640x360 
0x1382CA98, 37353943531796616, 89394358, 89394361, 3, 640x360 
0x1382CA98, 37353943532115968, 89394388, 89394394, 6, 640x360 
0x1382CA98, 37353943532439560, 89394421, 89394429, 8, 640x360 
0x1382CA98, 37353943532769056, 89394454, 89394465, 11, 640x360 
0x1382CA98, 37353943533083352, 89394485, 89394488, 3, 640x360 
0x1382CA98, 37353943533397352, 89394523, 89394531, 8, 640x360 
0x1382CA98, 37353943533714904, 89394552, 89394555, 3, 640x360 
0x1382CA98, 37353943534035328, 89394588, 89394598, 10, 640x360 
0x1382CA98, 37353943534355984, 89394631, 89394656, 25, 640x360 
0x1382CA98, 37353943534684576, 89394661, 89394663, 2, 640x360 
0x1382CA98, 37353943534995760, 89394695, 89394699, 4, 640x360 
0x1382CA98, 37353943535483328, 89394732, 89394736, 4, 640x360 
0x1382CA98, 37353943535835984, 89394794, 89394803, 9, 640x360 
0x1382CA98, 37353943536133568, 89394806, 89394814, 8, 640x360 
0x1382CA98, 37353943536451272, 89394836, 89394859, 23, 640x360 
0x1382CA98, 37353943536783152, 89394879, 89394903, 24, 640x360 
0x1382CA98, 37353943537115848, 89394920, 89394949, 29, 640x360 
0x1382CA98, 37353943537452288, 89394949, 89394952, 3, 640x360 
0x1382CA98, 37353943537810048, 89394982, 89394992, 10, 640x360 
0x1382CA98, 37353943538061840, 89395013, 89395019, 6, 640x360 
0x1382CA98, 37353943538377816, 89395044, 89395057, 13, 640x360 
0x1382CA98, 37353943538686936, 89395072, 89395083, 11, 640x360 
0x1382CA98, 37353943539021320, 89395096, 89395099, 3, 640x360 
0x1382CA98, 37353943539492504, 89395153, 89395166, 13, 640x360 
0x1382CA98, 37353943539798264, 89395169, 89395178, 9, 640x360 
0x1382CA98, 37353943540138328, 89395210, 89395224, 14, 640x360 
0x1382CA98, 37353943540445552, 89395239, 89395252, 13, 640x360 
0x1382CA98, 37353943540787552, 89395267, 89395270, 3, 640x360 
0x1382CA98, 37353943541081784, 89395287, 89395290, 3, 640x360 
0x1382CA98, 37353943541396880, 89395326, 89395329, 3, 640x360 
0x1382CA98, 37353943541726592, 89395353, 89395356, 3, 640x360 
0x1382CA98, 37353943542039560, 89395385, 89395390, 5, 640x360 
0x1382CA98, 37353943542356472, 89395419, 89395423, 4, 640x360 
0x1382CA98, 37353943542676032, 89395451, 89395454, 3, 640x360 
0x1382CA98, 37353943542995968, 89395484, 89395487, 3, 640x360 
0x1382CA98, 37353943543481664, 89395541, 89395559, 18, 640x360 
0x1382CA98, 37353943543803976, 89395579, 89395594, 15, 640x360 
0x1382CA98, 37353943544128264, 89395601, 89395607, 6, 640x360 
0x1382CA98, 37353943544464072, 89395638, 89395652, 14, 640x360 
0x1382CA98, 37353943544777456, 89395666, 89395673, 7, 640x360 
0x1382CA98, 37353943545075992, 89395687, 89395690, 3, 640x360 
0x1382CA98, 37353943545395464, 89395719, 89395721, 2, 640x360 
0x1382CA98, 37353943545723144, 89395758, 89395760, 2, 640x360 
0x1382CA98, 37353943546040496, 89395791, 89395793, 2, 640x360 
0x1382CA98, 37353943546359576, 89395816, 89395818, 2, 640x360 
0x1382CA98, 37353943546678672, 89395857, 89395862, 5, 640x360 
0x1382CA98, 37353943546994944, 89395882, 89395884, 2, 640x360 
0x1382CA98, 37353943547321688, 89395920, 89395926, 6, 640x360 
0x1382CA98, 37353943547794120, 89395962, 89395964, 2, 640x360 
0x1382CA98, 37353943548117320, 89395994, 89396002, 8, 640x360 
0x1382CA98, 37353943548441152, 89396026, 89396028, 2, 640x360 
0x1382CA98, 37353943548758088, 89396063, 89396068, 5, 640x360 
0x1382CA98, 37353943549079592, 89396088, 89396093, 5, 640x360 
0x1382CA98, 37353943549400136, 89396120, 89396124, 4, 640x360 
0x1382CA98, 37353943549721256, 89396153, 89396158, 5, 640x360 
0x1382CA98, 37353943550040712, 89396187, 89396195, 8, 640x360 
0x1382CA98, 37353943550357936, 89396219, 89396221, 2, 640x360 
0x1382CA98, 37353943550678720, 89396248, 89396250, 2, 640x360 
0x1382CA98, 37353943551009064, 89396280, 89396282, 2, 640x360 
0x1382CA98, 37353943551344208, 89396314, 89396316, 2, 640x360 
0x1382CA98, 37353943551796440, 89396360, 89396366, 6, 640x360 
0x1382CA98, 37353943552119296, 89396391, 89396398, 7, 640x360 
0x1382CA98, 37353943552440216, 89396424, 89396432, 8, 640x360 
0x1382CA98, 37353943552761720, 89396456, 89396465, 9, 640x360 
0x1382CA98, 37353943553083072, 89396490, 89396494, 4, 640x360 
0x1382CA98, 37353943553407536, 89396521, 89396526, 5, 640x360 
0x1382CA98, 37353943553720008, 89396554, 89396559, 5, 640x360 
0x1382CA98, 37353943554037224, 89396580, 89396582, 2, 640x360 
0x1382CA98, 37353943554355384, 89396616, 89396620, 4, 640x360 
0x1382CA98, 37353943554675672, 89396647, 89396649, 2, 640x360 
0x1382CA98, 37353943554998600, 89396681, 89396687, 6, 640x360 
0x1382CA98, 37353943555315736, 89396712, 89396715, 3, 640x360 
0x1382CA98, 37353943555797744, 89396767, 89396778, 11, 640x360 
0x1382CA98, 37353943556121808, 89396796, 89396798, 2, 640x360 
0x1382CA98, 37353943556441232, 89396837, 89396852, 15, 640x360 
0x1382CA98, 37353943556776488, 89396866, 89396875, 9, 640x360 
0x1382CA98, 37353943557090832, 89396893, 89396897, 4, 640x360 
0x1382CA98, 37353943557408640, 89396926, 89396933, 7, 640x360 
0x1382CA98, 37353943557714344, 89396959, 89396962, 3, 640x360 
0x1382CA98, 37353943558040792, 89396988, 89396994, 6, 640x360 
0x1382CA98, 37353943558360296, 89397026, 89397034, 8, 640x360 
0x1382CA98, 37353943558689064, 89397053, 89397056, 3, 640x360 
0x1382CA98, 37353943558999792, 89397087, 89397106, 19, 640x360 
0x1382CA98, 37353943559353520, 89397120, 89397134, 14, 640x360 
0x1382CA98, 37353943559793880, 89397167, 89397169, 2, 640x360 
0x1382CA98, 37353943560114384, 89397210, 89397224, 14, 640x360 
0x1382CA98, 37353943560449640, 89397234, 89397237, 3, 640x360 
0x1382CA98, 37353943560779464, 89397263, 89397272, 9, 640x360 
0x1382CA98, 37353943561095208, 89397296, 89397299, 3, 640x360 
0x1382CA98, 37353943561407376, 89397323, 89397336, 13, 640x360 
0x1382CA98, 37353943561715472, 89397357, 89397361, 4, 640x360 
0x1382CA98, 37353943562043168, 89397385, 89397387, 2, 640x360 
0x1382CA98, 37353943562354424, 89397419, 89397423, 4, 640x360 
0x1382CA98, 37353943562674488, 89397445, 89397447, 2, 640x360 
0x1382CA98, 37353943562995744, 89397481, 89397486, 5, 640x360 
0x1382CA98, 37353943563326312, 89397514, 89397516, 2, 640x360 
0x1382CA98, 37353943563793696, 89397558, 89397565, 7, 640x360 
0x1382CA98, 37353943564126360, 89397593, 89397595, 2, 640x360 
0x1382CA98, 37353943564434064, 89397625, 89397634, 9, 640x360 
0x1382CA98, 37353943564761728, 89397657, 89397666, 9, 640x360 
0x1382CA98, 37353943565080912, 89397685, 89397687, 2, 640x360 
0x1382CA98, 37353943565400536, 89397722, 89397732, 10, 640x360 
0x1382CA98, 37353943565713880, 89397753, 89397758, 5, 640x360 
0x1382CA98, 37353943566037976, 89397784, 89397786, 2, 640x360 
0x1382CA98, 37353943566354296, 89397815, 89397819, 4, 640x360 
0x1382CA98, 37353943566675696, 89397853, 89397860, 7, 640x360 
0x1382CA98, 37353943567003624, 89397880, 89397882, 2, 640x360 
0x1382CA98, 37353943567321520, 89397912, 89397914, 2, 640x360 
0x1382CA98, 37353943567793600, 89397967, 89397970, 3, 640x360 
0x1382CA98, 37353943568113856, 89397993, 89397996, 3, 640x360 
0x1382CA98, 37353943568434072, 89398021, 89398037, 16, 640x360 
0x1382CA98, 37353943568767096, 89398058, 89398063, 5, 640x360 
0x1382CA98, 37353943569081576, 89398090, 89398102, 12, 640x360 
0x1382CA98, 37353943569394800, 89398120, 89398134, 14, 640x360 
0x1382CA98, 37353943569719744, 89398152, 89398154, 2, 640x360 
0x1382CA98, 37353943570034664, 89398187, 89398194, 7, 640x360 
0x1382CA98, 37353943570358944, 89398226, 89398229, 3, 640x360 
0x1382CA98, 37353943570678280, 89398253, 89398257, 4, 640x360 
0x1382CA98, 37353943570997680, 89398284, 89398287, 3, 640x360 
0x1382CA98, 37353943571333800, 89398315, 89398321, 6, 640x360 
0x1382CA98, 37353943571634272, 89398347, 89398350, 3, 640x360 
0x1382CA98, 37353943572113760, 89398392, 89398403, 11, 640x360 
0x1382CA98, 37353943572439568, 89398427, 89398430, 3, 640x360 
0x1382CA98, 37353943572761672, 89398459, 89398461, 2, 640x360 
0x1382CA98, 37353943573078328, 89398494, 89398496, 2, 640x360 
0x1382CA98, 37353943573394528, 89398524, 89398534, 10, 640x360 
0x1382CA98, 37353943573714344, 89398553, 89398556, 3, 640x360 
0x1382CA98, 37353943574034664, 89398591, 89398595, 4, 640x360 
0x1382CA98, 37353943574357624, 89398617, 89398619, 2, 640x360 
0x1382CA98, 37353943574679440, 89398650, 89398652, 2, 640x360 
0x1382CA98, 37353943574999368, 89398682, 89398684, 2, 640x360 
0x1382CA98, 37353943575324648, 89398715, 89398717, 2, 640x360 
0x1382CA98, 37353943575643856, 89398752, 89398765, 13, 640x360 
0x1382CA98, 37353943576117576, 89398800, 89398802, 2, 640x360 
0x1382CA98, 37353943576433904, 89398838, 89398853, 15, 640x360 
0x1382CA98, 37353943576766256, 89398869, 89398886, 17, 640x360 
0x1382CA98, 37353943577104960, 89398904, 89398913, 9, 640x360 
0x1382CA98, 37353943577409488, 89398939, 89398948, 9, 640x360 
0x1382CA98, 37353943577726656, 89398979, 89398983, 4, 640x360 
0x1382CA98, 37353943578093648, 89398998, 89399001, 3, 640x360 
0x1382CA98, 37353943578361944, 89399026, 89399029, 3, 640x360 
0x1382CA98, 37353943578679680, 89399057, 89399065, 8, 640x360 
0x1382CA98, 37353943578996568, 89399085, 89399088, 3, 640x360 
0x1382CA98, 37353943579317072, 89399112, 89399114, 2, 640x360 
0x1382CA98, 37353943579643960, 89399156, 89399161, 5, 640x360 
0x1382CA98, 37353943580113760, 89399190, 89399194, 4, 640x360 
0x1382CA98, 37353943580433656, 89399218, 89399221, 3, 640x360 
0x1382CA98, 37353943580766944, 89399257, 89399264, 7, 640x360 
0x1382CA98, 37353943581093256, 89399291, 89399295, 4, 640x360 
0x1382CA98, 37353943581399312, 89399330, 89399338, 8, 640x360 
0x1382CA98, 37353943581718600, 89399359, 89399361, 2, 640x360 
0x1382CA98, 37353943582038808, 89399391, 89399401, 10, 640x360 
0x1382CA98, 37353943582362512, 89399426, 89399434, 8, 640x360 
0x1382CA98, 37353943582688744, 89399452, 89399454, 2, 640x360 
0x1382CA98, 37353943582994112, 89399480, 89399483, 3, 640x360 
0x1382CA98, 37353943583315656, 89399520, 89399523, 3, 640x360 
0x1382CA98, 37353943583642192, 89399555, 89399560, 5, 640x360 
0x1382CA98, 37353943584117608, 89399594, 89399597, 3, 640x360 
0x1382CA98, 37353943584437784, 89399623, 89399626, 3, 640x360 
0x1382CA98, 37353943584759384, 89399657, 89399660, 3, 640x360 
0x1382CA98, 37353943585095864, 89399693, 89399696, 3, 640x360 
0x1382CA98, 37353943585402624, 89399729, 89399738, 9, 640x360 
0x1382CA98, 37353943585713832, 89399755, 89399758, 3, 640x360 
0x1382CA98, 37353943586033504, 89399782, 89399784, 2, 640x360 
0x1382CA98, 37353943586357416, 89399817, 89399819, 2, 640x360 
0x1382CA98, 37353943586674296, 89399846, 89399848, 2, 640x360 
0x1382CA98, 37353943586993672, 89399879, 89399884, 5, 640x360 
0x1382CA98, 37353943587320248, 89399914, 89399916, 2, 640x360 
0x1382CA98, 37353943587638800, 89399946, 89399958, 12, 640x360 
0x1382CA98, 37353943588113992, 89399994, 89400001, 7, 640x360 
0x1382CA98, 37353943588435456, 89400020, 89400023, 3, 640x360 
0x1382CA98, 37353943588759360, 89400058, 89400066, 8, 640x360 
0x1382CA98, 37353943589081328, 89400085, 89400088, 3, 640x360 
0x1382CA98, 37353943589394056, 89400123, 89400133, 10, 640x360 
0x1382CA98, 37353943589714168, 89400158, 89400166, 8, 640x360 
0x1382CA98, 37353943590034696, 89400186, 89400188, 2, 640x360 
0x1382CA98, 37353943590354688, 89400219, 89400221, 2, 640x360 
0x1382CA98, 37353943590675000, 89400252, 89400255, 3, 640x360 
0x1382CA98, 37353943591001760, 89400281, 89400283, 2, 640x360 
0x1382CA98, 37353943591313824, 89400314, 89400316, 2, 640x360 
0x1382CA98, 37353943591638744, 89400341, 89400344, 3, 640x360 
0x1382CA98, 37353943592120480, 89400393, 89400398, 5, 640x360 
0x1382CA98, 37353943592459680, 89400433, 89400438, 5, 640x360 
0x1382CA98, 37353943592773896, 89400459, 89400468, 9, 640x360 
0x1382CA98, 37353943593073968, 89400497, 89400499, 2, 640x360 
0x1382CA98, 37353943593393432, 89400524, 89400535, 11, 640x360 
0x1382CA98, 37353943593714992, 89400557, 89400560, 3, 640x360 
0x1382CA98, 37353943594033752, 89400585, 89400591, 6, 640x360 
0x1382CA98, 37353943594355672, 89400619, 89400626, 7, 640x360 
0x1382CA98, 37353943594677184, 89400646, 89400648, 2, 640x360 
0x1382CA98, 37353943595007440, 89400685, 89400688, 3, 640x360 
0x1382CA98, 37353943595342576, 89400713, 89400715, 2, 640x360 
0x1382CA98, 37353943595665608, 89400747, 89400749, 2, 640x360 
0x1382CA98, 37353943596117272, 89400791, 89400798, 7, 640x360 
0x1382CA98, 37353943596434064, 89400823, 89400831, 8, 640x360 
0x1382CA98, 37353943596758136, 89400855, 89400864, 9, 640x360 
0x1382CA98, 37353943597076856, 89400886, 89400891, 5, 640x360 
0x1382CA98, 37353943597394128, 89400921, 89400929, 8, 640x360 
0x1382CA98, 37353943597713456, 89400957, 89400960, 3, 640x360 
0x1382CA98, 37353943598037744, 89400987, 89400992, 5, 640x360 
0x1382CA98, 37353943598353840, 89401015, 89401019, 4, 640x360 
0x1382CA98, 37353943598673928, 89401048, 89401051, 3, 640x360 
0x1382CA98, 37353943598997512, 89401083, 89401085, 2, 640x360 
0x1382CA98, 37353943599313424, 89401117, 89401121, 4, 640x360 
0x1382CA98, 37353943599656816, 89401155, 89401160, 5, 640x360 
0x1382CA98, 37353943599958704, 89401177, 89401184, 7, 640x360 
0x1382CA98, 37353943600432872, 89401219, 89401221, 2, 640x360 
0x1382CA98, 37353943600756584, 89401251, 89401253, 2, 640x360 
0x1382CA98, 37353943601079048, 89401283, 89401285, 2, 640x360 
0x1382CA98, 37353943601393872, 89401320, 89401324, 4, 640x360 
0x1382CA98, 37353943601713280, 89401352, 89401354, 2, 640x360 
0x1382CA98, 37353943602033784, 89401384, 89401387, 3, 640x360 
0x1382CA98, 37353943602359664, 89401416, 89401418, 2, 640x360 
0x1382CA98, 37353943602682360, 89401450, 89401452, 2, 640x360 
0x1382CA98, 37353943602993824, 89401481, 89401483, 2, 640x360 
0x1382CA98, 37353943603317216, 89401513, 89401516, 3, 640x360 
0x1382CA98, 37353943603633920, 89401546, 89401548, 2, 640x360 
0x1382CA98, 37353943603957952, 89401579, 89401581, 2, 640x360 
0x1382CA98, 37353943604437832, 89401622, 89401626, 4, 640x360 
0x1382CA98, 37353943604754144, 89401653, 89401659, 6, 640x360 
0x1382CA98, 37353943605085384, 89401684, 89401686, 2, 640x360 
0x1382CA98, 37353943605399816, 89401717, 89401719, 2, 640x360 
0x1382CA98, 37353943605713856, 89401751, 89401756, 5, 640x360 
0x1382CA98, 37353943606033912, 89401782, 89401784, 2, 640x360 
0x1382CA98, 37353943606365488, 89401817, 89401819, 2, 640x360 
0x1382CA98, 37353943606674400, 89401853, 89401856, 3, 640x360 
0x1382CA98, 37353943606995176, 89401876, 89401881, 5, 640x360 
0x1382CA98, 37353943607313728, 89401913, 89401919, 6, 640x360 
0x1382CA98, 37353943607635088, 89401945, 89401953, 8, 640x360 
0x1382CA98, 37353943607953936, 89401975, 89401978, 3, 640x360 
0x1382CA98, 37353943608433008, 89402026, 89402028, 2, 640x360 
0x1382CA98, 37353943608763560, 89402058, 89402066, 8, 640x360 
0x1382CA98, 37353943609100312, 89402094, 89402102, 8, 640x360 
0x1382CA98, 37353943609412072, 89402126, 89402129, 3, 640x360 
0x1382CA98, 37353943609717208, 89402158, 89402160, 2, 640x360 
0x1382CA98, 37353943610036880, 89402188, 89402205, 17, 640x360 
0x1382CA98, 37353943610366448, 89402223, 89402227, 4, 640x360 
0x1382CA98, 37353943610690912, 89402254, 89402257, 3, 640x360 
0x1382CA98, 37353943610993376, 89402290, 89402299, 9, 640x360 
0x1382CA98, 37353943611322904, 89402313, 89402321, 8, 640x360 
0x1382CA98, 37353943611634368, 89402347, 89402351, 4, 640x360 
0x1382CA98, 37353943611958808, 89402389, 89402393, 4, 640x360 
0x1382CA98, 37353943612433192, 89402426, 89402429, 3, 640x360 
0x1382CA98, 37353943612752840, 89402454, 89402462, 8, 640x360 
0x1382CA98, 37353943613082320, 89402497, 89402499, 2, 640x360 
0x1382CA98, 37353943613412504, 89402525, 89402528, 3, 640x360 
0x1382CA98, 37353943613716680, 89402554, 89402559, 5, 640x360 
0x1382CA98, 37353943614033672, 89402586, 89402597, 11, 640x360 
0x1382CA98, 37353943614353560, 89402628, 89402636, 8, 640x360 
0x1382CA98, 37353943614686056, 89402667, 89402670, 3, 640x360 
0x1382CA98, 37353943614996544, 89402692, 89402713, 21, 640x360 
0x1382CA98, 37353943615353280, 89402732, 89402744, 12, 640x360 
0x1382CA98, 37353943615646040, 89402767, 89402780, 13, 640x360 
0x1382CA98, 37353943615959632, 89402801, 89402813, 12, 640x360 
0x1382CA98, 37353943616457736, 89402853, 89402874, 21, 640x360 
0x1382CA98, 37353943616769416, 89402875, 89402882, 7, 640x360 
0x1382CA98, 37353943617091720, 89402913, 89402927, 14, 640x360 
0x1382CA98, 37353943617433856, 89402939, 89402942, 3, 640x360 
0x1382CA98, 37353943617719576, 89402965, 89402967, 2, 640x360 
0x1382CA98, 37353943618033832, 89402991, 89403002, 11, 640x360 
0x1382CA98, 37353943618377040, 89403043, 89403053, 10, 640x360 
0x1382CA98, 37353943618706656, 89403069, 89403077, 8, 640x360 
0x1382CA98, 37353943618998000, 89403086, 89403106, 20, 640x360 
0x1382CA98, 37353943619312872, 89403128, 89403132, 4, 640x360 
0x1382CA98, 37353943619665056, 89403152, 89403155, 3, 640x360 
0x1382CA98, 37353943619959616, 89403187, 89403192, 5, 640x360 
0x1382CA98, 37353943620441928, 89403222, 89403227, 5, 640x360 
0x1382CA98, 37353943620761592, 89403254, 89403268, 14, 640x360 
0x1382CA98, 37353943621088280, 89403286, 89403291, 5, 640x360 
0x1382CA98, 37353943621400232, 89403324, 89403331, 7, 640x360 
0x1382CA98, 37353943621712384, 89403355, 89403361, 6, 640x360 
0x1382CA98, 37353943622033368, 89403391, 89403394, 3, 640x360 
0x1382CA98, 37353943622359352, 89403415, 89403417, 2, 640x360 
0x1382CA98, 37353943622675584, 89403453, 89403458, 5, 640x360 
0x1382CA98, 37353943623008600, 89403480, 89403482, 2, 640x360 
0x1382CA98, 37353943623314584, 89403515, 89403518, 3, 640x360 
0x1382CA98, 37353943623636784, 89403554, 89403559, 5, 640x360 
0x1382CA98, 37353943623953680, 89403594, 89403597, 3, 640x360 
0x1382CA98, 37353943624437632, 89403628, 89403633, 5, 640x360 
0x1382CA98, 37353943624781536, 89403662, 89403669, 7, 640x360 
0x1382CA98, 37353943625098968, 89403687, 89403691, 4, 640x360 
0x1382CA98, 37353943625399448, 89403724, 89403733, 9, 640x360 
0x1382CA98, 37353943625713232, 89403750, 89403753, 3, 640x360 
0x1382CA98, 37353943626032496, 89403788, 89403793, 5, 640x360 
0x1382CA98, 37353943626363728, 89403817, 89403819, 2, 640x360 
0x1382CA98, 37353943626676736, 89403844, 89403853, 9, 640x360 
0x1382CA98, 37353943626997648, 89403879, 89403882, 3, 640x360 
0x1382CA98, 37353943627316696, 89403920, 89403932, 12, 640x360 
0x1382CA98, 37353943627636488, 89403948, 89403956, 8, 640x360 
0x1382CA98, 37353943627955736, 89403986, 89403993, 7, 640x360 
0x1382CA98, 37353943628274576, 89404009, 89404017, 8, 640x360 
0x1382CA98, 37353943628764600, 89404056, 89404059, 3, 640x360 
0x1382CA98, 37353943629103952, 89404091, 89404095, 4, 640x360 
0x1382CA98, 37353943629422504, 89404120, 89404141, 21, 640x360 
0x1382CA98, 37353943629743496, 89404154, 89404157, 3, 640x360 
0x1382CA98, 37353943630049928, 89404196, 89404199, 3, 640x360 
0x1382CA98, 37353943630353296, 89404220, 89404236, 16, 640x360 
0x1382CA98, 37353943630714800, 89404258, 89404269, 11, 640x360 
0x1382CA98, 37353943630993560, 89404285, 89404289, 4, 640x360 
0x1382CA98, 37353943631331304, 89404318, 89404320, 2, 640x360 
0x1382CA98, 37353943631649424, 89404345, 89404348, 3, 640x360 
0x1382CA98, 37353943631964600, 89404383, 89404385, 2, 640x360 
0x1382CA98, 37353943632354376, 89404419, 89404425, 6, 640x360 
0x1382CA98, 37353943632764184, 89404456, 89404465, 9, 640x360 
0x1382CA98, 37353943633091968, 89404485, 89404492, 7, 640x360 
0x1382CA98, 37353943633392920, 89404518, 89404521, 3, 640x360 
0x1382CA98, 37353943633712160, 89404547, 89404549, 2, 640x360 
0x1382CA98, 37353943634032072, 89404584, 89404586, 2, 640x360 
0x1382CA98, 37353943634356360, 89404621, 89404632, 11, 640x360 
0x1382CA98, 37353943634674176, 89404645, 89404648, 3, 640x360 
0x1382CA98, 37353943634992464, 89404679, 89404688, 9, 640x360 
0x1382CA98, 37353943635317200, 89404720, 89404725, 5, 640x360 
0x1382CA98, 37353943635639656, 89404754, 89404759, 5, 640x360 
0x1382CA98, 37353943635959792, 89404780, 89404782, 2, 640x360 
0x1382CA98, 37353943636272512, 89404806, 89404811, 5, 640x360 
0x1382CA98, 37353943636757440, 89404859, 89404862, 3, 640x360 
0x1382CA98, 37353943637074584, 89404891, 89404894, 3, 640x360 
0x1382CA98, 37353943637397280, 89404919, 89404924, 5, 640x360 
0x1382CA98, 37353943637712496, 89404958, 89404961, 3, 640x360 
0x1382CA98, 37353943638044512, 89404984, 89404986, 2, 640x360 
0x1382CA98, 37353943638352584, 89405019, 89405023, 4, 640x360 
0x1382CA98, 37353943638677976, 89405055, 89405059, 4, 640x360 
0x1382CA98, 37353943638994864, 89405078, 89405082, 4, 640x360 
0x1382CA98, 37353943639317112, 89405114, 89405116, 2, 640x360 
0x1382CA98, 37353943639639544, 89405146, 89405153, 7, 640x360 
0x1382CA98, 37353943639957984, 89405189, 89405193, 4, 640x360 
0x1382CA98, 37353943640273696, 89405208, 89405217, 9, 640x360 
0x1382CA98, 37353943640758664, 89405260, 89405267, 7, 640x360 
0x1382CA98, 37353943641082880, 89405295, 89405301, 6, 640x360 
0x1382CA98, 37353943641398552, 89405329, 89405335, 6, 640x360 
0x1382CA98, 37353943641712408, 89405360, 89405363, 3, 640x360 
0x1382CA98, 37353943642043064, 89405397, 89405399, 2, 640x360 
0x1382CA98, 37353943642352880, 89405422, 89405427, 5, 640x360 
0x1382CA98, 37353943642672464, 89405446, 89405452, 6, 640x360 
0x1382CA98, 37353943642995888, 89405477, 89405485, 8, 640x360 
0x1382CA98, 37353943643311984, 89405510, 89405512, 2, 640x360 
0x1382CA98, 37353943643632216, 89405538, 89405552, 14, 640x360 
0x1382CA98, 37353943643952768, 89405574, 89405583, 9, 640x360 
0x1382CA98, 37353943644272608, 89405609, 89405619, 10, 640x360 
0x1382CA98, 37353943644754712, 89405653, 89405659, 6, 640x360 
0x1382CA98, 37353943645071680, 89405681, 89405683, 2, 640x360 
0x1382CA98, 37353943645412336, 89405726, 89405728, 2, 640x360 
0x1382CA98, 37353943645712768, 89405754, 89405758, 4, 640x360 
0x1382CA98, 37353943646032456, 89405786, 89405793, 7, 640x360 
0x1382CA98, 37353943646355896, 89405821, 89405828, 7, 640x360 
0x1382CA98, 37353943646680264, 89405846, 89405852, 6, 640x360 
0x1382CA98, 37353943646992744, 89405878, 89405886, 8, 640x360 
0x1382CA98, 37353943647312288, 89405912, 89405914, 2, 640x360 
0x1382CA98, 37353943647635824, 89405940, 89405943, 3, 640x360 
0x1382CA98, 37353943647953320, 89405970, 89405977, 7, 640x360 
0x1382CA98, 37353943648275816, 89406010, 89406017, 7, 640x360 
0x1382CA98, 37353943648765224, 89406055, 89406060, 5, 640x360 
0x1382CA98, 37353943649076680, 89406087, 89406090, 3, 640x360 
0x1382CA98, 37353943649392904, 89406116, 89406119, 3, 640x360 
0x1382CA98, 37353943649712576, 89406150, 89406154, 4, 640x360 
0x1382CA98, 37353943650034968, 89406181, 89406184, 3, 640x360 
0x1382CA98, 37353943650356752, 89406213, 89406223, 10, 640x360 
0x1382CA98, 37353943650678168, 89406249, 89406251, 2, 640x360 
0x1382CA98, 37353943650992592, 89406283, 89406288, 5, 640x360 
0x1382CA98, 37353943651317880, 89406312, 89406315, 3, 640x360 
0x1382CA98, 37353943651632744, 89406340, 89406345, 5, 640x360 
0x1382CA98, 37353943651959192, 89406384, 89406386, 2, 640x360 
0x1382CA98, 37353943652276616, 89406410, 89406413, 3, 640x360 
0x1382CA98, 37353943652593528, 89406436, 89406443, 7, 640x360 
0x1382CA98, 37353943653074176, 89406485, 89406490, 5, 640x360 
0x1382CA98, 37353943653398696, 89406516, 89406518, 2, 640x360 
0x1382CA98, 37353943653715424, 89406552, 89406559, 7, 640x360 
0x1382CA98, 37353943654035904, 89406586, 89406590, 4, 640x360 
0x1382CA98, 37353943654355608, 89406613, 89406615, 2, 640x360 
0x1382CA98, 37353943654679064, 89406655, 89406666, 11, 640x360 
0x1382CA98, 37353943654994632, 89406683, 89406684, 1, 640x360 
0x1382CA98, 37353943655332928, 89406716, 89406717, 1, 640x360 
0x1382CA98, 37353943655638360, 89406755, 89406773, 18, 640x360 
0x1382CA98, 37353943655953608, 89406789, 89406791, 2, 640x360 
0x1382CA98, 37353943656278096, 89406811, 89406814, 3, 640x360 
0x1382CA98, 37353943656593960, 89406844, 89406847, 3, 640x360 
0x1382CA98, 37353943657088560, 89406892, 89406894, 2, 640x360 
0x1382CA98, 37353943657395240, 89406924, 89406929, 5, 640x360 
0x1382CA98, 37353943657711400, 89406954, 89406959, 5, 640x360 
0x1382CA98, 37353943658031584, 89406985, 89406987, 2, 640x360 
0x1382CA98, 37353943658355528, 89407018, 89407019, 1, 640x360 
0x1382CA98, 37353943658680112, 89407045, 89407048, 3, 640x360 
0x1382CA98, 37353943658995424, 89407081, 89407089, 8, 640x360 
0x1382CA98, 37353943659313192, 89407113, 89407120, 7, 640x360 
0x1382CA98, 37353943659633328, 89407144, 89407147, 3, 640x360 
0x1382CA98, 37353943659965096, 89407191, 89407198, 7, 640x360 
0x1382CA98, 37353943660277592, 89407210, 89407220, 10, 640x360 
0x1382CA98, 37353943660593200, 89407245, 89407247, 2, 640x360 
0x1382CA98, 37353943661090048, 89407289, 89407293, 4, 640x360 
0x1382CA98, 37353943661393336, 89407318, 89407320, 2, 640x360 
0x1382CA98, 37353943661711448, 89407346, 89407349, 3, 640x360 
0x1382CA98, 37353943662031616, 89407384, 89407386, 2, 640x360 
0x1382CA98, 37353943662356176, 89407413, 89407418, 5, 640x360 
0x1382CA98, 37353943662676584, 89407453, 89407456, 3, 640x360 
0x1382CA98, 37353943662993168, 89407480, 89407486, 6, 640x360 
0x1382CA98, 37353943663312032, 89407511, 89407519, 8, 640x360 
0x1382CA98, 37353943663633624, 89407540, 89407544, 4, 640x360 
0x1382CA98, 37353943663952824, 89407576, 89407579, 3, 640x360 
0x1382CA98, 37353943664301520, 89407619, 89407622, 3, 640x360 
0x1382CA98, 37353943664600136, 89407653, 89407657, 4, 640x360 
0x1382CA98, 37353943665074752, 89407693, 89407701, 8, 640x360 
0x1382CA98, 37353943665396480, 89407719, 89407723, 4, 640x360 
0x1382CA98, 37353943665711152, 89407758, 89407761, 3, 640x360 
0x1382CA98, 37353943666031240, 89407781, 89407784, 3, 640x360 
0x1382CA98, 37353943666355272, 89407821, 89407831, 10, 640x360 
0x1382CA98, 37353943666672680, 89407853, 89407855, 2, 640x360 
0x1382CA98, 37353943667005512, 89407880, 89407882, 2, 640x360 
0x1382CA98, 37353943667327064, 89407919, 89407922, 3, 640x360 
0x1382CA98, 37353943667660776, 89407949, 89407951, 2, 640x360 
0x1382CA98, 37353943667972784, 89407979, 89407982, 3, 640x360 
0x1382CA98, 37353943668290920, 89408015, 89408016, 1, 640x360 
0x1382CA98, 37353943668600696, 89408038, 89408046, 8, 640x360 
0x1382CA98, 37353943669079824, 89408087, 89408094, 7, 640x360 
0x1382CA98, 37353943669400080, 89408122, 89408133, 11, 640x360 
0x1382CA98, 37353943669712104, 89408156, 89408167, 11, 640x360 
0x1382CA98, 37353943670035432, 89408182, 89408185, 3, 640x360 
0x1382CA98, 37353943670354968, 89408216, 89408218, 2, 640x360 
0x1382CA98, 37353943670675680, 89408249, 89408251, 2, 640x360 
0x1382CA98, 37353943670994544, 89408290, 89408294, 4, 640x360 
0x1382CA98, 37353943671313192, 89408313, 89408315, 2, 640x360 
0x1382CA98, 37353943671634000, 89408342, 89408344, 2, 640x360 
0x1382CA98, 37353943671955264, 89408380, 89408382, 2, 640x360 
0x1382CA98, 37353943672273880, 89408409, 89408417, 8, 640x360 
0x1382CA98, 37353943672602976, 89408437, 89408443, 6, 640x360 
0x1382CA98, 37353943673073672, 89408490, 89408493, 3, 640x360 
0x1382CA98, 37353943673396480, 89408518, 89408522, 4, 640x360 
0x1382CA98, 37353943673711984, 89408551, 89408557, 6, 640x360 
0x1382CA98, 37353943674035672, 89408585, 89408589, 4, 640x360 
0x1382CA98, 37353943674351304, 89408614, 89408617, 3, 640x360 
0x1382CA98, 37353943674675216, 89408655, 89408659, 4, 640x360 
0x1382CA98, 37353943674991512, 89408678, 89408681, 3, 640x360 
0x1382CA98, 37353943675311992, 89408711, 89408719, 8, 640x360 
0x1382CA98, 37353943675631712, 89408744, 89408746, 2, 640x360 
0x1382CA98, 37353943675956272, 89408774, 89408777, 3, 640x360 
0x1382CA98, 37353943676271880, 89408810, 89408812, 2, 640x360 
0x1382CA98, 37353943676598184, 89408836, 89408839, 3, 640x360 
0x1382CA98, 37353943677073680, 89408882, 89408884, 2, 640x360 
0x1382CA98, 37353943677391464, 89408913, 89408915, 2, 640x360 
0x1382CA98, 37353943677711840, 89408945, 89408947, 2, 640x360 
0x1382CA98, 37353943678033424, 89408982, 89408985, 3, 640x360 
0x1382CA98, 37353943678351720, 89409024, 89409027, 3, 640x360 
0x1382CA98, 37353943678676360, 89409058, 89409061, 3, 640x360 
0x1382CA98, 37353943678992176, 89409083, 89409091, 8, 640x360 
0x1382CA98, 37353943679312192, 89409118, 89409120, 2, 640x360 
0x1382CA98, 37353943679631656, 89409145, 89409155, 10, 640x360 
0x1382CA98, 37353943679955336, 89409176, 89409186, 10, 640x360 
0x1382CA98, 37353943680277680, 89409213, 89409215, 2, 640x360 
0x1382CA98, 37353943680591648, 89409244, 89409253, 9, 640x360 
0x1382CA98, 37353943680922192, 89409277, 89409280, 3, 640x360 
0x1382CA98, 37353943681394872, 89409324, 89409327, 3, 640x360 
0x1382CA98, 37353943681711288, 89409352, 89409354, 2, 640x360 
0x1382CA98, 37353943682031008, 89409387, 89409389, 2, 640x360 
0x1382CA98, 37353943682350880, 89409412, 89409414, 2, 640x360 
0x1382CA98, 37353943682678264, 89409451, 89409453, 2, 640x360 
0x1382CA98, 37353943683001072, 89409481, 89409484, 3, 640x360 
0x1382CA98, 37353943683315496, 89409513, 89409516, 3, 640x360 
0x1382CA98, 37353943683635768, 89409544, 89409546, 2, 640x360 
0x1382CA98, 37353943683952168, 89409580, 89409582, 2, 640x360 
0x1382CA98, 37353943684273128, 89409603, 89409608, 5, 640x360 
0x1382CA98, 37353943684592240, 89409641, 89409644, 3, 640x360 
0x1382CA98, 37353943684911320, 89409681, 89409683, 2, 640x360 
0x1382CA98, 37353943685399544, 89409727, 89409729, 2, 640x360 
0x1382CA98, 37353943685716888, 89409769, 89409796, 27, 640x360 
0x1382CA98, 37353943686040464, 89409806, 89409815, 9, 640x360 
0x1382CA98, 37353943686359944, 89409829, 89409834, 5, 640x360 
0x1382CA98, 37353943686687520, 89409861, 89409863, 2, 640x360 
0x1382CA98, 37353943686991704, 89409882, 89409885, 3, 640x360 
0x1382CA98, 37353943687312024, 89409908, 89409910, 2, 640x360 
0x1382CA98, 37353943687634904, 89409946, 89409947, 1, 640x360 
0x1382CA98, 37353943687957256, 89409976, 89409981, 5, 640x360 
0x1382CA98, 37353943688276600, 89410004, 89410009, 5, 640x360 
0x1382CA98, 37353943688597000, 89410036, 89410041, 5, 640x360 
0x1382CA98, 37353943688929872, 89410071, 89410075, 4, 640x360 
0x1382CA98, 37353943689403728, 89410118, 89410120, 2, 640x360 
0x1382CA98, 37353943689711128, 89410153, 89410160, 7, 640x360 
0x1382CA98, 37353943690031416, 89410195, 89410197, 2, 640x360 
0x1382CA98, 37353943690351952, 89410227, 89410237, 10, 640x360 
0x1382CA98, 37353943690685976, 89410260, 89410269, 9, 640x360 
0x1382CA98, 37353943690990920, 89410283, 89410284, 1, 640x360 
0x1382CA98, 37353943691314736, 89410314, 89410322, 8, 640x360 
0x1382CA98, 37353943691635040, 89410348, 89410350, 2, 640x360 
0x1382CA98, 37353943691961616, 89410384, 89410385, 1, 640x360 
0x1382CA98, 37353943692271200, 89410411, 89410414, 3, 640x360 
0x1382CA98, 37353943692595928, 89410444, 89410450, 6, 640x360 
0x1382CA98, 37353943692918848, 89410471, 89410473, 2, 640x360 
0x1382CA98, 37353943693396280, 89410524, 89410532, 8, 640x360 
0x1382CA98, 37353943693715184, 89410552, 89410555, 3, 640x360 
0x1382CA98, 37353943694031424, 89410593, 89410595, 2, 640x360 
0x1382CA98, 37353943694351072, 89410626, 89410628, 2, 640x360 
0x1382CA98, 37353943694674816, 89410652, 89410653, 1, 640x360 
0x1382CA98, 37353943694990616, 89410679, 89410685, 6, 640x360 
0x1382CA98, 37353943695311496, 89410715, 89410717, 2, 640x360 
0x1382CA98, 37353943695631464, 89410738, 89410743, 5, 640x360 
0x1382CA98, 37353943695951304, 89410774, 89410778, 4, 640x360 
0x1382CA98, 37353943696271432, 89410808, 89410811, 3, 640x360 
0x1382CA98, 37353943696595216, 89410838, 89410843, 5, 640x360 
0x1382CA98, 37353943696917592, 89410869, 89410872, 3, 640x360 
0x1382CA98, 37353943697400464, 89410921, 89410926, 5, 640x360 
0x1382CA98, 37353943697718064, 89410961, 89410963, 2, 640x360 
0x1382CA98, 37353943698031248, 89410995, 89410998, 3, 640x360 
0x1382CA98, 37353943698351144, 89411020, 89411023, 3, 640x360 
0x1382CA98, 37353943698670800, 89411047, 89411053, 6, 640x360 
0x1382CA98, 37353943698990480, 89411082, 89411084, 2, 640x360 
0x1382CA98, 37353943699314464, 89411110, 89411113, 3, 640x360 
0x1382CA98, 37353943699635928, 89411149, 89411151, 2, 640x360 
0x1382CA98, 37353943699951008, 89411176, 89411183, 7, 640x360 
0x1382CA98, 37353943700270728, 89411207, 89411214, 7, 640x360 
0x1382CA98, 37353943700592312, 89411237, 89411242, 5, 640x360 
0x1382CA98, 37353943700930424, 89411274, 89411281, 7, 640x360 
0x1382CA98, 37353943701396552, 89411322, 89411326, 4, 640x360 
0x1382CA98, 37353943701716520, 89411348, 89411352, 4, 640x360 
0x1382CA98, 37353943702031200, 89411382, 89411386, 4, 640x360 
0x1382CA98, 37353943702350856, 89411413, 89411415, 2, 640x360 
0x1382CA98, 37353943702677208, 89411450, 89411453, 3, 640x360 
0x1382CA98, 37353943702991272, 89411485, 89411487, 2, 640x360 
0x1382CA98, 37353943703311176, 89411516, 89411524, 8, 640x360 
0x1382CA98, 37353943703631968, 89411547, 89411553, 6, 640x360 
0x1382CA98, 37353943703951552, 89411574, 89411581, 7, 640x360 
0x1382CA98, 37353943704296304, 89411615, 89411624, 9, 640x360 
0x1382CA98, 37353943704629352, 89411646, 89411648, 2, 640x360 
0x1382CA98, 37353943704919432, 89411672, 89411683, 11, 640x360 
0x1382CA98, 37353943705390072, 89411721, 89411724, 3, 640x360 
0x1382CA98, 37353943705711152, 89411755, 89411761, 6, 640x360 
0x1382CA98, 37353943706035616, 89411784, 89411787, 3, 640x360 
0x1382CA98, 37353943706350592, 89411814, 89411817, 3, 640x360 
0x1382CA98, 37353943706676864, 89411846, 89411849, 3, 640x360 
0x1382CA98, 37353943706992344, 89411881, 89411883, 2, 640x360 
0x1382CA98, 37353943707311472, 89411915, 89411917, 2, 640x360 
0x1382CA98, 37353943707640624, 89411947, 89411949, 2, 640x360 
0x1382CA98, 37353943707965408, 89411981, 89411983, 2, 640x360 
0x1382CA98, 37353943708282232, 89412014, 89412016, 2, 640x360 
0x1382CA98, 37353943708610704, 89412049, 89412051, 2, 640x360 
0x1382CA98, 37353943708918376, 89412074, 89412079, 5, 640x360 
0x1382CA98, 37353943709237216, 89412107, 89412111, 4, 640x360 
0x1382CA98, 37353943709710928, 89412159, 89412163, 4, 640x360 
0x1382CA98, 37353943710030696, 89412188, 89412193, 5, 640x360 
0x1382CA98, 37353943710354440, 89412222, 89412227, 5, 640x360 
0x1382CA98, 37353943710671760, 89412245, 89412253, 8, 640x360 
0x1382CA98, 37353943710990768, 89412282, 89412287, 5, 640x360 
0x1382CA98, 37353943711311080, 89412315, 89412321, 6, 640x360 
0x1382CA98, 37353943711636664, 89412341, 89412344, 3, 640x360 
0x1382CA98, 37353943711956464, 89412380, 89412382, 2, 640x360 
0x1382CA98, 37353943712274360, 89412408, 89412411, 3, 640x360 
0x1382CA98, 37353943712604000, 89412436, 89412439, 3, 640x360 
0x1382CA98, 37353943712920968, 89412473, 89412482, 9, 640x360 
0x1382CA98, 37353943713234008, 89412503, 89412506, 3, 640x360 
0x1382CA98, 37353943713710128, 89412551, 89412554, 3, 640x360 
0x1382CA98, 37353943714030248, 89412583, 89412590, 7, 640x360 
0x1382CA98, 37353943714355104, 89412615, 89412617, 2, 640x360 
0x1382CA98, 37353943714673272, 89412647, 89412650, 3, 640x360 
0x1382CA98, 37353943714991584, 89412682, 89412684, 2, 640x360 
0x1382CA98, 37353943715320728, 89412715, 89412717, 2, 640x360 
0x1382CA98, 37353943715647056, 89412745, 89412748, 3, 640x360 
0x1382CA98, 37353943715987296, 89412783, 89412785, 2, 640x360 
0x1382CA98, 37353943716320896, 89412813, 89412816, 3, 640x360 
0x1382CA98, 37353943716597752, 89412848, 89412849, 1, 640x360 
0x1382CA98, 37353943716923112, 89412881, 89412883, 2, 640x360 
0x1382CA98, 37353943717247576, 89412914, 89412917, 3, 640x360 
0x1382CA98, 37353943717709680, 89412961, 89412963, 2, 640x360 
0x1382CA98, 37353943718029920, 89412991, 89412994, 3, 640x360 
0x1382CA98, 37353943718353920, 89413024, 89413027, 3, 640x360 
0x1382CA98, 37353943718675032, 89413051, 89413059, 8, 640x360 
0x1382CA98, 37353943718989808, 89413082, 89413088, 6, 640x360 
0x1382CA98, 37353943719310016, 89413108, 89413111, 3, 640x360 
0x1382CA98, 37353943719629904, 89413141, 89413146, 5, 640x360 
0x1382CA98, 37353943719958528, 89413182, 89413188, 6, 640x360 
0x1382CA98, 37353943720270896, 89413203, 89413207, 4, 640x360 
0x1382CA98, 37353943720596992, 89413237, 89413241, 4, 640x360 
0x1382CA98, 37353943720923440, 89413273, 89413275, 2, 640x360 
0x1382CA98, 37353943721234064, 89413301, 89413303, 2, 640x360 
0x1382CA98, 37353943721709512, 89413354, 89413360, 6, 640x360 
0x1382CA98, 37353943722032128, 89413382, 89413384, 2, 640x360 
0x1382CA98, 37353943722359040, 89413422, 89413425, 3, 640x360 
0x1382CA98, 37353943722670600, 89413446, 89413449, 3, 640x360 
0x1382CA98, 37353943722993840, 89413482, 89413489, 7, 640x360 
0x1382CA98, 37353943723315832, 89413514, 89413522, 8, 640x360 
0x1382CA98, 37353943723630840, 89413541, 89413544, 3, 640x360 
0x1382CA98, 37353943723955008, 89413576, 89413578, 2, 640x360 
0x1382CA98, 37353943724274576, 89413607, 89413610, 3, 640x360 
0x1382CA98, 37353943724594944, 89413638, 89413641, 3, 640x360 
0x1382CA98, 37353943724920208, 89413669, 89413675, 6, 640x360 
0x1382CA98, 37353943725232952, 89413707, 89413716, 9, 640x360 
0x1382CA98, 37353943725709760, 89413748, 89413750, 2, 640x360 
0x1382CA98, 37353943726030224, 89413791, 89413794, 3, 640x360 
0x1382CA98, 37353943726354336, 89413823, 89413831, 8, 640x360 
0x1382CA98, 37353943726673928, 89413845, 89413851, 6, 640x360 
0x1382CA98, 37353943726994152, 89413877, 89413884, 7, 640x360 
0x1382CA98, 37353943727318920, 89413910, 89413915, 5, 640x360 
0x1382CA98, 37353943727639272, 89413947, 89413954, 7, 640x360 
0x1382CA98, 37353943727950272, 89413985, 89413992, 7, 640x360 
0x1382CA98, 37353943728286024, 89414014, 89414016, 2, 640x360 
0x1382CA98, 37353943728600064, 89414055, 89414062, 7, 640x360 
0x1382CA98, 37353943728921192, 89414083, 89414085, 2, 640x360 
0x1382CA98, 37353943729245416, 89414105, 89414113, 8, 640x360 
0x1382CA98, 37353943729709752, 89414163, 89414166, 3, 640x360 
0x1382CA98, 37353943730032768, 89414195, 89414210, 15, 640x360 
0x1382CA98, 37353943730359440, 89414228, 89414231, 3, 640x360 
0x1382CA98, 37353943730669352, 89414252, 89414256, 4, 640x360 
0x1382CA98, 37353943730989408, 89414285, 89414287, 2, 640x360 
0x1382CA98, 37353943731309928, 89414315, 89414317, 2, 640x360 
0x1382CA98, 37353943731632832, 89414344, 89414348, 4, 640x360 
0x1382CA98, 37353943731954416, 89414391, 89414399, 8, 640x360 
0x1382CA98, 37353943732273144, 89414416, 89414418, 2, 640x360 
0x1382CA98, 37353943732603840, 89414453, 89414455, 2, 640x360 
0x1382CA98, 37353943732921400, 89414484, 89414486, 2, 640x360 
0x1382CA98, 37353943733242008, 89414510, 89414518, 8, 640x360 
0x1382CA98, 37353943733549760, 89414541, 89414545, 4, 640x360 
0x1382CA98, 37353943734029512, 89414584, 89414586, 2, 640x360 
0x1382CA98, 37353943734349248, 89414620, 89414624, 4, 640x360 
0x1382CA98, 37353943734670000, 89414647, 89414652, 5, 640x360 
0x1382CA98, 37353943734994824, 89414684, 89414686, 2, 640x360 
0x1382CA98, 37353943735312632, 89414715, 89414717, 2, 640x360 
0x1382CA98, 37353943735640072, 89414747, 89414753, 6, 640x360 
0x1382CA98, 37353943735950448, 89414781, 89414788, 7, 640x360 
0x1382CA98, 37353943736271600, 89414815, 89414818, 3, 640x360 
0x1382CA98, 37353943736593920, 89414858, 89414862, 4, 640x360 
0x1382CA98, 37353943736918536, 89414881, 89414894, 13, 640x360 
0x1382CA98, 37353943737287880, 89414915, 89414918, 3, 640x360 
0x1382CA98, 37353943737550808, 89414954, 89414962, 8, 640x360 
0x1382CA98, 37353943738038544, 89415015, 89415019, 4, 640x360 
0x1382CA98, 37353943738381880, 89415052, 89415059, 7, 640x360 
0x1382CA98, 37353943738686352, 89415060, 89415064, 4, 640x360 
0x1382CA98, 37353943738994528, 89415110, 89415121, 11, 640x360 
0x1382CA98, 37353943739327800, 89415132, 89415161, 29, 640x360 
0x1382CA98, 37353943739656320, 89415165, 89415203, 38, 640x360 
0x1382CA98, 37353943739964592, 89415217, 89415233, 16, 640x360 
0x1382CA98, 37353943740301240, 89415237, 89415266, 29, 640x360 
0x1382CA98, 37353943740611928, 89415267, 89415317, 50, 640x360 
0x1382CA98, 37353943740948120, 89415318, 89415378, 60, 640x360 
0x1382CA98, 37353943741278848, 89415380, 89415419, 39, 640x360 
0x1382CA98, 37353943742098744, 89415419, 89415441, 22, 640x360 
0x1382CA98, 37353943742381392, 89415449, 89415469, 20, 640x360 
0x1382CA98, 37353943742793960, 89415478, 89415489, 11, 640x360 
0x1382CA98, 37353943743024024, 89415501, 89415533, 32, 640x360 
0x1382CA98, 37353943743327584, 89415536, 89415566, 30, 640x360 
0x1382CA98, 37353943743677424, 89415567, 89415598, 31, 640x360 
0x1382CA98, 37353943743968984, 89415602, 89415611, 9, 640x360 
0x1382CA98, 37353943744297080, 89415623, 89415633, 10, 640x360 
0x1382CA98, 37353943744609224, 89415645, 89415655, 10, 640x360 
0x1382CA98, 37353943744914880, 89415680, 89415683, 3, 640x360 
0x1382CA98, 37353943745255448, 89415727, 89415730, 3, 640x360 
0x1382CA98, 37353943745596656, 89415748, 89415750, 2, 640x360 
0x1382CA98, 37353943746029280, 89415788, 89415793, 5, 640x360 
0x1382CA98, 37353943746353424, 89415826, 89415828, 2, 640x360 
0x1382CA98, 37353943746673432, 89415850, 89415852, 2, 640x360 
0x1382CA98, 37353943746994632, 89415894, 89415900, 6, 640x360 
0x1382CA98, 37353943747311456, 89415917, 89415919, 2, 640x360 
0x1382CA98, 37353943747674272, 89415960, 89415963, 3, 640x360 
0x1382CA98, 37353943747953544, 89415986, 89415994, 8, 640x360 
0x1382CA98, 37353943748289792, 89416028, 89416033, 5, 640x360 
0x1382CA98, 37353943748605008, 89416048, 89416050, 2, 640x360 
0x1382CA98, 37353943748985240, 89416083, 89416085, 2, 640x360 
0x1382CA98, 37353943749259984, 89416132, 89416141, 9, 640x360 
0x1382CA98, 37353943749556656, 89416157, 89416161, 4, 640x360 
0x1382CA98, 37353943750041624, 89416199, 89416201, 2, 640x360 
0x1382CA98, 37353943750350224, 89416222, 89416226, 4, 640x360 
0x1382CA98, 37353943750674536, 89416250, 89416257, 7, 640x360 
0x1382CA98, 37353943750993056, 89416286, 89416289, 3, 640x360 
0x1382CA98, 37353943751314024, 89416315, 89416317, 2, 640x360 
0x1382CA98, 37353943751634152, 89416344, 89416352, 8, 640x360 
0x1382CA98, 37353943751949344, 89416387, 89416389, 2, 640x360 
0x1382CA98, 37353943752269848, 89416408, 89416411, 3, 640x360 
0x1382CA98, 37353943752597928, 89416447, 89416456, 9, 640x360 
0x1382CA98, 37353943752910064, 89416469, 89416472, 3, 640x360 
0x1382CA98, 37353943753229368, 89416505, 89416510, 5, 640x360 
0x1382CA98, 37353943753569792, 89416537, 89416540, 3, 640x360 
0x1382CA98, 37353943754028624, 89416593, 89416595, 2, 640x360 
0x1382CA98, 37353943754348680, 89416623, 89416626, 3, 640x360 
0x1382CA98, 37353943754673752, 89416646, 89416649, 3, 640x360 
0x1382CA98, 37353943754998360, 89416687, 89416693, 6, 640x360 
0x1382CA98, 37353943755313264, 89416715, 89416717, 2, 640x360 
0x1382CA98, 37353943755632744, 89416747, 89416753, 6, 640x360 
0x1382CA98, 37353943755950184, 89416773, 89416776, 3, 640x360 
0x1382CA98, 37353943756274336, 89416804, 89416810, 6, 640x360 
0x1382CA98, 37353943756589840, 89416834, 89416837, 3, 640x360 
0x1382CA98, 37353943756915408, 89416870, 89416881, 11, 640x360 
0x1382CA98, 37353943757229896, 89416901, 89416903, 2, 640x360 
0x1382CA98, 37353943757550912, 89416936, 89416938, 2, 640x360 
0x1382CA98, 37353943758029496, 89416983, 89416986, 3, 640x360 
0x1382CA98, 37353943758354752, 89417014, 89417017, 3, 640x360 
0x1382CA98, 37353943758681760, 89417052, 89417056, 4, 640x360 
0x1382CA98, 37353943758992352, 89417086, 89417093, 7, 640x360 
0x1382CA98, 37353943759309616, 89417126, 89417128, 2, 640x360 
0x1382CA98, 37353943759629584, 89417153, 89417160, 7, 640x360 
0x1382CA98, 37353943759950816, 89417187, 89417190, 3, 640x360 
0x1382CA98, 37353943760275760, 89417218, 89417219, 1, 640x360 
0x1382CA98, 37353943760606952, 89417253, 89417256, 3, 640x360 
0x1382CA98, 37353943760920008, 89417279, 89417281, 2, 640x360 
0x1382CA98, 37353943761234680, 89417319, 89417322, 3, 640x360 
0x1382CA98, 37353943761550496, 89417343, 89417346, 3, 640x360 
0x1382CA98, 37353943761875072, 89417373, 89417377, 4, 640x360 
0x1382CA98, 37353943762350952, 89417415, 89417421, 6, 640x360 
0x1382CA98, 37353943762670736, 89417447, 89417450, 3, 640x360 
0x1382CA98, 37353943762994176, 89417480, 89417483, 3, 640x360 
0x1382CA98, 37353943763315928, 89417514, 89417520, 6, 640x360 
0x1382CA98, 37353943763633640, 89417547, 89417549, 2, 640x360 
0x1382CA98, 37353943763954376, 89417580, 89417582, 2, 640x360 
0x1382CA98, 37353943764272456, 89417615, 89417618, 3, 640x360 
0x1382CA98, 37353943764598768, 89417638, 89417643, 5, 640x360 
0x1382CA98, 37353943764913824, 89417669, 89417672, 3, 640x360 
0x1382CA98, 37353943765239224, 89417710, 89417713, 3, 640x360 
0x1382CA98, 37353943765558816, 89417735, 89417738, 3, 640x360 
0x1382CA98, 37353943765870512, 89417768, 89417774, 6, 640x360 
0x1382CA98, 37353943766352976, 89417816, 89417821, 5, 640x360 
0x1382CA98, 37353943766668824, 89417854, 89417856, 2, 640x360 
0x1382CA98, 37353943766992328, 89417887, 89417890, 3, 640x360 
0x1382CA98, 37353943767312680, 89417921, 89417926, 5, 640x360 
0x1382CA98, 37353943767629048, 89417947, 89417949, 2, 640x360 
0x1382CA98, 37353943767949392, 89417976, 89417985, 9, 640x360 
0x1382CA98, 37353943768269648, 89418011, 89418018, 7, 640x360 
0x1382CA98, 37353943768596360, 89418042, 89418051, 9, 640x360 
0x1382CA98, 37353943768931696, 89418069, 89418074, 5, 640x360 
0x1382CA98, 37353943769257392, 89418104, 89418115, 11, 640x360 
0x1382CA98, 37353943769551704, 89418135, 89418139, 4, 640x360 
0x1382CA98, 37353943769869080, 89418169, 89418171, 2, 640x360 
0x1382CA98, 37353943770348456, 89418240, 89418248, 8, 640x360 
0x1382CA98, 37353943770686984, 89418261, 89418275, 14, 640x360 
0x1382CA98, 37353943771020048, 89418285, 89418291, 6, 640x360 
0x1382CA98, 37353943771352224, 89418323, 89418325, 2, 640x360 
0x1382CA98, 37353943771632720, 89418343, 89418347, 4, 640x360 
0x1382CA98, 37353943771949840, 89418374, 89418384, 10, 640x360 
0x1382CA98, 37353943772276104, 89418409, 89418412, 3, 640x360 
0x1382CA98, 37353943772605416, 89418442, 89418448, 6, 640x360 
0x1382CA98, 37353943772926232, 89418470, 89418484, 14, 640x360 
0x1382CA98, 37353943773242496, 89418510, 89418517, 7, 640x360 
0x1382CA98, 37353943773548688, 89418536, 89418542, 6, 640x360 
0x1382CA98, 37353943773872880, 89418570, 89418573, 3, 640x360 
0x1382CA98, 37353943774348336, 89418625, 89418627, 2, 640x360 
0x1382CA98, 37353943774669024, 89418645, 89418653, 8, 640x360 
0x1382CA98, 37353943774988528, 89418678, 89418680, 2, 640x360 
0x1382CA98, 37353943775309400, 89418712, 89418724, 12, 640x360 
0x1382CA98, 37353943775628768, 89418738, 89418743, 5, 640x360 
0x1382CA98, 37353943775951304, 89418778, 89418785, 7, 640x360 
0x1382CA98, 37353943776269296, 89418802, 89418804, 2, 640x360 
0x1382CA98, 37353943776594976, 89418834, 89418837, 3, 640x360 
0x1382CA98, 37353943776922688, 89418867, 89418870, 3, 640x360 
0x1382CA98, 37353943777230816, 89418900, 89418902, 2, 640x360 
0x1382CA98, 37353943777549192, 89418942, 89418944, 2, 640x360 
0x1382CA98, 37353943777872248, 89418969, 89418971, 2, 640x360 
0x1382CA98, 37353943778348448, 89419016, 89419018, 2, 640x360 
0x1382CA98, 37353943778669048, 89419043, 89419047, 4, 640x360 
0x1382CA98, 37353943778989232, 89419076, 89419079, 3, 640x360 
0x1382CA98, 37353943779309088, 89419114, 89419116, 2, 640x360 
0x1382CA98, 37353943779629080, 89419153, 89419155, 2, 640x360 
0x1382CA98, 37353943779950016, 89419179, 89419182, 3, 640x360 
0x1382CA98, 37353943780269344, 89419204, 89419209, 5, 640x360 
0x1382CA98, 37353943780589192, 89419235, 89419238, 3, 640x360 
0x1382CA98, 37353943780911400, 89419269, 89419272, 3, 640x360 
0x1382CA98, 37353943781229880, 89419304, 89419308, 4, 640x360 
0x1382CA98, 37353943781555664, 89419334, 89419337, 3, 640x360 
0x1382CA98, 37353943781874968, 89419368, 89419371, 3, 640x360 
0x1382CA98, 37353943782349120, 89419411, 89419414, 3, 640x360 
0x1382CA98, 37353943782669576, 89419446, 89419452, 6, 640x360 
0x1382CA98, 37353943782988816, 89419481, 89419493, 12, 640x360 
0x1382CA98, 37353943783309032, 89419511, 89419518, 7, 640x360 
0x1382CA98, 37353943783629280, 89419538, 89419542, 4, 640x360 
0x1382CA98, 37353943783948712, 89419570, 89419575, 5, 640x360 
0x1382CA98, 37353943784269176, 89419601, 89419603, 2, 640x360 
0x1382CA98, 37353943784595384, 89419637, 89419641, 4, 640x360 
0x1382CA98, 37353943784924656, 89419667, 89419669, 2, 640x360 
0x1382CA98, 37353943785229504, 89419706, 89419714, 8, 640x360 
0x1382CA98, 37353943785549184, 89419736, 89419740, 4, 640x360 
0x1382CA98, 37353943785869696, 89419763, 89419765, 2, 640x360 
0x1382CA98, 37353943786348336, 89419817, 89419820, 3, 640x360 
0x1382CA98, 37353943786672336, 89419846, 89419852, 6, 640x360 
0x1382CA98, 37353943786988832, 89419880, 89419886, 6, 640x360 
0x1382CA98, 37353943787312784, 89419911, 89419923, 12, 640x360 
0x1382CA98, 37353943787630280, 89419945, 89419948, 3, 640x360 
0x1382CA98, 37353943787948776, 89419971, 89419984, 13, 640x360 
0x1382CA98, 37353943788270600, 89420003, 89420007, 4, 640x360 
0x1382CA98, 37353943788598664, 89420041, 89420047, 6, 640x360 
0x1382CA98, 37353943788919520, 89420070, 89420081, 11, 640x360 
0x1382CA98, 37353943789273016, 89420108, 89420111, 3, 640x360 
0x1382CA98, 37353943789549304, 89420137, 89420143, 6, 640x360 
0x1382CA98, 37353943789868848, 89420163, 89420165, 2, 640x360 
0x1382CA98, 37353943790189432, 89420199, 89420202, 3, 640x360 
0x1382CA98, 37353943790672984, 89420246, 89420249, 3, 640x360 
0x1382CA98, 37353943790988528, 89420279, 89420285, 6, 640x360 
0x1382CA98, 37353943791309096, 89420308, 89420311, 3, 640x360 
0x1382CA98, 37353943791632520, 89420347, 89420354, 7, 640x360 
0x1382CA98, 37353943791948312, 89420375, 89420377, 2, 640x360 
0x1382CA98, 37353943792269224, 89420406, 89420411, 5, 640x360 
0x1382CA98, 37353943792595304, 89420436, 89420438, 2, 640x360 
0x1382CA98, 37353943792921400, 89420472, 89420482, 10, 640x360 
0x1382CA98, 37353943793229152, 89420503, 89420507, 4, 640x360 
0x1382CA98, 37353943793549024, 89420534, 89420536, 2, 640x360 
0x1382CA98, 37353943793869680, 89420567, 89420569, 2, 640x360 
0x1382CA98, 37353943794189840, 89420599, 89420601, 2, 640x360 
0x1382CA98, 37353943794668872, 89420646, 89420653, 7, 640x360 
0x1382CA98, 37353943794988992, 89420679, 89420681, 2, 640x360 
0x1382CA98, 37353943795309248, 89420711, 89420714, 3, 640x360 
0x1382CA98, 37353943795629008, 89420746, 89420748, 2, 640x360 
0x1382CA98, 37353943795952768, 89420776, 89420778, 2, 640x360 
0x1382CA98, 37353943796269304, 89420808, 89420815, 7, 640x360 
0x1382CA98, 37353943796591888, 89420839, 89420847, 8, 640x360 
0x1382CA98, 37353943796926504, 89420868, 89420873, 5, 640x360 
0x1382CA98, 37353943797234080, 89420901, 89420903, 2, 640x360 
0x1382CA98, 37353943797548968, 89420936, 89420939, 3, 640x360 
0x1382CA98, 37353943797869240, 89420963, 89420965, 2, 640x360 
0x1382CA98, 37353943798189168, 89420999, 89421001, 2, 640x360 
0x1382CA98, 37353943798669384, 89421042, 89421052, 10, 640x360 
0x1382CA98, 37353943798988312, 89421079, 89421085, 6, 640x360 
0x1382CA98, 37353943799310256, 89421113, 89421116, 3, 640x360 
0x1382CA98, 37353943799633024, 89421148, 89421150, 2, 640x360 
0x1382CA98, 37353943799954064, 89421173, 89421185, 12, 640x360 
0x1382CA98, 37353943800277896, 89421205, 89421215, 10, 640x360 
0x1382CA98, 37353943800602672, 89421235, 89421237, 2, 640x360 
0x1382CA98, 37353943800916360, 89421269, 89421272, 3, 640x360 
0x1382CA98, 37353943801228904, 89421301, 89421303, 2, 640x360 
0x1382CA98, 37353943801552416, 89421340, 89421342, 2, 640x360 
0x1382CA98, 37353943801875120, 89421365, 89421369, 4, 640x360 
0x1382CA98, 37353943802188992, 89421399, 89421401, 2, 640x360 
0x1382CA98, 37353943802668456, 89421444, 89421452, 8, 640x360 
0x1382CA98, 37353943802988648, 89421475, 89421484, 9, 640x360 
0x1382CA98, 37353943803308320, 89421507, 89421513, 6, 640x360 
0x1382CA98, 37353943803628712, 89421538, 89421542, 4, 640x360 
0x1382CA98, 37353943803948976, 89421571, 89421577, 6, 640x360 
0x1382CA98, 37353943804268736, 89421603, 89421609, 6, 640x360 
0x1382CA98, 37353943804593088, 89421640, 89421647, 7, 640x360 
0x1382CA98, 37353943804924368, 89421667, 89421669, 2, 640x360 
0x1382CA98, 37353943805234560, 89421706, 89421709, 3, 640x360 
0x1382CA98, 37353943805553352, 89421731, 89421734, 3, 640x360 
0x1382CA98, 37353943805874752, 89421768, 89421770, 2, 640x360 
0x1382CA98, 37353943806194592, 89421795, 89421797, 2, 640x360 
0x1382CA98, 37353943806668328, 89421846, 89421850, 4, 640x360 
0x1382CA98, 37353943806988520, 89421878, 89421884, 6, 640x360 
0x1382CA98, 37353943807308288, 89421910, 89421917, 7, 640x360 
0x1382CA98, 37353943807632576, 89421941, 89421944, 3, 640x360 
0x1382CA98, 37353943807955008, 89421973, 89421978, 5, 640x360 
0x1382CA98, 37353943808271704, 89422006, 89422011, 5, 640x360 
0x1382CA98, 37353943808589536, 89422036, 89422042, 6, 640x360 
0x1382CA98, 37353943808925520, 89422067, 89422069, 2, 640x360 
0x1382CA98, 37353943809240760, 89422103, 89422119, 16, 640x360 
0x1382CA98, 37353943809635272, 89422151, 89422181, 30, 640x360 
0x1382CA98, 37353943809980888, 89422190, 89422209, 19, 640x360 
0x1382CA98, 37353943810196432, 89422209, 89422216, 7, 640x360 
0x1382CA98, 37353943810667272, 89422251, 89422253, 2, 640x360 
0x1382CA98, 37353943810993808, 89422281, 89422286, 5, 640x360 
0x1382CA98, 37353943811310264, 89422325, 89422328, 3, 640x360 
0x1382CA98, 37353943811632304, 89422348, 89422349, 1, 640x360 
0x1382CA98, 37353943811973800, 89422378, 89422385, 7, 640x360 
0x1382CA98, 37353943812296000, 89422417, 89422419, 2, 640x360 
0x1382CA98, 37353943812600944, 89422442, 89422452, 10, 640x360 
0x1382CA98, 37353943812933408, 89422475, 89422479, 4, 640x360 
0x1382CA98, 37353943813250968, 89422504, 89422508, 4, 640x360 
0x1382CA98, 37353943813548240, 89422546, 89422549, 3, 640x360 
0x1382CA98, 37353943813898544, 89422568, 89422574, 6, 640x360 
0x1382CA98, 37353943814207064, 89422604, 89422611, 7, 640x360 
0x1382CA98, 37353943814516832, 89422641, 89422644, 3, 640x360 
0x1382CA98, 37353943814994288, 89422693, 89422701, 8, 640x360 
0x1382CA98, 37353943815309504, 89422720, 89422723, 3, 640x360 
0x1382CA98, 37353943815627752, 89422753, 89422755, 2, 640x360 
0x1382CA98, 37353943815965648, 89422785, 89422787, 2, 640x360 
0x1382CA98, 37353943816282560, 89422820, 89422823, 3, 640x360 
0x1382CA98, 37353943816600984, 89422849, 89422852, 3, 640x360 
0x1382CA98, 37353943816920672, 89422886, 89422891, 5, 640x360 
0x1382CA98, 37353943817228112, 89422904, 89422917, 13, 640x360 
0x1382CA98, 37353943817549080, 89422943, 89422945, 2, 640x360 
0x1382CA98, 37353943817868024, 89422963, 89422967, 4, 640x360 
0x1382CA98, 37353943818187736, 89423000, 89423002, 2, 640x360 
0x1382CA98, 37353943818512176, 89423032, 89423034, 2, 640x360 
0x1382CA98, 37353943818988152, 89423082, 89423084, 2, 640x360 
0x1382CA98, 37353943819310424, 89423115, 89423123, 8, 640x360 
0x1382CA98, 37353943819630104, 89423145, 89423149, 4, 640x360 
0x1382CA98, 37353943819948520, 89423194, 89423202, 8, 640x360 
0x1382CA98, 37353943820272984, 89423214, 89423216, 2, 640x360 
0x1382CA98, 37353943820592496, 89423240, 89423251, 11, 640x360 
0x1382CA98, 37353943820932840, 89423286, 89423294, 8, 640x360 
0x1382CA98, 37353943821249032, 89423313, 89423319, 6, 640x360 
0x1382CA98, 37353943821547352, 89423347, 89423349, 2, 640x360 
0x1382CA98, 37353943821867640, 89423376, 89423384, 8, 640x360 
0x1382CA98, 37353943822188560, 89423409, 89423411, 2, 640x360 
0x1382CA98, 37353943822507560, 89423440, 89423444, 4, 640x360 
0x1382CA98, 37353943822991912, 89423478, 89423484, 6, 640x360 
0x1382CA98, 37353943823333176, 89423514, 89423516, 2, 640x360 
0x1382CA98, 37353943823638040, 89423545, 89423553, 8, 640x360 
0x1382CA98, 37353943823957936, 89423584, 89423586, 2, 640x360 
0x1382CA98, 37353943824276976, 89423617, 89423619, 2, 640x360 
0x1382CA98, 37353943824632952, 89423661, 89423669, 8, 640x360 
0x1382CA98, 37353943824931272, 89423694, 89423702, 8, 640x360 
0x1382CA98, 37353943825246560, 89423715, 89423717, 2, 640x360 
0x1382CA98, 37353943825552432, 89423742, 89423745, 3, 640x360 
0x1382CA98, 37353943825871888, 89423767, 89423770, 3, 640x360 
0x1382CA98, 37353943826192424, 89423798, 89423809, 11, 640x360 
0x1382CA98, 37353943826511024, 89423836, 89423840, 4, 640x360 
0x1382CA98, 37353943826989512, 89423885, 89423892, 7, 640x360 
0x1382CA98, 37353943827307792, 89423918, 89423920, 2, 640x360 
0x1382CA98, 37353943827632856, 89423949, 89423951, 2, 640x360 
0x1382CA98, 37353943827954328, 89423974, 89423984, 10, 640x360 
0x1382CA98, 37353943828272440, 89424004, 89424010, 6, 640x360 
0x1382CA98, 37353943828598232, 89424045, 89424048, 3, 640x360 
0x1382CA98, 37353943828921120, 89424069, 89424073, 4, 640x360 
0x1382CA98, 37353943829228200, 89424102, 89424104, 2, 640x360 
0x1382CA98, 37353943829547272, 89424136, 89424139, 3, 640x360 
0x1382CA98, 37353943829872304, 89424168, 89424170, 2, 640x360 
0x1382CA98, 37353943830192088, 89424197, 89424199, 2, 640x360 
0x1382CA98, 37353943830508000, 89424230, 89424240, 10, 640x360 
0x1382CA98, 37353943830989264, 89424284, 89424290, 6, 640x360 
0x1382CA98, 37353943831307968, 89424314, 89424316, 2, 640x360 
0x1382CA98, 37353943831641520, 89424348, 89424350, 2, 640x360 
0x1382CA98, 37353943831954880, 89424381, 89424383, 2, 640x360 
0x1382CA98, 37353943832290592, 89424415, 89424417, 2, 640x360 
0x1382CA98, 37353943832603392, 89424447, 89424450, 3, 640x360 
0x1382CA98, 37353943832909760, 89424472, 89424477, 5, 640x360 
0x1382CA98, 37353943833245280, 89424503, 89424506, 3, 640x360 
0x1382CA98, 37353943833549248, 89424535, 89424538, 3, 640x360 
0x1382CA98, 37353943833873800, 89424575, 89424577, 2, 640x360 
0x1382CA98, 37353943834192496, 89424601, 89424603, 2, 640x360 
0x1382CA98, 37353943834514472, 89424634, 89424636, 2, 640x360 
0x1382CA98, 37353943834990064, 89424697, 89424710, 13, 640x360 
0x1382CA98, 37353943835317496, 89424726, 89424732, 6, 640x360 
0x1382CA98, 37353943835629144, 89424745, 89424753, 8, 640x360 
0x1382CA98, 37353943835957064, 89424782, 89424784, 2, 640x360 
0x1382CA98, 37353943836295528, 89424814, 89424816, 2, 640x360 
0x1382CA98, 37353943836588576, 89424841, 89424843, 2, 640x360 
0x1382CA98, 37353943836911896, 89424874, 89424886, 12, 640x360 
0x1382CA98, 37353943837243224, 89424904, 89424916, 12, 640x360 
0x1382CA98, 37353943837548200, 89424934, 89424936, 2, 640x360 
0x1382CA98, 37353943837867920, 89424971, 89424976, 5, 640x360 
0x1382CA98, 37353943838187432, 89424998, 89425002, 4, 640x360 
0x1382CA98, 37353943838510376, 89425040, 89425050, 10, 640x360 
0x1382CA98, 37353943838995304, 89425087, 89425089, 2, 640x360 
0x1382CA98, 37353943839314256, 89425112, 89425115, 3, 640x360 
0x1382CA98, 37353943839626488, 89425152, 89425153, 1, 640x360 
0x1382CA98, 37353943839946744, 89425187, 89425191, 4, 640x360 
0x1382CA98, 37353943840270440, 89425220, 89425226, 6, 640x360 
0x1382CA98, 37353943840592672, 89425238, 89425250, 12, 640x360 
0x1382CA98, 37353943840910168, 89425276, 89425286, 10, 640x360 
0x1382CA98, 37353943841230536, 89425311, 89425314, 3, 640x360 
0x1382CA98, 37353943841546832, 89425341, 89425343, 2, 640x360 
0x1382CA98, 37353943841866768, 89425373, 89425376, 3, 640x360 
0x1382CA98, 37353943842186976, 89425396, 89425403, 7, 640x360 
0x1382CA98, 37353943842511032, 89425434, 89425437, 3, 640x360 
0x1382CA98, 37353943843320224, 89425523, 89425537, 14, 640x360 
0x1382CA98, 37353943843635000, 89425551, 89425553, 2, 640x360 
0x1382CA98, 37353943843959656, 89425574, 89425583, 9, 640x360 
0x1382CA98, 37353943844304288, 89425625, 89425629, 4, 640x360 
0x1382CA98, 37353943844601080, 89425646, 89425649, 3, 640x360 
0x1382CA98, 37353943844913248, 89425687, 89425690, 3, 640x360 
0x1382CA98, 37353943845234672, 89425707, 89425711, 4, 640x360 
0x1382CA98, 37353943845555632, 89425736, 89425739, 3, 640x360 
0x1382CA98, 37353943845877088, 89425775, 89425777, 2, 640x360 
0x1382CA98, 37353943846186712, 89425805, 89425808, 3, 640x360 
0x1382CA98, 37353943846507176, 89425840, 89425849, 9, 640x360 
0x1382CA98, 37353943846829472, 89425873, 89425883, 10, 640x360 
0x1382CA98, 37353943847317256, 89425920, 89425923, 3, 640x360 
0x1382CA98, 37353943847630840, 89425954, 89425957, 3, 640x360 
0x1382CA98, 37353943847956104, 89425972, 89425978, 6, 640x360 
0x1382CA98, 37353943848273704, 89426004, 89426011, 7, 640x360 
0x1382CA98, 37353943848591840, 89426037, 89426040, 3, 640x360 
0x1382CA98, 37353943848911232, 89426069, 89426073, 4, 640x360 
0x1382CA98, 37353943849238480, 89426102, 89426106, 4, 640x360 
0x1382CA98, 37353943849546528, 89426139, 89426150, 11, 640x360 
0x1382CA98, 37353943849869920, 89426168, 89426171, 3, 640x360 
0x1382CA98, 37353943850190480, 89426207, 89426212, 5, 640x360 
0x1382CA98, 37353943850518768, 89426234, 89426236, 2, 640x360 
0x1382CA98, 37353943850826864, 89426268, 89426270, 2, 640x360 
0x1382CA98, 37353943851310648, 89426307, 89426314, 7, 640x360 
0x1382CA98, 37353943851626216, 89426339, 89426342, 3, 640x360 
0x1382CA98, 37353943851947192, 89426371, 89426375, 4, 640x360 
0x1382CA98, 37353943852267816, 89426409, 89426411, 2, 640x360 
0x1382CA98, 37353943852588160, 89426435, 89426438, 3, 640x360 
0x1382CA98, 37353943852921864, 89426474, 89426476, 2, 640x360 
0x1382CA98, 37353943853232232, 89426506, 89426511, 5, 640x360 
0x1382CA98, 37353943853551224, 89426540, 89426542, 2, 640x360 
0x1382CA98, 37353943853867208, 89426565, 89426567, 2, 640x360 
0x1382CA98, 37353943854187808, 89426596, 89426598, 2, 640x360 
0x1382CA98, 37353943854508160, 89426627, 89426630, 3, 640x360 
0x1382CA98, 37353943854827328, 89426658, 89426660, 2, 640x360 
0x1382CA98, 37353943855307296, 89426711, 89426714, 3, 640x360 
0x1382CA98, 37353943855627264, 89426740, 89426744, 4, 640x360 
0x1382CA98, 37353943855946760, 89426771, 89426776, 5, 640x360 
0x1382CA98, 37353944334975904, 89474695, 89474704, 9, 640x360 
0x1382CA98, 37353944335303664, 89474733, 89474743, 10, 640x360 
0x1382CA98, 37353944335631304, 89474749, 89474752, 3, 640x360 
0x1382CA98, 37353944335950720, 89474792, 89474801, 9, 640x360 
0x1382CA98, 37353944336287344, 89474816, 89474826, 10, 640x360 
0x1382CA98, 37353944336575432, 89474849, 89474857, 8, 640x360 
0x1382CA98, 37353944337053984, 89474895, 89474898, 3, 640x360 
0x1382CA98, 37353944337377520, 89474933, 89474935, 2, 640x360 
0x1382CA98, 37353944337693776, 89474977, 89474981, 4, 640x360 
0x1382CA98, 37353944338034920, 89474992, 89475001, 9, 640x360 
0x1382CA98, 37353944338341992, 89475034, 89475043, 9, 640x360 
0x1382CA98, 37353944338656176, 89475053, 89475063, 10, 640x360 
0x1382CA98, 37353944338974472, 89475087, 89475093, 6, 640x360 
0x1382CA98, 37353944339299088, 89475121, 89475125, 4, 640x360 
0x1382CA98, 37353944339620744, 89475178, 89475189, 11, 640x360 
0x1382CA98, 37353944339945016, 89475190, 89475202, 12, 640x360 
0x1382CA98, 37353944340281504, 89475219, 89475221, 2, 640x360 
0x1382CA98, 37353944340623288, 89475252, 89475254, 2, 640x360 
0x1382CA98, 37353944341052976, 89475293, 89475298, 5, 640x360 
0x1382CA98, 37353944341375016, 89475326, 89475334, 8, 640x360 
0x1382CA98, 37353944341695304, 89475351, 89475354, 3, 640x360 
0x1382CA98, 37353944342013680, 89475386, 89475393, 7, 640x360 
0x1382CA98, 37353944342335304, 89475425, 89475430, 5, 640x360 
0x1382CA98, 37353944342657880, 89475462, 89475464, 2, 640x360 
0x1382CA98, 37353944342973984, 89475492, 89475495, 3, 640x360 
0x1382CA98, 37353944343294320, 89475519, 89475533, 14, 640x360 
0x1382CA98, 37353944343614416, 89475559, 89475571, 12, 640x360 
0x1382CA98, 37353944343960744, 89475595, 89475602, 7, 640x360 
0x1382CA98, 37353944344270264, 89475624, 89475639, 15, 640x360 
0x1382CA98, 37353944344636032, 89475677, 89475698, 21, 640x360 
0x1382CA98, 37353944345077952, 89475703, 89475738, 35, 640x360 
0x1382CA98, 37353944345392960, 89475738, 89475761, 23, 640x360 
0x1382CA98, 37353944345696192, 89475762, 89475778, 16, 640x360 
0x1382CA98, 37353944346013832, 89475789, 89475830, 41, 640x360 
0x1382CA98, 37353944346343264, 89475831, 89475854, 23, 640x360 
0x1382CA98, 37353944346683504, 89475854, 89475878, 24, 640x360 
0x1382CA98, 37353944346976928, 89475892, 89475901, 9, 640x360 
0x1382CA98, 37353944347308880, 89475922, 89475945, 23, 640x360 
0x1382CA98, 37353944347641280, 89475960, 89475994, 34, 640x360 
0x1382CA98, 37353944348050656, 89476006, 89476028, 22, 640x360 
0x1382CA98, 37353944348258344, 89476042, 89476048, 6, 640x360 
0x1382CA98, 37353944348576104, 89476051, 89476068, 17, 640x360 
0x1382CA98, 37353944349156552, 89476109, 89476131, 22, 640x360 
0x1382CA98, 37353944349435560, 89476150, 89476155, 5, 640x360 
0x1382CA98, 37353944349792960, 89476189, 89476211, 22, 640x360 
0x1382CA98, 37353944350026832, 89476212, 89476232, 20, 640x360 
0x1382CA98, 37353944350347512, 89476240, 89476246, 6, 640x360 
0x1382CA98, 37353944350692264, 89476285, 89476290, 5, 640x360 
0x1382CA98, 37353944351047456, 89476339, 89476348, 9, 640x360 
0x1382CA98, 37353944351632208, 89476373, 89476384, 11, 640x360 
0x1382CA98, 37353944351947712, 89476393, 89476408, 15, 640x360 
0x1382CA98, 37353944352265800, 89476472, 89476498, 26, 640x360 
0x1382CA98, 37353944353130088, 89476526, 89476554, 28, 640x360 
0x1382CA98, 37353944353474312, 89476555, 89476578, 23, 640x360 
0x1382CA98, 37353944353752856, 89476578, 89476585, 7, 640x360 
0x1382CA98, 37353944354038424, 89476597, 89476608, 11, 640x360 
0x1382CA98, 37353944354336832, 89476621, 89476627, 6, 640x360 
0x1382CA98, 37353944354662016, 89476655, 89476657, 2, 640x360 
0x1382CA98, 37353944354974816, 89476688, 89476691, 3, 640x360 
0x1382CA98, 37353944355295496, 89476719, 89476721, 2, 640x360 
0x1382CA98, 37353944355613984, 89476749, 89476752, 3, 640x360 
0x1382CA98, 37353944355952408, 89476781, 89476795, 14, 640x360 
0x1382CA98, 37353944356267304, 89476818, 89476820, 2, 640x360 
0x1382CA98, 37353944356629272, 89476851, 89476855, 4, 640x360 
0x1382CA98, 37353944356894144, 89476876, 89476888, 12, 640x360 
0x1382CA98, 37353944357375568, 89476928, 89476931, 3, 640x360 
0x1382CA98, 37353944357692624, 89476964, 89476966, 2, 640x360 
0x1382CA98, 37353944358012976, 89476987, 89476994, 7, 640x360 
0x1382CA98, 37353944358336920, 89477014, 89477017, 3, 640x360 
0x1382CA98, 37353944358653008, 89477054, 89477058, 4, 640x360 
0x1382CA98, 37353944358980104, 89477092, 89477095, 3, 640x360 
0x1382CA98, 37353944359304912, 89477131, 89477133, 2, 640x360 
0x1382CA98, 37353944359619280, 89477154, 89477158, 4, 640x360 
0x1382CA98, 37353944359986672, 89477199, 89477201, 2, 640x360 
0x1382CA98, 37353944360287008, 89477233, 89477235, 2, 640x360 
0x1382CA98, 37353944360590968, 89477262, 89477265, 3, 640x360 
0x1382CA98, 37353944360922512, 89477279, 89477288, 9, 640x360 
0x1382CA98, 37353944361373048, 89477330, 89477334, 4, 640x360 
0x1382CA98, 37353944361693360, 89477359, 89477362, 3, 640x360 
0x1382CA98, 37353944362012672, 89477380, 89477383, 3, 640x360 
0x1382CA98, 37353944362332672, 89477425, 89477427, 2, 640x360 
0x1382CA98, 37353944362652664, 89477446, 89477448, 2, 640x360 
0x1382CA98, 37353944362974120, 89477484, 89477495, 11, 640x360 
0x1382CA98, 37353944363308656, 89477531, 89477552, 21, 640x360 
0x1382CA98, 37353944363614912, 89477553, 89477562, 9, 640x360 
0x1382CA98, 37353944363962560, 89477579, 89477587, 8, 640x360 
0x1382CA98, 37353944364265584, 89477621, 89477631, 10, 640x360 
0x1382CA98, 37353944364627888, 89477649, 89477659, 10, 640x360 
0x1382CA98, 37353944364899248, 89477690, 89477695, 5, 640x360 
0x1382CA98, 37353944365375184, 89477724, 89477734, 10, 640x360 
0x1382CA98, 37353944365703848, 89477761, 89477764, 3, 640x360 
0x1382CA98, 37353944366015480, 89477788, 89477795, 7, 640x360 
0x1382CA98, 37353944366345976, 89477821, 89477823, 2, 640x360 
0x1382CA98, 37353944366653264, 89477848, 89477850, 2, 640x360 
0x1382CA98, 37353944366972672, 89477879, 89477881, 2, 640x360 
0x1382CA98, 37353944367296448, 89477910, 89477912, 2, 640x360 
0x1382CA98, 37353944367617792, 89477941, 89477944, 3, 640x360 
0x1382CA98, 37353944367933720, 89477973, 89477980, 7, 640x360 
0x1382CA98, 37353944368253696, 89478004, 89478007, 3, 640x360 
0x1382CA98, 37353944368578248, 89478040, 89478048, 8, 640x360 
0x1382CA98, 37353944368893416, 89478071, 89478073, 2, 640x360 
0x1382CA98, 37353944369376184, 89478118, 89478120, 2, 640x360 
0x1382CA98, 37353944369696856, 89478148, 89478151, 3, 640x360 
0x1382CA98, 37353944370013128, 89478180, 89478183, 3, 640x360 
0x1382CA98, 37353944370333320, 89478212, 89478215, 3, 640x360 
0x1382CA98, 37353944370652976, 89478243, 89478245, 2, 640x360 
0x1382CA98, 37353944370973560, 89478274, 89478277, 3, 640x360 
0x1382CA98, 37353944371293584, 89478305, 89478308, 3, 640x360 
0x1382CA98, 37353944371613888, 89478341, 89478344, 3, 640x360 
0x1382CA98, 37353944371934160, 89478370, 89478374, 4, 640x360 
0x1382CA98, 37353944372253496, 89478404, 89478407, 3, 640x360 
0x1382CA98, 37353944372573600, 89478435, 89478438, 3, 640x360 
0x1382CA98, 37353944372895024, 89478469, 89478479, 10, 640x360 
0x1382CA98, 37353944373372440, 89478521, 89478523, 2, 640x360 
0x1382CA98, 37353944373700904, 89478552, 89478554, 2, 640x360 
0x1382CA98, 37353944374012736, 89478584, 89478587, 3, 640x360 
0x1382CA98, 37353944374336008, 89478616, 89478619, 3, 640x360 
0x1382CA98, 37353944374652512, 89478647, 89478650, 3, 640x360 
0x1382CA98, 37353944374973288, 89478682, 89478689, 7, 640x360 
0x1382CA98, 37353944375293576, 89478707, 89478711, 4, 640x360 
0x1382CA98, 37353944375616848, 89478738, 89478744, 6, 640x360 
0x1382CA98, 37353944375933440, 89478769, 89478772, 3, 640x360 
0x1382CA98, 37353944376278960, 89478810, 89478817, 7, 640x360 
0x1382CA98, 37353944376578776, 89478847, 89478850, 3, 640x360 
0x1382CA98, 37353944376900792, 89478876, 89478879, 3, 640x360 
0x1382CA98, 37353944377372168, 89478920, 89478922, 2, 640x360 
0x1382CA98, 37353944377697600, 89478956, 89478960, 4, 640x360 
0x1382CA98, 37353944378012624, 89478983, 89478985, 2, 640x360 
0x1382CA98, 37353944378338920, 89479016, 89479022, 6, 640x360 
0x1382CA98, 37353944378653352, 89479048, 89479050, 2, 640x360 
0x1382CA98, 37353944378973264, 89479081, 89479086, 5, 640x360 
0x1382CA98, 37353944379293152, 89479110, 89479113, 3, 640x360 
0x1382CA98, 37353944379634024, 89479140, 89479149, 9, 640x360 
0x1382CA98, 37353944379937872, 89479171, 89479174, 3, 640x360 
0x1382CA98, 37353944380269568, 89479204, 89479208, 4, 640x360 
0x1382CA98, 37353944380604528, 89479242, 89479248, 6, 640x360 
0x1382CA98, 37353944380893480, 89479267, 89479270, 3, 640x360 
0x1382CA98, 37353944381217360, 89479301, 89479303, 2, 640x360 
0x1382CA98, 37353944381693280, 89479348, 89479352, 4, 640x360 
0x1382CA98, 37353944382013936, 89479388, 89479391, 3, 640x360 
0x1382CA98, 37353944382336728, 89479416, 89479422, 6, 640x360 
0x1382CA98, 37353944382659672, 89479454, 89479455, 1, 640x360 
0x1382CA98, 37353944382976144, 89479480, 89479482, 2, 640x360 
0x1382CA98, 37353944383296328, 89479514, 89479516, 2, 640x360 
0x1382CA98, 37353944383613472, 89479559, 89479563, 4, 640x360 
0x1382CA98, 37353944383939704, 89479584, 89479586, 2, 640x360 
0x1382CA98, 37353944384271248, 89479615, 89479620, 5, 640x360 
0x1382CA98, 37353944384610240, 89479638, 89479641, 3, 640x360 
0x1382CA98, 37353944384896616, 89479675, 89479685, 10, 640x360 
0x1382CA98, 37353944385212368, 89479700, 89479702, 2, 640x360 
0x1382CA98, 37353944385692008, 89479757, 89479768, 11, 640x360 
0x1382CA98, 37353944386014040, 89479792, 89479795, 3, 640x360 
0x1382CA98, 37353944386350136, 89479826, 89479837, 11, 640x360 
0x1382CA98, 37353944386671712, 89479856, 89479859, 3, 640x360 
0x1382CA98, 37353944386980696, 89479882, 89479888, 6, 640x360 
0x1382CA98, 37353944387296352, 89479918, 89479920, 2, 640x360 
0x1382CA98, 37353944387612784, 89479946, 89479948, 2, 640x360 
0x1382CA98, 37353944387973040, 89479988, 89479990, 2, 640x360 
0x1382CA98, 37353944388271632, 89480010, 89480017, 7, 640x360 
0x1382CA98, 37353944388576232, 89480044, 89480053, 9, 640x360 
0x1382CA98, 37353944388896648, 89480079, 89480088, 9, 640x360 
0x1382CA98, 37353944389217240, 89480104, 89480106, 2, 640x360 
0x1382CA98, 37353944389692536, 89480154, 89480156, 2, 640x360 
0x1382CA98, 37353944390016656, 89480181, 89480184, 3, 640x360 
0x1382CA98, 37353944390344696, 89480220, 89480228, 8, 640x360 
0x1382CA98, 37353944390657344, 89480246, 89480251, 5, 640x360 
0x1382CA98, 37353944390978256, 89480287, 89480289, 2, 640x360 
0x1382CA98, 37353944391302872, 89480315, 89480318, 3, 640x360 
0x1382CA98, 37353944391662560, 89480350, 89480352, 2, 640x360 
0x1382CA98, 37353944391950216, 89480376, 89480381, 5, 640x360 
0x1382CA98, 37353944392254144, 89480409, 89480412, 3, 640x360 
0x1382CA98, 37353944392578088, 89480439, 89480442, 3, 640x360 
0x1382CA98, 37353944392892792, 89480471, 89480473, 2, 640x360 
0x1382CA98, 37353944393213376, 89480503, 89480505, 2, 640x360 
0x1382CA98, 37353944393693152, 89480553, 89480555, 2, 640x360 
0x1382CA98, 37353944394016416, 89480584, 89480587, 3, 640x360 
0x1382CA98, 37353944394348000, 89480619, 89480624, 5, 640x360 
0x1382CA98, 37353944394658048, 89480646, 89480654, 8, 640x360 
0x1382CA98, 37353944394976152, 89480679, 89480681, 2, 640x360 
0x1382CA98, 37353944395292504, 89480710, 89480714, 4, 640x360 
0x1382CA98, 37353944395612944, 89480741, 89480752, 11, 640x360 
0x1382CA98, 37353944395938800, 89480773, 89480784, 11, 640x360 
0x1382CA98, 37353944396274200, 89480810, 89480820, 10, 640x360 
0x1382CA98, 37353944396613536, 89480839, 89480849, 10, 640x360 
0x1382CA98, 37353944396896208, 89480876, 89480885, 9, 640x360 
0x1382CA98, 37353944397215840, 89480914, 89480920, 6, 640x360 
0x1382CA98, 37353944397691896, 89480949, 89480952, 3, 640x360 
0x1382CA98, 37353944398012368, 89480982, 89480988, 6, 640x360 
0x1382CA98, 37353944398333544, 89481023, 89481037, 14, 640x360 
0x1382CA98, 37353944398662456, 89481053, 89481059, 6, 640x360 
0x1382CA98, 37353944399007704, 89481103, 89481108, 5, 640x360 
0x1382CA98, 37353944399305392, 89481143, 89481146, 3, 640x360 
0x1382CA98, 37353944399619824, 89481156, 89481173, 17, 640x360 
0x1382CA98, 37353944399973096, 89481196, 89481201, 5, 640x360 
0x1382CA98, 37353944400271712, 89481230, 89481245, 15, 640x360 
0x1382CA98, 37353944400623288, 89481255, 89481263, 8, 640x360 
0x1382CA98, 37353944400893832, 89481282, 89481310, 28, 640x360 
0x1382CA98, 37353944401219536, 89481317, 89481321, 4, 640x360 
0x1382CA98, 37353944401691936, 89481354, 89481358, 4, 640x360 
0x1382CA98, 37353944402012320, 89481382, 89481384, 2, 640x360 
0x1382CA98, 37353944402331520, 89481419, 89481422, 3, 640x360 
0x1382CA98, 37353944402661128, 89481460, 89481464, 4, 640x360 
0x1382CA98, 37353944402972128, 89481481, 89481483, 2, 640x360 
0x1382CA98, 37353944403297144, 89481521, 89481523, 2, 640x360 
0x1382CA98, 37353944403612256, 89481549, 89481551, 2, 640x360 
0x1382CA98, 37353944403936704, 89481580, 89481586, 6, 640x360 
0x1382CA98, 37353944404264768, 89481611, 89481618, 7, 640x360 
0x1382CA98, 37353944404585664, 89481649, 89481655, 6, 640x360 
0x1382CA98, 37353944404895408, 89481679, 89481681, 2, 640x360 
0x1382CA98, 37353944405212640, 89481714, 89481716, 2, 640x360 
0x1382CA98, 37353944405691864, 89481749, 89481751, 2, 640x360 
0x1382CA98, 37353944406015400, 89481800, 89481820, 20, 640x360 
0x1382CA98, 37353944406368144, 89481839, 89481854, 15, 640x360 
0x1382CA98, 37353944406676544, 89481854, 89481863, 9, 640x360 
0x1382CA98, 37353944406972224, 89481878, 89481886, 8, 640x360 
0x1382CA98, 37353944407292000, 89481921, 89481923, 2, 640x360 
0x1382CA98, 37353944407611648, 89481948, 89481950, 2, 640x360 
0x1382CA98, 37353944407936376, 89481985, 89481987, 2, 640x360 
0x1382CA98, 37353944408274312, 89482016, 89482019, 3, 640x360 
0x1382CA98, 37353944408578760, 89482044, 89482052, 8, 640x360 
0x1382CA98, 37353944408892008, 89482077, 89482080, 3, 640x360 
0x1382CA98, 37353944409211904, 89482106, 89482111, 5, 640x360 
0x1382CA98, 37353944409538872, 89482137, 89482138, 1, 640x360 
0x1382CA98, 37353944410011952, 89482179, 89482182, 3, 640x360 
0x1382CA98, 37353944410336080, 89482218, 89482227, 9, 640x360 
0x1382CA98, 37353944410651952, 89482246, 89482252, 6, 640x360 
0x1382CA98, 37353944410976392, 89482285, 89482291, 6, 640x360 
0x1382CA98, 37353944411296816, 89482319, 89482321, 2, 640x360 
0x1382CA98, 37353944411642744, 89482350, 89482352, 2, 640x360 
0x1382CA98, 37353944411944232, 89482388, 89482390, 2, 640x360 
0x1382CA98, 37353944412260008, 89482419, 89482421, 2, 640x360 
0x1382CA98, 37353944412574216, 89482443, 89482453, 10, 640x360 
0x1382CA98, 37353944412896544, 89482481, 89482488, 7, 640x360 
0x1382CA98, 37353944413212856, 89482515, 89482522, 7, 640x360 
0x1382CA98, 37353944413537072, 89482545, 89482547, 2, 640x360 
0x1382CA98, 37353944414016776, 89482594, 89482597, 3, 640x360 
0x1382CA98, 37353944414338352, 89482615, 89482623, 8, 640x360 
0x1382CA98, 37353944414656472, 89482647, 89482653, 6, 640x360 
0x1382CA98, 37353944414971360, 89482682, 89482684, 2, 640x360 
0x1382CA98, 37353944415300672, 89482707, 89482714, 7, 640x360 
0x1382CA98, 37353944415611472, 89482740, 89482746, 6, 640x360 
0x1382CA98, 37353944415939968, 89482778, 89482788, 10, 640x360 
0x1382CA98, 37353944416274872, 89482822, 89482825, 3, 640x360 
0x1382CA98, 37353944416572368, 89482861, 89482879, 18, 640x360 
0x1382CA98, 37353944416893200, 89482879, 89482884, 5, 640x360 
0x1382CA98, 37353944417212456, 89482906, 89482921, 15, 640x360 
0x1382CA98, 37353944417539584, 89482954, 89482960, 6, 640x360 
0x1382CA98, 37353944418021160, 89483002, 89483011, 9, 640x360 
0x1382CA98, 37353944418341048, 89483045, 89483050, 5, 640x360 
0x1382CA98, 37353944418710888, 89483069, 89483073, 4, 640x360 
0x1382CA98, 37353944418986776, 89483097, 89483103, 6, 640x360 
0x1382CA98, 37353944419350920, 89483122, 89483137, 15, 640x360 
0x1382CA98, 37353944419664808, 89483155, 89483163, 8, 640x360 
0x1382CA98, 37353944419988880, 89483197, 89483203, 6, 640x360 
0x1382CA98, 37353944420260864, 89483210, 89483218, 8, 640x360 
0x1382CA98, 37353944420576464, 89483244, 89483253, 9, 640x360 
0x1382CA98, 37353944420896984, 89483272, 89483276, 4, 640x360 
0x1382CA98, 37353944421211464, 89483309, 89483313, 4, 640x360 
0x1382CA98, 37353944421549368, 89483338, 89483343, 5, 640x360 
0x1382CA98, 37353944422015320, 89483389, 89483394, 5, 640x360 
0x1382CA98, 37353944422331048, 89483421, 89483429, 8, 640x360 
0x1382CA98, 37353944422652096, 89483462, 89483464, 2, 640x360 
0x1382CA98, 37353944422978216, 89483493, 89483508, 15, 640x360 
0x1382CA98, 37353944423293600, 89483528, 89483532, 4, 640x360 
0x1382CA98, 37353944423624800, 89483555, 89483558, 3, 640x360 
0x1382CA98, 37353944423951440, 89483582, 89483592, 10, 640x360 
0x1382CA98, 37353944424266760, 89483606, 89483611, 5, 640x360 
0x1382CA98, 37353944424571976, 89483649, 89483652, 3, 640x360 
0x1382CA98, 37353944424909232, 89483695, 89483703, 8, 640x360 
0x1382CA98, 37353944425219704, 89483715, 89483718, 3, 640x360 
0x1382CA98, 37353944425532136, 89483740, 89483742, 2, 640x360 
0x1382CA98, 37353944426015128, 89483784, 89483787, 3, 640x360 
0x1382CA98, 37353944426337480, 89483828, 89483830, 2, 640x360 
0x1382CA98, 37353944426665032, 89483856, 89483858, 2, 640x360 
0x1382CA98, 37353944426974968, 89483883, 89483889, 6, 640x360 
0x1382CA98, 37353944427292248, 89483919, 89483920, 1, 640x360 
0x1382CA98, 37353944427617040, 89483947, 89483957, 10, 640x360 
0x1382CA98, 37353944427940952, 89483980, 89483985, 5, 640x360 
0x1382CA98, 37353944428274072, 89484040, 89484046, 6, 640x360 
0x1382CA98, 37353944428590632, 89484050, 89484052, 2, 640x360 
0x1382CA98, 37353944428896256, 89484079, 89484086, 7, 640x360 
0x1382CA98, 37353944429212096, 89484110, 89484115, 5, 640x360 
0x1382CA98, 37353944429531680, 89484149, 89484152, 3, 640x360 
0x1382CA98, 37353944430011240, 89484198, 89484205, 7, 640x360 
0x1382CA98, 37353944430338936, 89484216, 89484225, 9, 640x360 
0x1382CA98, 37353944430656440, 89484249, 89484256, 7, 640x360 
0x1382CA98, 37353944430975224, 89484289, 89484299, 10, 640x360 
0x1382CA98, 37353944431309480, 89484318, 89484320, 2, 640x360 
0x1382CA98, 37353944431616568, 89484348, 89484351, 3, 640x360 
0x1382CA98, 37353944431948112, 89484385, 89484386, 1, 640x360 
0x1382CA98, 37353944432287824, 89484417, 89484420, 3, 640x360 
0x1382CA98, 37353944432578416, 89484441, 89484448, 7, 640x360 
0x1382CA98, 37353944432891752, 89484481, 89484488, 7, 640x360 
0x1382CA98, 37353944433211384, 89484505, 89484515, 10, 640x360 
0x1382CA98, 37353944433542128, 89484536, 89484539, 3, 640x360 
0x1382CA98, 37353944433851656, 89484566, 89484574, 8, 640x360 
0x1382CA98, 37353944434333112, 89484630, 89484636, 6, 640x360 
0x1382CA98, 37353944434656000, 89484660, 89484671, 11, 640x360 
0x1382CA98, 37353944434974032, 89484693, 89484697, 4, 640x360 
0x1382CA98, 37353944435296040, 89484728, 89484731, 3, 640x360 
0x1382CA98, 37353944435628168, 89484752, 89484754, 2, 640x360 
0x1382CA98, 37353944435937808, 89484795, 89484798, 3, 640x360 
0x1382CA98, 37353944436264416, 89484818, 89484821, 3, 640x360 
0x1382CA98, 37353944436593744, 89484841, 89484847, 6, 640x360 
0x1382CA98, 37353944436892680, 89484877, 89484879, 2, 640x360 
0x1382CA98, 37353944437242960, 89484903, 89484905, 2, 640x360 
0x1382CA98, 37353944437536176, 89484944, 89484947, 3, 640x360 
0x1382CA98, 37353944437851944, 89484971, 89484975, 4, 640x360 
0x1382CA98, 37353944438330688, 89485016, 89485021, 5, 640x360 
0x1382CA98, 37353944438667552, 89485054, 89485057, 3, 640x360 
0x1382CA98, 37353944438975272, 89485083, 89485088, 5, 640x360 
0x1382CA98, 37353944439293168, 89485129, 89485146, 17, 640x360 
0x1382CA98, 37353944439622568, 89485159, 89485169, 10, 640x360 
0x1382CA98, 37353944439931288, 89485178, 89485183, 5, 640x360 
0x1382CA98, 37353944440258672, 89485207, 89485220, 13, 640x360 
0x1382CA98, 37353944440572496, 89485242, 89485254, 12, 640x360 
0x1382CA98, 37353944440901696, 89485281, 89485285, 4, 640x360 
0x1382CA98, 37353944441218408, 89485321, 89485350, 29, 640x360 
0x1382CA98, 37353944441540592, 89485350, 89485354, 4, 640x360 
0x1382CA98, 37353944441852088, 89485370, 89485376, 6, 640x360 
0x1382CA98, 37353944442361208, 89485441, 89485452, 11, 640x360 
0x1382CA98, 37353944442684504, 89485480, 89485487, 7, 640x360 
0x1382CA98, 37353944442974728, 89485487, 89485491, 4, 640x360 
0x1382CA98, 37353944443304280, 89485520, 89485522, 2, 640x360 
0x1382CA98, 37353944443620592, 89485555, 89485561, 6, 640x360 
0x1382CA98, 37353944443939848, 89485586, 89485589, 3, 640x360 
0x1382CA98, 37353944444264472, 89485618, 89485620, 2, 640x360 
0x1382CA98, 37353944444581288, 89485649, 89485651, 2, 640x360 
0x1382CA98, 37353944444892520, 89485670, 89485674, 4, 640x360 
0x1382CA98, 37353944445210800, 89485701, 89485703, 2, 640x360 
0x1382CA98, 37353944445531216, 89485735, 89485738, 3, 640x360 
0x1382CA98, 37353944445852536, 89485771, 89485774, 3, 640x360 
0x1382CA98, 37353944446340776, 89485832, 89485843, 11, 640x360 
0x1382CA98, 37353944446688344, 89485861, 89485878, 17, 640x360 
0x1382CA98, 37353944446973872, 89485928, 89485939, 11, 640x360 
0x1382CA98, 37353944447694408, 89485977, 89485982, 5, 640x360 
0x1382CA98, 37353944447999696, 89486013, 89486050, 37, 640x360 
0x1382CA98, 37353944448671824, 89486090, 89486105, 15, 640x360 
0x1382CA98, 37353944448956016, 89486114, 89486120, 6, 640x360 
0x1382CA98, 37353944449326752, 89486152, 89486156, 4, 640x360 
0x1382CA98, 37353944449645208, 89486165, 89486182, 17, 640x360 
0x1382CA98, 37353944449895424, 89486211, 89486221, 10, 640x360 
0x1382CA98, 37353944450270160, 89486234, 89486240, 6, 640x360 
0x1382CA98, 37353944450499080, 89486240, 89486244, 4, 640x360 
0x1382CA98, 37353944450686864, 89486256, 89486262, 6, 640x360 
0x1382CA98, 37353944451306224, 89486321, 89486323, 2, 640x360 
0x1382CA98, 37353944451635992, 89486396, 89486405, 9, 640x360 
0x1382CA98, 37353944451963072, 89486425, 89486435, 10, 640x360 
0x1382CA98, 37353944452303968, 89486451, 89486455, 4, 640x360 
0x1382CA98, 37353944452644376, 89486472, 89486481, 9, 640x360 
0x1382CA98, 37353944452963424, 89486504, 89486514, 10, 640x360 
0x1382CA98, 37353944453253848, 89486538, 89486586, 48, 640x360 
0x1382CA98, 37353944453546456, 89486587, 89486622, 35, 640x360 
0x1382CA98, 37353944453967520, 89486622, 89486635, 13, 640x360 
0x1382CA98, 37353944454385664, 89486666, 89486670, 4, 640x360 
0x1382CA98, 37353944454974808, 89486680, 89486682, 2, 640x360 
0x1382CA98, 37353944455085224, 89486708, 89486714, 6, 640x360 
0x1382CA98, 37353944455343104, 89486733, 89486737, 4, 640x360 
0x1382CA98, 37353944456011560, 89486801, 89486814, 13, 640x360 
0x1382CA98, 37353944456310760, 89486842, 89486849, 7, 640x360 
0x1382CA98, 37353944456650016, 89486863, 89486875, 12, 640x360 
0x1382CA98, 37353944456949240, 89486892, 89486922, 30, 640x360 
0x1382CA98, 37353944457216272, 89486939, 89486943, 4, 640x360 
0x1382CA98, 37353944457551840, 89486964, 89486967, 3, 640x360 
0x1382CA98, 37353944457861872, 89486985, 89486988, 3, 640x360 
0x1382CA98, 37353944458329984, 89487019, 89487030, 11, 640x360 
0x1382CA98, 37353944458672944, 89487056, 89487060, 4, 640x360 
0x1382CA98, 37353944458976088, 89487092, 89487111, 19, 640x360 
0x1382CA98, 37353944459356176, 89487151, 89487172, 21, 640x360 
0x1382CA98, 37353944459665296, 89487179, 89487183, 4, 640x360 
0x1382CA98, 37353944460009224, 89487206, 89487213, 7, 640x360 
0x1382CA98, 37353944460292120, 89487232, 89487248, 16, 640x360 
0x1382CA98, 37353944460572816, 89487249, 89487254, 5, 640x360 
0x1382CA98, 37353944460896880, 89487287, 89487296, 9, 640x360 
0x1382CA98, 37353944461211680, 89487322, 89487329, 7, 640x360 
0x1382CA98, 37353944461540208, 89487358, 89487366, 8, 640x360 
0x1382CA98, 37353944461861504, 89487383, 89487393, 10, 640x360 
0x1382CA98, 37353944462173240, 89487419, 89487422, 3, 640x360 
0x1382CA98, 37353944462655008, 89487450, 89487452, 2, 640x360 
0x1382CA98, 37353944462972808, 89487482, 89487484, 2, 640x360 
0x1382CA98, 37353944463289960, 89487511, 89487513, 2, 640x360 
0x1382CA98, 37353944463611096, 89487541, 89487543, 2, 640x360 
0x1382CA98, 37353944463930832, 89487572, 89487575, 3, 640x360 
0x1382CA98, 37353944464251224, 89487612, 89487614, 2, 640x360 
0x1382CA98, 37353944464584376, 89487644, 89487648, 4, 640x360 
0x1382CA98, 37353944464891512, 89487680, 89487682, 2, 640x360 
0x1382CA98, 37353944465213272, 89487705, 89487708, 3, 640x360 
0x1382CA98, 37353944465534552, 89487734, 89487737, 3, 640x360 
0x1382CA98, 37353944465855368, 89487765, 89487774, 9, 640x360 
0x1382CA98, 37353944466170896, 89487801, 89487806, 5, 640x360 
0x1382CA98, 37353944466697544, 89487886, 89487898, 12, 640x360 
0x1382CA98, 37353944466989248, 89487899, 89487930, 31, 640x360 
0x1382CA98, 37353944467332440, 89487930, 89487937, 7, 640x360 
0x1382CA98, 37353944467623976, 89487970, 89487982, 12, 640x360 
0x1382CA98, 37353944467991128, 89487998, 89488004, 6, 640x360 
0x1382CA98, 37353944468324280, 89488048, 89488060, 12, 640x360 
0x1382CA98, 37353944468656440, 89488062, 89488084, 22, 640x360 
0x1382CA98, 37353944468933944, 89488084, 89488101, 17, 640x360 
0x1382CA98, 37353944469221888, 89488131, 89488151, 20, 640x360 
0x1382CA98, 37353944469545768, 89488171, 89488195, 24, 640x360 
0x1382CA98, 37353944469860760, 89488195, 89488198, 3, 640x360 
0x1382CA98, 37353944470196360, 89488228, 89488236, 8, 640x360 
0x1382CA98, 37353944470656456, 89488272, 89488292, 20, 640x360 
0x1382CA98, 37353944470975736, 89488313, 89488318, 5, 640x360 
0x1382CA98, 37353944471302488, 89488328, 89488333, 5, 640x360 
0x1382CA98, 37353944471625248, 89488353, 89488371, 18, 640x360 
0x1382CA98, 37353944471943368, 89488404, 89488411, 7, 640x360 
0x1382CA98, 37353944472266192, 89488431, 89488446, 15, 640x360 
0x1382CA98, 37353944472627536, 89488472, 89488481, 9, 640x360 
0x1382CA98, 37353944472981696, 89488501, 89488505, 4, 640x360 
0x1382CA98, 37353944473216552, 89488528, 89488544, 16, 640x360 
0x1382CA98, 37353944473542512, 89488544, 89488547, 3, 640x360 
0x1382CA98, 37353944473851016, 89488576, 89488583, 7, 640x360 
0x1382CA98, 37353944474170400, 89488606, 89488612, 6, 640x360 
0x1382CA98, 37353944474653040, 89488649, 89488653, 4, 640x360 
0x1382CA98, 37353944474973336, 89488686, 89488695, 9, 640x360 
0x1382CA98, 37353944475292400, 89488711, 89488716, 5, 640x360 
0x1382CA98, 37353944475615176, 89488755, 89488758, 3, 640x360 
0x1382CA98, 37353944475941136, 89488785, 89488788, 3, 640x360 
0x1382CA98, 37353944476251976, 89488812, 89488816, 4, 640x360 
0x1382CA98, 37353944476578584, 89488856, 89488861, 5, 640x360 
0x1382CA98, 37353944476894120, 89488886, 89488894, 8, 640x360 
0x1382CA98, 37353944477210368, 89488918, 89488925, 7, 640x360 
0x1382CA98, 37353944477537352, 89488949, 89488954, 5, 640x360 
0x1382CA98, 37353944477857616, 89488972, 89488983, 11, 640x360 
0x1382CA98, 37353944478174056, 89489007, 89489015, 8, 640x360 
0x1382CA98, 37353944478672232, 89489065, 89489072, 7, 640x360 
0x1382CA98, 37353944478977936, 89489094, 89489099, 5, 640x360 
0x1382CA98, 37353944479295560, 89489121, 89489133, 12, 640x360 
0x1382CA98, 37353944479627272, 89489149, 89489152, 3, 640x360 
0x1382CA98, 37353944479958328, 89489181, 89489183, 2, 640x360 
0x1382CA98, 37353944480259088, 89489204, 89489207, 3, 640x360 
0x1382CA98, 37353944480577224, 89489237, 89489239, 2, 640x360 
0x1382CA98, 37353944480890408, 89489276, 89489278, 2, 640x360 
0x1382CA98, 37353944481210120, 89489305, 89489307, 2, 640x360 
0x1382CA98, 37353944481533688, 89489333, 89489336, 3, 640x360 
0x1382CA98, 37353944481850432, 89489364, 89489367, 3, 640x360 
0x1382CA98, 37353944482175248, 89489402, 89489408, 6, 640x360 
0x1382CA98, 37353944482651608, 89489449, 89489451, 2, 640x360 
0x1382CA98, 37353944482970256, 89489482, 89489485, 3, 640x360 
0x1382CA98, 37353944483290848, 89489519, 89489521, 2, 640x360 
0x1382CA98, 37353944483616968, 89489558, 89489572, 14, 640x360 
0x1382CA98, 37353944484025448, 89489618, 89489621, 3, 640x360 
0x1382CA98, 37353944484291984, 89489639, 89489646, 7, 640x360 
0x1382CA98, 37353944484610664, 89489664, 89489667, 3, 640x360 
0x1382CA98, 37353944484891952, 89489674, 89489684, 10, 640x360 
0x1382CA98, 37353944485214592, 89489720, 89489727, 7, 640x360 
0x1382CA98, 37353944485530344, 89489746, 89489748, 2, 640x360 
0x1382CA98, 37353944485853720, 89489768, 89489776, 8, 640x360 
0x1382CA98, 37353944486173320, 89489817, 89489819, 2, 640x360 
0x1382CA98, 37353944486656488, 89489871, 89489878, 7, 640x360 
0x1382CA98, 37353944486974728, 89489894, 89489898, 4, 640x360 
0x1382CA98, 37353944487291560, 89489918, 89489920, 2, 640x360 
0x1382CA98, 37353944487633536, 89489950, 89489953, 3, 640x360 
0x1382CA98, 37353944487945464, 89489976, 89489982, 6, 640x360 
0x1382CA98, 37353944488272464, 89490021, 89490023, 2, 640x360 
0x1382CA98, 37353944488571352, 89490048, 89490051, 3, 640x360 
0x1382CA98, 37353944488889880, 89490082, 89490085, 3, 640x360 
0x1382CA98, 37353944489209744, 89490102, 89490105, 3, 640x360 
0x1382CA98, 37353944489530072, 89490145, 89490148, 3, 640x360 
0x1382CA98, 37353944489853768, 89490184, 89490186, 2, 640x360 
0x1382CA98, 37353944490174400, 89490202, 89490208, 6, 640x360 
0x1382CA98, 37353944490499224, 89490248, 89490252, 4, 640x360 
0x1382CA98, 37353944490972144, 89490281, 89490284, 3, 640x360 
0x1382CA98, 37353944491289936, 89490312, 89490316, 4, 640x360 
0x1382CA98, 37353944491611336, 89490349, 89490351, 2, 640x360 
0x1382CA98, 37353944491937752, 89490378, 89490380, 2, 640x360 
0x1382CA98, 37353944492251544, 89490412, 89490416, 4, 640x360 
0x1382CA98, 37353944492577608, 89490441, 89490446, 5, 640x360 
0x1382CA98, 37353944492900256, 89490472, 89490479, 7, 640x360 
0x1382CA98, 37353944493216072, 89490504, 89490506, 2, 640x360 
0x1382CA98, 37353944493543432, 89490534, 89490537, 3, 640x360 
0x1382CA98, 37353944493853600, 89490570, 89490575, 5, 640x360 
0x1382CA98, 37353944494170080, 89490612, 89490615, 3, 640x360 
0x1382CA98, 37353944494492128, 89490638, 89490644, 6, 640x360 
0x1382CA98, 37353944494970656, 89490701, 89490704, 3, 640x360 
0x1382CA98, 37353944495301816, 89490752, 89490767, 15, 640x360 
0x1382CA98, 37353944495659200, 89490771, 89490784, 13, 640x360 
0x1382CA98, 37353944495980272, 89490798, 89490809, 11, 640x360 
0x1382CA98, 37353944496282400, 89490824, 89490829, 5, 640x360 
0x1382CA98, 37353944496582768, 89490852, 89490862, 10, 640x360 
0x1382CA98, 37353944496891384, 89490888, 89490895, 7, 640x360 
0x1382CA98, 37353944497213264, 89490917, 89490931, 14, 640x360 
0x1382CA98, 37353944497531600, 89490951, 89490963, 12, 640x360 
0x1382CA98, 37353944497856888, 89490970, 89490981, 11, 640x360 
0x1382CA98, 37353944498171128, 89491018, 89491022, 4, 640x360 
0x1382CA98, 37353944498492464, 89491046, 89491048, 2, 640x360 
0x1382CA98, 37353944498968944, 89491083, 89491092, 9, 640x360 
0x1382CA98, 37353944499288936, 89491111, 89491114, 3, 640x360 
0x1382CA98, 37353944499621984, 89491150, 89491154, 4, 640x360 
0x1382CA98, 37353944499942672, 89491186, 89491203, 17, 640x360 
0x1382CA98, 37353944500290080, 89491251, 89491255, 4, 640x360 
0x1382CA98, 37353944500621768, 89491290, 89491319, 29, 640x360 
0x1382CA98, 37353944501020720, 89491347, 89491362, 15, 640x360 
0x1382CA98, 37353944501694280, 89491372, 89491409, 37, 640x360 
0x1382CA98, 37353944501954864, 89491410, 89491426, 16, 640x360 
0x1382CA98, 37353944502296552, 89491454, 89491470, 16, 640x360 
0x1382CA98, 37353944502658848, 89491486, 89491497, 11, 640x360 
0x1382CA98, 37353944503053088, 89491502, 89491504, 2, 640x360 
0x1382CA98, 37353944503308160, 89491518, 89491531, 13, 640x360 
0x1382CA98, 37353944503932640, 89491573, 89491580, 7, 640x360 
0x1382CA98, 37353944504253440, 89491609, 89491614, 5, 640x360 
0x1382CA98, 37353944504576896, 89491636, 89491639, 3, 640x360 
0x1382CA98, 37353944504903808, 89491687, 89491690, 3, 640x360 
0x1382CA98, 37353944505210592, 89491739, 89491747, 8, 640x360 
0x1382CA98, 37353944505541728, 89491747, 89491755, 8, 640x360 
0x1382CA98, 37353944505875048, 89491783, 89491786, 3, 640x360 
0x1382CA98, 37353944506173000, 89491805, 89491812, 7, 640x360 
0x1382CA98, 37353944506494904, 89491846, 89491850, 4, 640x360 
0x1382CA98, 37353944506975856, 89491886, 89491894, 8, 640x360 
0x1382CA98, 37353944507289800, 89491918, 89491930, 12, 640x360 
0x1382CA98, 37353944507635680, 89491963, 89491966, 3, 640x360 
0x1382CA98, 37353944507930248, 89491973, 89491979, 6, 640x360 
0x1382CA98, 37353944508257800, 89492007, 89492014, 7, 640x360 
0x1382CA98, 37353944508580336, 89492046, 89492049, 3, 640x360 
0x1382CA98, 37353944508893160, 89492071, 89492075, 4, 640x360 
0x1382CA98, 37353944509213896, 89492105, 89492107, 2, 640x360 
0x1382CA98, 37353944509533488, 89492138, 89492142, 4, 640x360 
0x1382CA98, 37353944509850016, 89492165, 89492170, 5, 640x360 
0x1382CA98, 37353944510169424, 89492203, 89492205, 2, 640x360 
0x1382CA98, 37353944510491000, 89492241, 89492250, 9, 640x360 
0x1382CA98, 37353944510980096, 89492285, 89492302, 17, 640x360 
0x1382CA98, 37353944511311384, 89492322, 89492324, 2, 640x360 
0x1382CA98, 37353944511616296, 89492350, 89492356, 6, 640x360 
0x1382CA98, 37353944511944096, 89492377, 89492379, 2, 640x360 
0x1382CA98, 37353944512254096, 89492407, 89492411, 4, 640x360 
0x1382CA98, 37353944512569712, 89492435, 89492438, 3, 640x360 
0x1382CA98, 37353944512893312, 89492481, 89492483, 2, 640x360 
0x1382CA98, 37353944513209432, 89492512, 89492514, 2, 640x360 
0x1382CA98, 37353944513529408, 89492532, 89492535, 3, 640x360 
0x1382CA98, 37353944513849144, 89492575, 89492578, 3, 640x360 
0x1382CA98, 37353944514170056, 89492605, 89492609, 4, 640x360 
0x1382CA98, 37353944514489880, 89492629, 89492632, 3, 640x360 
0x1382CA98, 37353944514810016, 89492666, 89492668, 2, 640x360 
0x1382CA98, 37353944515290168, 89492707, 89492716, 9, 640x360 
0x1382CA98, 37353944515613848, 89492746, 89492749, 3, 640x360 
0x1382CA98, 37353944515935704, 89492774, 89492782, 8, 640x360 
0x1382CA98, 37353944516251672, 89492802, 89492804, 2, 640x360 
0x1382CA98, 37353944516571728, 89492841, 89492845, 4, 640x360 
0x1382CA98, 37353944516898112, 89492872, 89492875, 3, 640x360 
0x1382CA98, 37353944517228312, 89492903, 89492905, 2, 640x360 
0x1382CA98, 37353944517529736, 89492938, 89492940, 2, 640x360 
0x1382CA98, 37353944517849696, 89492966, 89492969, 3, 640x360 
0x1382CA98, 37353944518169888, 89492997, 89493003, 6, 640x360 
0x1382CA98, 37353944518495336, 89493029, 89493033, 4, 640x360 
0x1382CA98, 37353944518813096, 89493075, 89493083, 8, 640x360 
0x1382CA98, 37353944519289296, 89493106, 89493110, 4, 640x360 
0x1382CA98, 37353944519608464, 89493138, 89493141, 3, 640x360 
0x1382CA98, 37353944519929048, 89493177, 89493184, 7, 640x360 
0x1382CA98, 37353944520257208, 89493208, 89493217, 9, 640x360 
0x1382CA98, 37353944520572536, 89493236, 89493239, 3, 640x360 
0x1382CA98, 37353944520889904, 89493270, 89493273, 3, 640x360 
0x1382CA98, 37353944521212800, 89493304, 89493308, 4, 640x360 
0x1382CA98, 37353944521529128, 89493337, 89493341, 4, 640x360 
0x1382CA98, 37353944521855728, 89493369, 89493371, 2, 640x360 
0x1382CA98, 37353944522169800, 89493411, 89493413, 2, 640x360 
0x1382CA98, 37353944522489640, 89493437, 89493439, 2, 640x360 
0x1382CA98, 37353944522809928, 89493460, 89493463, 3, 640x360 
0x1382CA98, 37353944523299752, 89493521, 89493524, 3, 640x360 
0x1382CA98, 37353944523663960, 89493557, 89493564, 7, 640x360 
0x1382CA98, 37353944523931920, 89493583, 89493594, 11, 640x360 
0x1382CA98, 37353944524255720, 89493610, 89493613, 3, 640x360 
0x1382CA98, 37353944524579056, 89493639, 89493645, 6, 640x360 
0x1382CA98, 37353944524911208, 89493675, 89493685, 10, 640x360 
0x1382CA98, 37353944525209472, 89493707, 89493713, 6, 640x360 
0x1382CA98, 37353944525533984, 89493742, 89493746, 4, 640x360 
0x1382CA98, 37353944525864016, 89493773, 89493778, 5, 640x360 
0x1382CA98, 37353944526168952, 89493798, 89493805, 7, 640x360 
0x1382CA98, 37353944526489000, 89493833, 89493835, 2, 640x360 
0x1382CA98, 37353944526825480, 89493870, 89493873, 3, 640x360 
0x1382CA98, 37353944527289424, 89493916, 89493926, 10, 640x360 
0x1382CA98, 37353944527608200, 89493947, 89493951, 4, 640x360 
0x1382CA98, 37353944527928264, 89493971, 89493974, 3, 640x360 
0x1382CA98, 37353944528268960, 89494005, 89494017, 12, 640x360 
0x1382CA98, 37353944528572304, 89494045, 89494053, 8, 640x360 
0x1382CA98, 37353944528890000, 89494087, 89494089, 2, 640x360 
0x1382CA98, 37353944529209448, 89494103, 89494104, 1, 640x360 
0x1382CA98, 37353944529528624, 89494136, 89494138, 2, 640x360 
0x1382CA98, 37353944529849552, 89494172, 89494175, 3, 640x360 
0x1382CA98, 37353944530176552, 89494207, 89494219, 12, 640x360 
0x1382CA98, 37353944530493504, 89494233, 89494244, 11, 640x360 
0x1382CA98, 37353944530809416, 89494269, 89494271, 2, 640x360 
0x1382CA98, 37353944531291960, 89494316, 89494318, 2, 640x360 
0x1382CA98, 37353944531608632, 89494344, 89494346, 2, 640x360 
0x1382CA98, 37353944531934792, 89494371, 89494373, 2, 640x360 
0x1382CA98, 37353944532259592, 89494409, 89494415, 6, 640x360 
0x1382CA98, 37353944532573896, 89494436, 89494439, 3, 640x360 
0x1382CA98, 37353944532891904, 89494470, 89494474, 4, 640x360 
0x1382CA98, 37353944533212640, 89494504, 89494508, 4, 640x360 
0x1382CA98, 37353944533529328, 89494540, 89494545, 5, 640x360 
0x1382CA98, 37353944533852232, 89494566, 89494569, 3, 640x360 
0x1382CA98, 37353944534175192, 89494597, 89494599, 2, 640x360 
0x1382CA98, 37353944534490920, 89494635, 89494642, 7, 640x360 
0x1382CA98, 37353944534809120, 89494673, 89494685, 12, 640x360 
0x1382CA98, 37353944535289296, 89494715, 89494717, 2, 640x360 
0x1382CA98, 37353944535608632, 89494749, 89494751, 2, 640x360 
0x1382CA98, 37353944535928080, 89494779, 89494781, 2, 640x360 
0x1382CA98, 37353944536248520, 89494806, 89494814, 8, 640x360 
0x1382CA98, 37353944536569960, 89494838, 89494840, 2, 640x360 
0x1382CA98, 37353944536888752, 89494871, 89494874, 3, 640x360 
0x1382CA98, 37353944537216096, 89494902, 89494904, 2, 640x360 
0x1382CA98, 37353944537529872, 89494934, 89494938, 4, 640x360 
0x1382CA98, 37353944537850712, 89494965, 89494971, 6, 640x360 
0x1382CA98, 37353944538170688, 89495002, 89495008, 6, 640x360 
0x1382CA98, 37353944538492280, 89495037, 89495039, 2, 640x360 
0x1382CA98, 37353944538831256, 89495064, 89495066, 2, 640x360 
0x1382CA98, 37353944539288328, 89495122, 89495127, 5, 640x360 
0x1382CA98, 37353944539608688, 89495155, 89495162, 7, 640x360 
0x1382CA98, 37353944539961880, 89495192, 89495200, 8, 640x360 
0x1382CA98, 37353944540262648, 89495227, 89495230, 3, 640x360 
0x1382CA98, 37353944540578800, 89495248, 89495251, 3, 640x360 
0x1382CA98, 37353944540888176, 89495281, 89495294, 13, 640x360 
0x1382CA98, 37353944541213328, 89495315, 89495317, 2, 640x360 
0x1382CA98, 37353944541534608, 89495352, 89495355, 3, 640x360 
0x1382CA98, 37353944541857592, 89495372, 89495376, 4, 640x360 
0x1382CA98, 37353944542168744, 89495411, 89495414, 3, 640x360 
0x1382CA98, 37353944542488568, 89495431, 89495434, 3, 640x360 
0x1382CA98, 37353944542822664, 89495471, 89495473, 2, 640x360 
0x1382CA98, 37353944543133960, 89495500, 89495502, 2, 640x360 
0x1382CA98, 37353944543608088, 89495549, 89495561, 12, 640x360 
0x1382CA98, 37353944543933888, 89495570, 89495578, 8, 640x360 
0x1382CA98, 37353944544256152, 89495616, 89495623, 7, 640x360 
0x1382CA98, 37353944544568984, 89495647, 89495649, 2, 640x360 
0x1382CA98, 37353944544888032, 89495674, 89495677, 3, 640x360 
0x1382CA98, 37353944545207992, 89495711, 89495713, 2, 640x360 
0x1382CA98, 37353944545528632, 89495735, 89495737, 2, 640x360 
0x1382CA98, 37353944545848504, 89495765, 89495778, 13, 640x360 
0x1382CA98, 37353944546176168, 89495801, 89495803, 2, 640x360 
0x1382CA98, 37353944546490272, 89495842, 89495846, 4, 640x360 
0x1382CA98, 37353944546808832, 89495865, 89495873, 8, 640x360 
0x1382CA98, 37353944547136432, 89495915, 89495917, 2, 640x360 
0x1382CA98, 37353944547617616, 89495943, 89495954, 11, 640x360 
0x1382CA98, 37353944547953960, 89495997, 89496005, 8, 640x360 
0x1382CA98, 37353944548327024, 89496022, 89496038, 16, 640x360 
0x1382CA98, 37353944548633648, 89496062, 89496071, 9, 640x360 
0x1382CA98, 37353944548910576, 89496093, 89496105, 12, 640x360 
0x1382CA98, 37353944549217384, 89496121, 89496145, 24, 640x360 
0x1382CA98, 37353944549529200, 89496146, 89496171, 25, 640x360 
0x1382CA98, 37353944549864120, 89496191, 89496198, 7, 640x360 
0x1382CA98, 37353944550174392, 89496205, 89496234, 29, 640x360 
0x1382CA98, 37353944550523072, 89496262, 89496271, 9, 640x360 
0x1382CA98, 37353944550828768, 89496300, 89496302, 2, 640x360 
0x1382CA98, 37353944551152560, 89496314, 89496322, 8, 640x360 
0x1382CA98, 37353944551636312, 89496358, 89496372, 14, 640x360 
0x1382CA98, 37353944552005512, 89496432, 89496439, 7, 640x360 
0x1382CA98, 37353944552351816, 89496481, 89496495, 14, 640x360 
0x1382CA98, 37353944552804656, 89496510, 89496517, 7, 640x360 
0x1382CA98, 37353944553406768, 89496552, 89496560, 8, 640x360 
0x1382CA98, 37353944553852688, 89496584, 89496610, 26, 640x360 
0x1382CA98, 37353944554208112, 89496615, 89496633, 18, 640x360 
0x1382CA98, 37353944554504224, 89496645, 89496652, 7, 640x360 
0x1382CA98, 37353944554809160, 89496676, 89496681, 5, 640x360 
0x1382CA98, 37353944555134376, 89496700, 89496710, 10, 640x360 
0x1382CA98, 37353944555608272, 89496756, 89496763, 7, 640x360 
0x1382CA98, 37353944555942800, 89496801, 89496806, 5, 640x360 
0x1382CA98, 37353944556277312, 89496830, 89496837, 7, 640x360 
0x1382CA98, 37353944556597624, 89496859, 89496865, 6, 640x360 
0x1382CA98, 37353944556888344, 89496877, 89496880, 3, 640x360 
0x1382CA98, 37353944557211288, 89496904, 89496908, 4, 640x360 
0x1382CA98, 37353944557527904, 89496945, 89496947, 2, 640x360 
0x1382CA98, 37353944557854200, 89496966, 89496969, 3, 640x360 
0x1382CA98, 37353944558172736, 89497005, 89497007, 2, 640x360 
0x1382CA98, 37353944558508560, 89497033, 89497036, 3, 640x360 
0x1382CA98, 37353944558816632, 89497062, 89497073, 11, 640x360 
0x1382CA98, 37353944559131344, 89497109, 89497114, 5, 640x360 
0x1382CA98, 37353944559611464, 89497156, 89497158, 2, 640x360 
0x1382CA98, 37353944559932584, 89497173, 89497178, 5, 640x360 
0x1382CA98, 37353944560266496, 89497206, 89497217, 11, 640x360 
0x1382CA98, 37353944560569504, 89497244, 89497252, 8, 640x360 
0x1382CA98, 37353944560891440, 89497270, 89497273, 3, 640x360 
0x1382CA98, 37353944561207656, 89497303, 89497305, 2, 640x360 
0x1382CA98, 37353944561534872, 89497346, 89497354, 8, 640x360 
0x1382CA98, 37353944561850504, 89497368, 89497371, 3, 640x360 
0x1382CA98, 37353944562168568, 89497408, 89497413, 5, 640x360 
0x1382CA98, 37353944562487936, 89497434, 89497436, 2, 640x360 
0x1382CA98, 37353944562813464, 89497466, 89497468, 2, 640x360 
0x1382CA98, 37353944563127904, 89497500, 89497506, 6, 640x360 
0x1382CA98, 37353944563608472, 89497544, 89497548, 4, 640x360 
0x1382CA98, 37353944563927104, 89497574, 89497586, 12, 640x360 
0x1382CA98, 37353944564260976, 89497605, 89497608, 3, 640x360 
0x1382CA98, 37353944564570424, 89497643, 89497649, 6, 640x360 
0x1382CA98, 37353944564887448, 89497684, 89497692, 8, 640x360 
0x1382CA98, 37353944565211016, 89497702, 89497704, 2, 640x360 
0x1382CA98, 37353944565528064, 89497742, 89497746, 4, 640x360 
0x1382CA98, 37353944565851664, 89497779, 89497781, 2, 640x360 
0x1382CA98, 37353944566167544, 89497798, 89497801, 3, 640x360 
0x1382CA98, 37353944566487592, 89497832, 89497834, 2, 640x360 
0x1382CA98, 37353944566807600, 89497863, 89497866, 3, 640x360 
0x1382CA98, 37353944567127704, 89497890, 89497893, 3, 640x360 
0x1382CA98, 37353944567671744, 89497964, 89497981, 17, 640x360 
0x1382CA98, 37353944567937024, 89497986, 89497989, 3, 640x360 
0x1382CA98, 37353944568258248, 89498019, 89498021, 2, 640x360 
0x1382CA98, 37353944568568288, 89498050, 89498053, 3, 640x360 
0x1382CA98, 37353944568890352, 89498093, 89498102, 9, 640x360 
0x1382CA98, 37353944569239720, 89498124, 89498405, 281, 640x360 
0x1382CA98, 37353944569619624, 89498405, 89498417, 12, 640x360 
0x1382CA98, 37353944572279848, 89498435, 89498451, 16, 640x360 
0x1382CA98, 37353944572607848, 89498473, 89498486, 13, 640x360 
0x1382CA98, 37353944572968008, 89498496, 89498509, 13, 640x360 
0x1382CA98, 37353944573243288, 89498530, 89498535, 5, 640x360 
0x1382CA98, 37353944573537264, 89498551, 89498555, 4, 640x360 
0x1382CA98, 37353944573863736, 89498574, 89498587, 13, 640x360 
0x1382CA98, 37353944574201808, 89498615, 89498622, 7, 640x360 
0x1382CA98, 37353944574528712, 89498644, 89498657, 13, 640x360 
0x1382CA98, 37353944574834224, 89498676, 89498678, 2, 640x360 
0x1382CA98, 37353944575134640, 89498715, 89498717, 2, 640x360 
0x1382CA98, 37353944575459232, 89498736, 89498739, 3, 640x360 
0x1382CA98, 37353944575941456, 89498786, 89498788, 2, 640x360 
0x1382CA98, 37353944576272488, 89498819, 89498831, 12, 640x360 
0x1382CA98, 37353944576581272, 89498847, 89498850, 3, 640x360 
0x1382CA98, 37353944576887040, 89498872, 89498876, 4, 640x360 
0x1382CA98, 37353944577211072, 89498908, 89498912, 4, 640x360 
0x1382CA98, 37353944577527464, 89498937, 89498945, 8, 640x360 
0x1382CA98, 37353944577847216, 89498965, 89498979, 14, 640x360 
0x1382CA98, 37353944578167656, 89499007, 89499010, 3, 640x360 
0x1382CA98, 37353944578492216, 89499030, 89499034, 4, 640x360 
0x1382CA98, 37353944578810272, 89499067, 89499069, 2, 640x360 
0x1382CA98, 37353944579136144, 89499101, 89499103, 2, 640x360 
0x1382CA98, 37353944579452232, 89499127, 89499132, 5, 640x360 
0x1382CA98, 37353944579937560, 89499175, 89499180, 5, 640x360 
0x1382CA98, 37353944580258776, 89499219, 89499224, 5, 640x360 
0x1382CA98, 37353944580569664, 89499250, 89499252, 2, 640x360 
0x1382CA98, 37353944580890272, 89499282, 89499284, 2, 640x360 
0x1382CA98, 37353944581206944, 89499312, 89499315, 3, 640x360 
0x1382CA98, 37353944581528560, 89499334, 89499342, 8, 640x360 
0x1382CA98, 37353944581847208, 89499367, 89499376, 9, 640x360 
0x1382CA98, 37353944582167640, 89499402, 89499404, 2, 640x360 
0x1382CA98, 37353944582491296, 89499444, 89499446, 2, 640x360 
0x1382CA98, 37353944582807264, 89499467, 89499471, 4, 640x360 
0x1382CA98, 37353944583131488, 89499509, 89499520, 11, 640x360 
0x1382CA98, 37353944583449128, 89499535, 89499539, 4, 640x360 
0x1382CA98, 37353944583931648, 89499594, 89499604, 10, 640x360 
0x1382CA98, 37353944584271568, 89499625, 89499637, 12, 640x360 
0x1382CA98, 37353944584578056, 89499647, 89499658, 11, 640x360 
0x1382CA98, 37353944584900000, 89499677, 89499683, 6, 640x360 
0x1382CA98, 37353944585241640, 89499714, 89499723, 9, 640x360 
0x1382CA98, 37353944585538072, 89499740, 89499742, 2, 640x360 
0x1382CA98, 37353944585851632, 89499767, 89499770, 3, 640x360 
0x1382CA98, 37353944586167056, 89499799, 89499802, 3, 640x360 
0x1382CA98, 37353944586486992, 89499830, 89499838, 8, 640x360 
0x1382CA98, 37353944586810952, 89499873, 89499878, 5, 640x360 
0x1382CA98, 37353944587133144, 89499901, 89499904, 3, 640x360 
0x1382CA98, 37353944587457888, 89499933, 89499935, 2, 640x360 
0x1382CA98, 37353944587926616, 89499984, 89499986, 2, 640x360 
0x1382CA98, 37353944588249008, 89500018, 89500020, 2, 640x360 
0x1382CA98, 37353944588574008, 89500040, 89500044, 4, 640x360 
0x1382CA98, 37353944588890976, 89500076, 89500079, 3, 640x360 
0x1382CA98, 37353944589206768, 89500102, 89500104, 2, 640x360 
0x1382CA98, 37353944589527320, 89500140, 89500143, 3, 640x360 
0x1382CA98, 37353944589847512, 89500165, 89500167, 2, 640x360 
0x1382CA98, 37353944590167696, 89500196, 89500199, 3, 640x360 
0x1382CA98, 37353944590487152, 89500228, 89500231, 3, 640x360 
0x1382CA98, 37353944590807752, 89500265, 89500272, 7, 640x360 
0x1382CA98, 37353944591131320, 89500299, 89500305, 6, 640x360 
0x1382CA98, 37353944591449968, 89500339, 89500342, 3, 640x360 
0x1382CA98, 37353944591927088, 89500383, 89500395, 12, 640x360 
0x1382CA98, 37353944592250632, 89500430, 89500433, 3, 640x360 
0x1382CA98, 37353944592568576, 89500446, 89500448, 2, 640x360 
0x1382CA98, 37353944592914504, 89500475, 89500480, 5, 640x360 
0x1382CA98, 37353944593211136, 89500517, 89500519, 2, 640x360 
0x1382CA98, 37353944593527008, 89500543, 89500548, 5, 640x360 
0x1382CA98, 37353944593854648, 89500574, 89500580, 6, 640x360 
0x1382CA98, 37353944594167352, 89500603, 89500610, 7, 640x360 
0x1382CA98, 37353944594490520, 89500640, 89500643, 3, 640x360 
0x1382CA98, 37353944594808080, 89500670, 89500673, 3, 640x360 
0x1382CA98, 37353944595130160, 89500700, 89500703, 3, 640x360 
0x1382CA98, 37353944595450168, 89500734, 89500738, 4, 640x360 
0x1382CA98, 37353944595938704, 89500776, 89500785, 9, 640x360 
0x1382CA98, 37353944596252136, 89500812, 89500814, 2, 640x360 
0x1382CA98, 37353944596567288, 89500846, 89500853, 7, 640x360 
0x1382CA98, 37353944596886688, 89500878, 89500880, 2, 640x360 
0x1382CA98, 37353944597206696, 89500900, 89500902, 2, 640x360 
0x1382CA98, 37353944597526824, 89500940, 89500945, 5, 640x360 
0x1382CA98, 37353944597850576, 89500964, 89500970, 6, 640x360 
0x1382CA98, 37353944598170328, 89501002, 89501005, 3, 640x360 
0x1382CA98, 37353944598488792, 89501039, 89501041, 2, 640x360 
0x1382CA98, 37353944598812048, 89501068, 89501074, 6, 640x360 
0x1382CA98, 37353944599129648, 89501104, 89501106, 2, 640x360 
0x1382CA98, 37353944599448136, 89501131, 89501139, 8, 640x360 
0x1382CA98, 37353944599779872, 89501165, 89501170, 5, 640x360 
0x1382CA98, 37353944600258712, 89501207, 89501211, 4, 640x360 
0x1382CA98, 37353944600567152, 89501240, 89501242, 2, 640x360 
0x1382CA98, 37353944600887104, 89501270, 89501272, 2, 640x360 
0x1382CA98, 37353944601207008, 89501300, 89501303, 3, 640x360 
0x1382CA98, 37353944601527472, 89501335, 89501349, 14, 640x360 
0x1382CA98, 37353944601850536, 89501366, 89501373, 7, 640x360 
0x1382CA98, 37353944602170384, 89501397, 89501399, 2, 640x360 
0x1382CA98, 37353944602490464, 89501439, 89501443, 4, 640x360 
0x1382CA98, 37353944602810408, 89501466, 89501472, 6, 640x360 
0x1382CA98, 37353944603131352, 89501493, 89501502, 9, 640x360 
0x1382CA98, 37353944603459888, 89501528, 89501531, 3, 640x360 
0x1382CA98, 37353944604267152, 89501614, 89501616, 2, 640x360 
0x1382CA98, 37353944604571752, 89501638, 89501642, 4, 640x360 
0x1382CA98, 37353944604886784, 89501674, 89501684, 10, 640x360 
0x1382CA98, 37353944605207280, 89501711, 89501718, 7, 640x360 
0x1382CA98, 37353944605527176, 89501736, 89501740, 4, 640x360 
0x1382CA98, 37353944605846632, 89501770, 89501773, 3, 640x360 
0x1382CA98, 37353944606167960, 89501807, 89501813, 6, 640x360 
0x1382CA98, 37353944606527104, 89501844, 89501853, 9, 640x360 
0x1382CA98, 37353944606822656, 89501870, 89501871, 1, 640x360 
0x1382CA98, 37353944607141072, 89501903, 89501905, 2, 640x360 
0x1382CA98, 37353944607466032, 89501937, 89501938, 1, 640x360 
0x1382CA98, 37353944607784648, 89501965, 89501968, 3, 640x360 
0x1382CA98, 37353944608251344, 89502010, 89502014, 4, 640x360 
0x1382CA98, 37353944608567904, 89502041, 89502046, 5, 640x360 
0x1382CA98, 37353944608886736, 89502071, 89502073, 2, 640x360 
0x1382CA98, 37353944609206392, 89502106, 89502109, 3, 640x360 
0x1382CA98, 37353944609528312, 89502146, 89502148, 2, 640x360 
0x1382CA98, 37353944609847008, 89502169, 89502171, 2, 640x360 
0x1382CA98, 37353944610171664, 89502205, 89502208, 3, 640x360 
0x1382CA98, 37353944610486976, 89502237, 89502242, 5, 640x360 
0x1382CA98, 37353944610824064, 89502268, 89502270, 2, 640x360 
0x1382CA98, 37353944611129944, 89502294, 89502300, 6, 640x360 
0x1382CA98, 37353944611447640, 89502334, 89502336, 2, 640x360 
0x1382CA98, 37353944611776400, 89502372, 89502378, 6, 640x360 
0x1382CA98, 37353944612246392, 89502408, 89502415, 7, 640x360 
0x1382CA98, 37353944612573208, 89502441, 89502446, 5, 640x360 
0x1382CA98, 37353944612900728, 89502473, 89502475, 2, 640x360 
0x1382CA98, 37353944613206976, 89502510, 89502512, 2, 640x360 
0x1382CA98, 37353944613526096, 89502541, 89502545, 4, 640x360 
0x1382CA98, 37353944613851728, 89502565, 89502571, 6, 640x360 
0x1382CA98, 37353944614170040, 89502597, 89502599, 2, 640x360 
0x1382CA98, 37353944614486064, 89502640, 89502644, 4, 640x360 
0x1382CA98, 37353944614809864, 89502665, 89502667, 2, 640x360 
0x1382CA98, 37353944615132032, 89502697, 89502703, 6, 640x360 
0x1382CA98, 37353944615456744, 89502729, 89502731, 2, 640x360 
0x1382CA98, 37353944615766552, 89502761, 89502763, 2, 640x360 
0x1382CA98, 37353944616258200, 89502806, 89502816, 10, 640x360 
0x1382CA98, 37353944616566992, 89502840, 89502846, 6, 640x360 
0x1382CA98, 37353944616886736, 89502877, 89502885, 8, 640x360 
0x1382CA98, 37353944617206768, 89502901, 89502903, 2, 640x360 
0x1382CA98, 37353944617526104, 89502937, 89502939, 2, 640x360 
0x1382CA98, 37353944617846200, 89502968, 89502970, 2, 640x360 
0x1382CA98, 37353944618171672, 89503012, 89503015, 3, 640x360 
0x1382CA98, 37353944618491728, 89503045, 89503047, 2, 640x360 
0x1382CA98, 37353944618808064, 89503076, 89503079, 3, 640x360 
0x1382CA98, 37353944619130040, 89503097, 89503100, 3, 640x360 
0x1382CA98, 37353944619446344, 89503123, 89503126, 3, 640x360 
0x1382CA98, 37353944619769888, 89503162, 89503165, 3, 640x360 
0x1382CA98, 37353944620251368, 89503212, 89503220, 8, 640x360 
0x1382CA98, 37353944620566368, 89503238, 89503241, 3, 640x360 
0x1382CA98, 37353944620885752, 89503272, 89503276, 4, 640x360 
0x1382CA98, 37353944621205712, 89503304, 89503306, 2, 640x360 
0x1382CA98, 37353944621529944, 89503333, 89503339, 6, 640x360 
0x1382CA98, 37353944621857360, 89503371, 89503373, 2, 640x360 
0x1382CA98, 37353944622168088, 89503404, 89503406, 2, 640x360 
0x1382CA98, 37353944622487256, 89503434, 89503437, 3, 640x360 
0x1382CA98, 37353944622807016, 89503466, 89503474, 8, 640x360 
0x1382CA98, 37353944623133320, 89503495, 89503497, 2, 640x360 
0x1382CA98, 37353944623450048, 89503525, 89503527, 2, 640x360 
0x1382CA98, 37353944623766872, 89503564, 89503566, 2, 640x360 
0x1382CA98, 37353944624086712, 89503601, 89503605, 4, 640x360 
0x1382CA98, 37353944624566424, 89503646, 89503650, 4, 640x360 
0x1382CA98, 37353944624886416, 89503679, 89503683, 4, 640x360 
0x1382CA98, 37353944625206512, 89503709, 89503713, 4, 640x360 
0x1382CA98, 37353944625530088, 89503736, 89503738, 2, 640x360 
0x1382CA98, 37353944625851392, 89503771, 89503773, 2, 640x360 
0x1382CA98, 37353944626173720, 89503799, 89503808, 9, 640x360 
0x1382CA98, 37353944626490104, 89503838, 89503840, 2, 640x360 
0x1382CA98, 37353944626809016, 89503872, 89503875, 3, 640x360 
0x1382CA98, 37353944627128368, 89503898, 89503906, 8, 640x360 
0x1382CA98, 37353944627447496, 89503928, 89503938, 10, 640x360 
0x1382CA98, 37353944627773728, 89503971, 89503974, 3, 640x360 
0x1382CA98, 37353944628092528, 89503995, 89504004, 9, 640x360 
0x1382CA98, 37353944628565952, 89504043, 89504051, 8, 640x360 
0x1382CA98, 37353944628885432, 89504075, 89504085, 10, 640x360 
0x1382CA98, 37353944629209744, 89504108, 89504117, 9, 640x360 
0x1382CA98, 37353944629525824, 89504139, 89504142, 3, 640x360 
0x1382CA98, 37353944629845848, 89504171, 89504172, 1, 640x360 
0x1382CA98, 37353944630180832, 89504208, 89504212, 4, 640x360 
0x1382CA98, 37353944630486344, 89504242, 89504245, 3, 640x360 
0x1382CA98, 37353944630814480, 89504265, 89504272, 7, 640x360 
0x1382CA98, 37353944631128520, 89504298, 89504301, 3, 640x360 
0x1382CA98, 37353944631450720, 89504325, 89504331, 6, 640x360 
0x1382CA98, 37353944631767128, 89504356, 89504362, 6, 640x360 
0x1382CA98, 37353944632093240, 89504388, 89504391, 3, 640x360 
0x1382CA98, 37353944632566000, 89504444, 89504447, 3, 640x360 
0x1382CA98, 37353944632890712, 89504476, 89504480, 4, 640x360 
0x1382CA98, 37353944633205912, 89504500, 89504504, 4, 640x360 
0x1382CA98, 37353944633526472, 89504531, 89504537, 6, 640x360 
0x1382CA98, 37353944633850464, 89504564, 89504567, 3, 640x360 
0x1382CA98, 37353944634170840, 89504597, 89504601, 4, 640x360 
0x1382CA98, 37353944634488776, 89504633, 89504640, 7, 640x360 
0x1382CA98, 37353944634825920, 89504668, 89504670, 2, 640x360 
0x1382CA98, 37353944635126904, 89504706, 89504708, 2, 640x360 
0x1382CA98, 37353944635455232, 89504745, 89504748, 3, 640x360 
0x1382CA98, 37353944635772440, 89504767, 89504774, 7, 640x360 
0x1382CA98, 37353944636098032, 89504794, 89504801, 7, 640x360 
0x1382CA98, 37353944636581568, 89504861, 89504869, 8, 640x360 
0x1382CA98, 37353944636885880, 89504891, 89504906, 15, 640x360 
0x1382CA98, 37353944637213304, 89504921, 89504924, 3, 640x360 
0x1382CA98, 37353944637526672, 89504956, 89504964, 8, 640x360 
0x1382CA98, 37353944637854912, 89504978, 89504996, 18, 640x360 
0x1382CA98, 37353944638174320, 89505018, 89505021, 3, 640x360 
0x1382CA98, 37353944638491960, 89505056, 89505062, 6, 640x360 
0x1382CA98, 37353944638809960, 89505082, 89505084, 2, 640x360 
0x1382CA98, 37353944639128000, 89505094, 89505098, 4, 640x360 
0x1382CA98, 37353944639449576, 89505136, 89505144, 8, 640x360 
0x1382CA98, 37353944639777064, 89505163, 89505167, 4, 640x360 
0x1382CA98, 37353944640091352, 89505196, 89505203, 7, 640x360 
0x1382CA98, 37353944640566008, 89505242, 89505252, 10, 640x360 
0x1382CA98, 37353944640885304, 89505281, 89505287, 6, 640x360 
0x1382CA98, 37353944641207512, 89505305, 89505308, 3, 640x360 
0x1382CA98, 37353944641525968, 89505343, 89505346, 3, 640x360 
0x1382CA98, 37353944641845512, 89505367, 89505371, 4, 640x360 
0x1382CA98, 37353944642168576, 89505408, 89505420, 12, 640x360 
0x1382CA98, 37353944642488904, 89505432, 89505439, 7, 640x360 
0x1382CA98, 37353944642809448, 89505476, 89505480, 4, 640x360 
0x1382CA98, 37353944643130408, 89505497, 89505500, 3, 640x360 
0x1382CA98, 37353944643445704, 89505526, 89505529, 3, 640x360 
0x1382CA98, 37353944643776792, 89505558, 89505563, 5, 640x360 
0x1382CA98, 37353944644094904, 89505590, 89505593, 3, 640x360 
0x1382CA98, 37353944644565816, 89505641, 89505646, 5, 640x360 
0x1382CA98, 37353944644885272, 89505672, 89505676, 4, 640x360 
0x1382CA98, 37353944645206040, 89505707, 89505712, 5, 640x360 
0x1382CA98, 37353944645593192, 89505739, 89505749, 10, 640x360 
0x1382CA98, 37353944645847704, 89505766, 89505769, 3, 640x360 
0x1382CA98, 37353944646165680, 89505806, 89505809, 3, 640x360 
0x1382CA98, 37353944646493704, 89505837, 89505841, 4, 640x360 
0x1382CA98, 37353944646809600, 89505868, 89505871, 3, 640x360 
0x1382CA98, 37353944647136672, 89505901, 89505907, 6, 640x360 
0x1382CA98, 37353944647446560, 89505934, 89505937, 3, 640x360 
0x1382CA98, 37353944647770080, 89505963, 89505971, 8, 640x360 
0x1382CA98, 37353944648100424, 89505988, 89505996, 8, 640x360 
0x1382CA98, 37353944648571032, 89506045, 89506047, 2, 640x360 
0x1382CA98, 37353944648888088, 89506081, 89506087, 6, 640x360 
0x1382CA98, 37353944649205768, 89506112, 89506118, 6, 640x360 
0x1382CA98, 37353944649544104, 89506147, 89506155, 8, 640x360 
0x1382CA98, 37353944649849912, 89506177, 89506181, 4, 640x360 
0x1382CA98, 37353944650170184, 89506209, 89506232, 23, 640x360 
0x1382CA98, 37353944650532048, 89506259, 89506266, 7, 640x360 
0x1382CA98, 37353944650821664, 89506270, 89506272, 2, 640x360 
0x1382CA98, 37353944651126112, 89506303, 89506305, 2, 640x360 
0x1382CA98, 37353944651448952, 89506329, 89506337, 8, 640x360 
0x1382CA98, 37353944651775840, 89506359, 89506366, 7, 640x360 
0x1382CA98, 37353944652092088, 89506391, 89506400, 9, 640x360 
0x1382CA98, 37353944652410680, 89506420, 89506422, 2, 640x360 
0x1382CA98, 37353944652884832, 89506475, 89506485, 10, 640x360 
0x1382CA98, 37353944653208056, 89506507, 89506519, 12, 640x360 
0x1382CA98, 37353944653525600, 89506543, 89506551, 8, 640x360 
0x1382CA98, 37353944653847520, 89506574, 89506580, 6, 640x360 
0x1382CA98, 37353944654168056, 89506597, 89506614, 17, 640x360 
0x1382CA98, 37353944654490040, 89506631, 89506634, 3, 640x360 
0x1382CA98, 37353944654805696, 89506666, 89506671, 5, 640x360 
0x1382CA98, 37353944655125816, 89506694, 89506701, 7, 640x360 
0x1382CA98, 37353944655445264, 89506739, 89506742, 3, 640x360 
0x1382CA98, 37353944655771592, 89506770, 89506772, 2, 640x360 
0x1382CA98, 37353944656091192, 89506805, 89506807, 2, 640x360 
0x1382CA98, 37353944656412248, 89506822, 89506828, 6, 640x360 
0x1382CA98, 37353944656885352, 89506870, 89506873, 3, 640x360 
0x1382CA98, 37353944657206648, 89506905, 89506907, 2, 640x360 
0x1382CA98, 37353944657525000, 89506934, 89506937, 3, 640x360 
0x1382CA98, 37353944657845312, 89506966, 89506968, 2, 640x360 
0x1382CA98, 37353944658165848, 89506998, 89507001, 3, 640x360 
0x1382CA98, 37353944658485776, 89507035, 89507040, 5, 640x360 
0x1382CA98, 37353944658806072, 89507065, 89507067, 2, 640x360 
0x1382CA98, 37353944659126944, 89507096, 89507099, 3, 640x360 
0x1382CA98, 37353944659447296, 89507128, 89507133, 5, 640x360 
0x1382CA98, 37353944659766000, 89507156, 89507160, 4, 640x360 
0x1382CA98, 37353944660085600, 89507187, 89507190, 3, 640x360 
0x1382CA98, 37353944660407232, 89507218, 89507221, 3, 640x360 
0x1382CA98, 37353944660885344, 89507275, 89507279, 4, 640x360 
0x1382CA98, 37353944661205224, 89507306, 89507309, 3, 640x360 
0x1382CA98, 37353944661524968, 89507332, 89507334, 2, 640x360 
0x1382CA98, 37353944661850880, 89507374, 89507378, 4, 640x360 
0x1382CA98, 37353944662169904, 89507397, 89507399, 2, 640x360 
0x1382CA98, 37353944662486080, 89507429, 89507432, 3, 640x360 
0x1382CA98, 37353944662809200, 89507466, 89507468, 2, 640x360 
0x1382CA98, 37353944663126168, 89507493, 89507498, 5, 640x360 
0x1382CA98, 37353944663449488, 89507527, 89507530, 3, 640x360 
0x1382CA98, 37353944663767224, 89507561, 89507567, 6, 640x360 
0x1382CA98, 37353944664092144, 89507594, 89507601, 7, 640x360 
0x1382CA98, 37353944664425360, 89507625, 89507633, 8, 640x360 
0x1382CA98, 37353944664885256, 89507672, 89507675, 3, 640x360 
0x1382CA98, 37353944665210560, 89507704, 89507706, 2, 640x360 
0x1382CA98, 37353944665528992, 89507736, 89507738, 2, 640x360 
0x1382CA98, 37353944665845992, 89507770, 89507775, 5, 640x360 
0x1382CA98, 37353944666165640, 89507800, 89507806, 6, 640x360 
0x1382CA98, 37353944666485088, 89507829, 89507831, 2, 640x360 
0x1382CA98, 37353944666809496, 89507865, 89507872, 7, 640x360 
0x1382CA98, 37353944667126280, 89507897, 89507899, 2, 640x360 
0x1382CA98, 37353944667453576, 89507932, 89507935, 3, 640x360 
0x1382CA98, 37353944667765504, 89507963, 89507966, 3, 640x360 
0x1382CA98, 37353944668085312, 89507996, 89507998, 2, 640x360 
0x1382CA98, 37353944668412896, 89508029, 89508036, 7, 640x360 
0x1382CA98, 37353944668884664, 89508080, 89508087, 7, 640x360 
0x1382CA98, 37353944669205632, 89508114, 89508121, 7, 640x360 
0x1382CA98, 37353944669526960, 89508144, 89508150, 6, 640x360 
0x1382CA98, 37353944669845616, 89508178, 89508182, 4, 640x360 
0x1382CA98, 37353944670165232, 89508209, 89508212, 3, 640x360 
0x1382CA98, 37353944670488696, 89508231, 89508233, 2, 640x360 
0x1382CA98, 37353944670807688, 89508266, 89508268, 2, 640x360 
0x1382CA98, 37353944671128672, 89508299, 89508302, 3, 640x360 
0x1382CA98, 37353944671449072, 89508328, 89508333, 5, 640x360 
0x1382CA98, 37353944671764824, 89508357, 89508365, 8, 640x360 
0x1382CA98, 37353944672085544, 89508388, 89508392, 4, 640x360 
0x1382CA98, 37353944672406656, 89508426, 89508429, 3, 640x360 
0x1382CA98, 37353944672885296, 89508473, 89508478, 5, 640x360 
0x1382CA98, 37353944673208352, 89508504, 89508508, 4, 640x360 
0x1382CA98, 37353944673526072, 89508545, 89508556, 11, 640x360 
0x1382CA98, 37353944673847152, 89508575, 89508585, 10, 640x360 
0x1382CA98, 37353944674165248, 89508599, 89508602, 3, 640x360 
0x1382CA98, 37353944674491232, 89508639, 89508641, 2, 640x360 
0x1382CA98, 37353944674813152, 89508673, 89508676, 3, 640x360 
0x1382CA98, 37353944675129944, 89508700, 89508708, 8, 640x360 
0x1382CA98, 37353944675445304, 89508722, 89508725, 3, 640x360 
0x1382CA98, 37353944675768344, 89508764, 89508769, 5, 640x360 
0x1382CA98, 37353944676093672, 89508797, 89508803, 6, 640x360 
0x1382CA98, 37353944676418688, 89508829, 89508836, 7, 640x360 
0x1382CA98, 37353944676885432, 89508870, 89508877, 7, 640x360 
0x1382CA98, 37353944677205080, 89508899, 89508901, 2, 640x360 
0x1382CA98, 37353944677528256, 89508939, 89508944, 5, 640x360 
0x1382CA98, 37353944677848552, 89508966, 89508969, 3, 640x360 
0x1382CA98, 37353944678164536, 89509005, 89509008, 3, 640x360 
0x1382CA98, 37353944678487760, 89509034, 89509036, 2, 640x360 
0x1382CA98, 37353944678811472, 89509065, 89509068, 3, 640x360 
0x1382CA98, 37353944679151472, 89509099, 89509102, 3, 640x360 
0x1382CA98, 37353944679459048, 89509139, 89509155, 16, 640x360 
0x1382CA98, 37353944679773888, 89509178, 89509185, 7, 640x360 
0x1382CA98, 37353944680103216, 89509212, 89509216, 4, 640x360 
0x1382CA98, 37353944680432984, 89509238, 89509243, 5, 640x360 
0x1382CA98, 37353944680751144, 89509285, 89509287, 2, 640x360 
0x1382CA98, 37353944681205136, 89509318, 89509322, 4, 640x360 
0x1382CA98, 37353944681528792, 89509347, 89509350, 3, 640x360 
0x1382CA98, 37353944681848712, 89509374, 89509379, 5, 640x360 
0x1382CA98, 37353944682168112, 89509401, 89509402, 1, 640x360 
0x1382CA98, 37353944682491312, 89509433, 89509441, 8, 640x360 
0x1382CA98, 37353944682804568, 89509462, 89509475, 13, 640x360 
0x1382CA98, 37353944683125480, 89509498, 89509501, 3, 640x360 
0x1382CA98, 37353944683450592, 89509527, 89509531, 4, 640x360 
0x1382CA98, 37353944683773680, 89509561, 89509571, 10, 640x360 
0x1382CA98, 37353944684091504, 89509599, 89509605, 6, 640x360 
0x1382CA98, 37353944684421344, 89509622, 89509625, 3, 640x360 
0x1382CA98, 37353944684725312, 89509658, 89509669, 11, 640x360 
0x1382CA98, 37353944685208160, 89509704, 89509707, 3, 640x360 
0x1382CA98, 37353944685535712, 89509737, 89509739, 2, 640x360 
0x1382CA98, 37353944685848768, 89509770, 89509772, 2, 640x360 
0x1382CA98, 37353944686169008, 89509803, 89509810, 7, 640x360 
0x1382CA98, 37353944686485120, 89509842, 89509846, 4, 640x360 
0x1382CA98, 37353944686808432, 89509868, 89509870, 2, 640x360 
0x1382CA98, 37353944687127880, 89509897, 89509908, 11, 640x360 
0x1382CA98, 37353944687445048, 89509923, 89509926, 3, 640x360 
0x1382CA98, 37353944687780016, 89509965, 89509967, 2, 640x360 
0x1382CA98, 37353944688086200, 89509989, 89509993, 4, 640x360 
0x1382CA98, 37353944688426448, 89510020, 89510022, 2, 640x360 
0x1382CA98, 37353944688726568, 89510054, 89510057, 3, 640x360 
0x1382CA98, 37353944689204872, 89510104, 89510106, 2, 640x360 
0x1382CA98, 37353944689528720, 89510136, 89510139, 3, 640x360 
0x1382CA98, 37353944689852608, 89510171, 89510173, 2, 640x360 
0x1382CA98, 37353944690167704, 89510204, 89510206, 2, 640x360 
0x1382CA98, 37353944690487768, 89510235, 89510241, 6, 640x360 
0x1382CA98, 37353944690804528, 89510273, 89510275, 2, 640x360 
0x1382CA98, 37353944691125048, 89510305, 89510308, 3, 640x360 
0x1382CA98, 37353944691444712, 89510327, 89510335, 8, 640x360 
0x1382CA98, 37353944691767912, 89510371, 89510373, 2, 640x360 
0x1382CA98, 37353944692091088, 89510389, 89510396, 7, 640x360 
0x1382CA98, 37353944692410264, 89510421, 89510425, 4, 640x360 
0x1382CA98, 37353944692725936, 89510454, 89510457, 3, 640x360 
0x1382CA98, 37353944693204248, 89510503, 89510505, 2, 640x360 
0x1382CA98, 37353944693528448, 89510534, 89510536, 2, 640x360 
0x1382CA98, 37353944693851976, 89510570, 89510575, 5, 640x360 
0x1382CA98, 37353944694165064, 89510600, 89510610, 10, 640x360 
0x1382CA98, 37353944694484648, 89510637, 89510641, 4, 640x360 
0x1382CA98, 37353944694804912, 89510664, 89510673, 9, 640x360 
0x1382CA98, 37353944695129568, 89510694, 89510701, 7, 640x360 
0x1382CA98, 37353944695446472, 89510725, 89510736, 11, 640x360 
0x1382CA98, 37353944695769384, 89510765, 89510768, 3, 640x360 
0x1382CA98, 37353944696091072, 89510791, 89510801, 10, 640x360 
0x1382CA98, 37353944696423352, 89510838, 89510842, 4, 640x360 
0x1382CA98, 37353944696726040, 89510866, 89510869, 3, 640x360 
0x1382CA98, 37353944697204144, 89510903, 89510906, 3, 640x360 
0x1382CA98, 37353944697525272, 89510946, 89510954, 8, 640x360 
0x1382CA98, 37353944697851896, 89510975, 89510979, 4, 640x360 
0x1382CA98, 37353944698163936, 89510999, 89511001, 2, 640x360 
0x1382CA98, 37353944698485232, 89511032, 89511034, 2, 640x360 
0x1382CA98, 37353944698806960, 89511063, 89511067, 4, 640x360 
0x1382CA98, 37353944699124600, 89511094, 89511097, 3, 640x360 
0x1382CA98, 37353944699450784, 89511131, 89511133, 2, 640x360 
0x1382CA98, 37353944699765776, 89511158, 89511171, 13, 640x360 
0x1382CA98, 37353944700101152, 89511193, 89511201, 8, 640x360 
0x1382CA98, 37353944700413192, 89511228, 89511235, 7, 640x360 
0x1382CA98, 37353944700724888, 89511256, 89511269, 13, 640x360 
0x1382CA98, 37353944701326592, 89511335, 89511352, 17, 640x360 
0x1382CA98, 37353944701548624, 89511353, 89511365, 12, 640x360 
0x1382CA98, 37353944701848176, 89511373, 89511400, 27, 640x360 
0x1382CA98, 37353944702164144, 89511413, 89511415, 2, 640x360 
0x1382CA98, 37353944702484264, 89511445, 89511448, 3, 640x360 
0x1382CA98, 37353944702806200, 89511469, 89511476, 7, 640x360 
0x1382CA98, 37353944703127856, 89511490, 89511496, 6, 640x360 
0x1382CA98, 37353944703450160, 89511532, 89511535, 3, 640x360 
0x1382CA98, 37353944703776488, 89511555, 89511558, 3, 640x360 
0x1382CA98, 37353944704095664, 89511596, 89511599, 3, 640x360 
0x1382CA98, 37353944704421464, 89511630, 89511633, 3, 640x360 
0x1382CA98, 37353944704725008, 89511661, 89511663, 2, 640x360 
0x1382CA98, 37353944705044208, 89511695, 89511698, 3, 640x360 
0x1382CA98, 37353944705527376, 89511738, 89511740, 2, 640x360 
0x1382CA98, 37353944705844008, 89511764, 89511767, 3, 640x360 
0x1382CA98, 37353944706168440, 89511800, 89511802, 2, 640x360 
0x1382CA98, 37353944706487688, 89511832, 89511839, 7, 640x360 
0x1382CA98, 37353944706804696, 89511866, 89511873, 7, 640x360 
0x1382CA98, 37353944707124856, 89511894, 89511898, 4, 640x360 
0x1382CA98, 37353944707443928, 89511922, 89511929, 7, 640x360 
0x1382CA98, 37353944707772144, 89511954, 89511957, 3, 640x360 
0x1382CA98, 37353944708089272, 89511999, 89512002, 3, 640x360 
0x1382CA98, 37353944708461432, 89512024, 89512027, 3, 640x360 
0x1382CA98, 37353944708738720, 89512056, 89512058, 2, 640x360 
0x1382CA98, 37353944709048296, 89512097, 89512099, 2, 640x360 
0x1382CA98, 37353944709525040, 89512147, 89512149, 2, 640x360 
0x1382CA98, 37353944709843800, 89512167, 89512177, 10, 640x360 
0x1382CA98, 37353944710168064, 89512200, 89512202, 2, 640x360 
0x1382CA98, 37353944710488152, 89512240, 89512245, 5, 640x360 
0x1382CA98, 37353944710804224, 89512267, 89512269, 2, 640x360 
0x1382CA98, 37353944711123560, 89512310, 89512313, 3, 640x360 
0x1382CA98, 37353944711444272, 89512333, 89512336, 3, 640x360 
0x1382CA98, 37353944711765320, 89512355, 89512359, 4, 640x360 
0x1382CA98, 37353944712092088, 89512387, 89512390, 3, 640x360 
0x1382CA98, 37353944712405056, 89512419, 89512421, 2, 640x360 
0x1382CA98, 37353944712725472, 89512455, 89512459, 4, 640x360 
0x1382CA98, 37353944713044952, 89512497, 89512504, 7, 640x360 
0x1382CA98, 37353944713525288, 89512544, 89512548, 4, 640x360 
0x1382CA98, 37353944713845408, 89512580, 89512587, 7, 640x360 
0x1382CA98, 37353944714166544, 89512616, 89512619, 3, 640x360 
0x1382CA98, 37353944714489976, 89512636, 89512639, 3, 640x360 
0x1382CA98, 37353944714831232, 89512670, 89512671, 1, 640x360 
0x1382CA98, 37353944715124016, 89512703, 89512709, 6, 640x360 
0x1382CA98, 37353944715444904, 89512732, 89512742, 10, 640x360 
0x1382CA98, 37353944715773056, 89512764, 89512766, 2, 640x360 
0x1382CA98, 37353944716089712, 89512793, 89512803, 10, 640x360 
0x1382CA98, 37353944716428040, 89512828, 89512835, 7, 640x360 
0x1382CA98, 37353944716724528, 89512858, 89512868, 10, 640x360 
0x1382CA98, 37353944717527000, 89512939, 89512941, 2, 640x360 
0x1382CA98, 37353944717844224, 89512966, 89512973, 7, 640x360 
0x1382CA98, 37353944718164008, 89512997, 89513002, 5, 640x360 
0x1382CA98, 37353944718484496, 89513030, 89513034, 4, 640x360 
0x1382CA98, 37353944718806832, 89513068, 89513070, 2, 640x360 
0x1382CA98, 37353944719124280, 89513096, 89513100, 4, 640x360 
0x1382CA98, 37353944719444152, 89513136, 89513151, 15, 640x360 
0x1382CA98, 37353944719767416, 89513168, 89513170, 2, 640x360 
0x1382CA98, 37353944720085032, 89513187, 89513189, 2, 640x360 
0x1382CA98, 37353944720409480, 89513227, 89513231, 4, 640x360 
0x1382CA98, 37353944720724296, 89513263, 89513271, 8, 640x360 
0x1382CA98, 37353944721044552, 89513288, 89513290, 2, 640x360 
0x1382CA98, 37353944721523048, 89513337, 89513339, 2, 640x360 
0x1382CA98, 37353944721843920, 89513364, 89513372, 8, 640x360 
0x1382CA98, 37353944722164064, 89513404, 89513406, 2, 640x360 
0x1382CA98, 37353944722486816, 89513428, 89513432, 4, 640x360 
0x1382CA98, 37353944722808008, 89513458, 89513468, 10, 640x360 
0x1382CA98, 37353944723123976, 89513494, 89513500, 6, 640x360 
0x1382CA98, 37353944723444200, 89513525, 89513535, 10, 640x360 
0x1382CA98, 37353944723764528, 89513561, 89513567, 6, 640x360 
0x1382CA98, 37353944724093160, 89513590, 89513601, 11, 640x360 
0x1382CA98, 37353944724404216, 89513621, 89513624, 3, 640x360 
0x1382CA98, 37353944724724320, 89513655, 89513658, 3, 640x360 
0x1382CA98, 37353944725047472, 89513684, 89513687, 3, 640x360 
0x1382CA98, 37353944725527872, 89513738, 89513742, 4, 640x360 
0x1382CA98, 37353944725843864, 89513770, 89513772, 2, 640x360 
0x1382CA98, 37353944726163840, 89513798, 89513805, 7, 640x360 
0x1382CA98, 37353944726487672, 89513835, 89513837, 2, 640x360 
0x1382CA98, 37353944726815840, 89513865, 89513871, 6, 640x360 
0x1382CA98, 37353944727124064, 89513900, 89513902, 2, 640x360 
0x1382CA98, 37353944727444040, 89513927, 89513932, 5, 640x360 
0x1382CA98, 37353944727767696, 89513973, 89513979, 6, 640x360 
0x1382CA98, 37353944728093696, 89514006, 89514014, 8, 640x360 
0x1382CA98, 37353944728420168, 89514033, 89514035, 2, 640x360 
0x1382CA98, 37353944728724096, 89514061, 89514064, 3, 640x360 
0x1382CA98, 37353944729043360, 89514090, 89514095, 5, 640x360 
0x1382CA98, 37353944729523392, 89514133, 89514136, 3, 640x360 
0x1382CA98, 37353944729846144, 89514178, 89514180, 2, 640x360 
0x1382CA98, 37353944730169096, 89514203, 89514204, 1, 640x360 
0x1382CA98, 37353944730486656, 89514234, 89514240, 6, 640x360 
0x1382CA98, 37353944730808392, 89514261, 89514265, 4, 640x360 
0x1382CA98, 37353944731123760, 89514298, 89514300, 2, 640x360 
0x1382CA98, 37353944731444064, 89514322, 89514325, 3, 640x360 
0x1382CA98, 37353944731766640, 89514363, 89514365, 2, 640x360 
0x1382CA98, 37353944732085632, 89514389, 89514406, 17, 640x360 
0x1382CA98, 37353944732448640, 89514430, 89514436, 6, 640x360 
0x1382CA98, 37353944732735632, 89514456, 89514460, 4, 640x360 
0x1382CA98, 37353944733043696, 89514493, 89514502, 9, 640x360 
0x1382CA98, 37353944733366928, 89514518, 89514521, 3, 640x360 
0x1382CA98, 37353944733843072, 89514569, 89514571, 2, 640x360 
0x1382CA98, 37353944734166696, 89514601, 89514603, 2, 640x360 
0x1382CA98, 37353944734483800, 89514627, 89514631, 4, 640x360 
0x1382CA98, 37353944734803744, 89514660, 89514663, 3, 640x360 
0x1382CA98, 37353944735124080, 89514695, 89514697, 2, 640x360 
0x1382CA98, 37353944735447984, 89514727, 89514732, 5, 640x360 
0x1382CA98, 37353944735763200, 89514758, 89514766, 8, 640x360 
0x1382CA98, 37353944736083336, 89514789, 89514793, 4, 640x360 
0x1382CA98, 37353944736407304, 89514820, 89514822, 2, 640x360 
0x1382CA98, 37353944736730928, 89514863, 89514865, 2, 640x360 
0x1382CA98, 37353944737047904, 89514889, 89514891, 2, 640x360 
0x1382CA98, 37353944737363688, 89514927, 89514935, 8, 640x360 
0x1382CA98, 37353944737843104, 89514966, 89514970, 4, 640x360 
0x1382CA98, 37353944738163800, 89514999, 89515008, 9, 640x360 
0x1382CA98, 37353944738487104, 89515033, 89515040, 7, 640x360 
0x1382CA98, 37353944738804936, 89515067, 89515069, 2, 640x360 
0x1382CA98, 37353944739129496, 89515108, 89515114, 6, 640x360 
0x1382CA98, 37353944739445144, 89515138, 89515141, 3, 640x360 
0x1382CA98, 37353944739765864, 89515166, 89515172, 6, 640x360 
0x1382CA98, 37353944740089248, 89515195, 89515197, 2, 640x360 
0x1382CA98, 37353944740407328, 89515221, 89515224, 3, 640x360 
0x1382CA98, 37353944740755224, 89515257, 89515265, 8, 640x360 
0x1382CA98, 37353944741045880, 89515299, 89515301, 2, 640x360 
0x1382CA98, 37353944741363024, 89515325, 89515330, 5, 640x360 
0x1382CA98, 37353944741843032, 89515364, 89515369, 5, 640x360 
0x1382CA98, 37353944742163728, 89515402, 89515404, 2, 640x360 
0x1382CA98, 37353944742496464, 89515435, 89515437, 2, 640x360 
0x1382CA98, 37353944742808408, 89515471, 89515473, 2, 640x360 
0x1382CA98, 37353944743134144, 89515506, 89515511, 5, 640x360 
0x1382CA98, 37353944743444280, 89515529, 89515537, 8, 640x360 
0x1382CA98, 37353944743764904, 89515560, 89515573, 13, 640x360 
0x1382CA98, 37353944744094248, 89515603, 89515608, 5, 640x360 
0x1382CA98, 37353944744411200, 89515631, 89515633, 2, 640x360 
0x1382CA98, 37353944744722848, 89515666, 89515668, 2, 640x360 
0x1382CA98, 37353944745045824, 89515687, 89515690, 3, 640x360 
0x1382CA98, 37353944745363304, 89515729, 89515732, 3, 640x360 
0x1382CA98, 37353944745842848, 89515771, 89515773, 2, 640x360 
0x1382CA98, 37353944746172472, 89515809, 89515814, 5, 640x360 
0x1382CA98, 37353944746485256, 89515835, 89515840, 5, 640x360 
0x1382CA98, 37353944746808024, 89515866, 89515868, 2, 640x360 
0x1382CA98, 37353944747128080, 89515896, 89515907, 11, 640x360 
0x1382CA98, 37353944747446968, 89515923, 89515929, 6, 640x360 
0x1382CA98, 37353944747767064, 89515964, 89515969, 5, 640x360 
0x1382CA98, 37353944748098480, 89515992, 89516001, 9, 640x360 
0x1382CA98, 37353944748405240, 89516021, 89516023, 2, 640x360 
0x1382CA98, 37353944748724048, 89516055, 89516059, 4, 640x360 
0x1382CA98, 37353944749043552, 89516096, 89516103, 7, 640x360 
0x1382CA98, 37353944749363016, 89516132, 89516143, 11, 640x360 
0x1382CA98, 37353944749844728, 89516171, 89516175, 4, 640x360 
0x1382CA98, 37353944750175112, 89516206, 89516210, 4, 640x360 
0x1382CA98, 37353944750485808, 89516243, 89516249, 6, 640x360 
0x1382CA98, 37353944750808416, 89516274, 89516277, 3, 640x360 
0x1382CA98, 37353944751123816, 89516315, 89516319, 4, 640x360 
0x1382CA98, 37353944751466448, 89516351, 89516366, 15, 640x360 
0x1382CA98, 37353944751789920, 89516385, 89516388, 3, 640x360 
0x1382CA98, 37353944752101184, 89516422, 89516430, 8, 640x360 
0x1382CA98, 37353944752441600, 89516442, 89516463, 21, 640x360 
0x1382CA98, 37353944752755984, 89516474, 89516478, 4, 640x360 
0x1382CA98, 37353944753042944, 89516501, 89516513, 12, 640x360 
0x1382CA98, 37353944753490080, 89516556, 89516560, 4, 640x360 
0x1382CA98, 37353944753843976, 89516579, 89516602, 23, 640x360 
0x1382CA98, 37353944754176088, 89516615, 89516618, 3, 640x360 
0x1382CA98, 37353944754485520, 89516652, 89516669, 17, 640x360 
0x1382CA98, 37353944754846816, 89516698, 89516713, 15, 640x360 
0x1382CA98, 37353944755155248, 89516715, 89516732, 17, 640x360 
0x1382CA98, 37353944755449632, 89516752, 89516763, 11, 640x360 
0x1382CA98, 37353944755795880, 89516795, 89516800, 5, 640x360 
0x1382CA98, 37353944756127800, 89516815, 89516820, 5, 640x360 
0x1382CA98, 37353944756463328, 89516834, 89516845, 11, 640x360 
0x1382CA98, 37353944756726248, 89516874, 89516879, 5, 640x360 
0x1382CA98, 37353944757045472, 89516891, 89516898, 7, 640x360 
0x1382CA98, 37353944757362624, 89516916, 89516922, 6, 640x360 
0x1382CA98, 37353944757684936, 89516949, 89516956, 7, 640x360 
0x1382CA98, 37353944758162144, 89517004, 89517006, 2, 640x360 
0x1382CA98, 37353944758486848, 89517034, 89517045, 11, 640x360 
0x1382CA98, 37353944758805768, 89517066, 89517069, 3, 640x360 
0x1382CA98, 37353944759122688, 89517100, 89517102, 2, 640x360 
0x1382CA98, 37353944759443392, 89517134, 89517136, 2, 640x360 
0x1382CA98, 37353944759780720, 89517166, 89517172, 6, 640x360 
0x1382CA98, 37353944760101256, 89517194, 89517199, 5, 640x360 
0x1382CA98, 37353944760464104, 89517231, 89517234, 3, 640x360 
0x1382CA98, 37353944760726992, 89517256, 89517259, 3, 640x360 
0x1382CA98, 37353944761042944, 89517287, 89517291, 4, 640x360 
0x1382CA98, 37353944761367200, 89517329, 89517331, 2, 640x360 
0x1382CA98, 37353944761687496, 89517358, 89517362, 4, 640x360 
0x1382CA98, 37353944762166616, 89517399, 89517402, 3, 640x360 
0x1382CA98, 37353944762482952, 89517435, 89517437, 2, 640x360 
0x1382CA98, 37353944762802984, 89517467, 89517473, 6, 640x360 
0x1382CA98, 37353944763124304, 89517498, 89517501, 3, 640x360 
0x1382CA98, 37353944763447480, 89517524, 89517530, 6, 640x360 
0x1382CA98, 37353944763763160, 89517555, 89517558, 3, 640x360 
0x1382CA98, 37353944764094688, 89517588, 89517600, 12, 640x360 
0x1382CA98, 37353944764427128, 89517627, 89517633, 6, 640x360 
0x1382CA98, 37353944764723728, 89517661, 89517665, 4, 640x360 
0x1382CA98, 37353944765053048, 89517687, 89517690, 3, 640x360 
0x1382CA98, 37353944765369280, 89517720, 89517723, 3, 640x360 
0x1382CA98, 37353944765683800, 89517751, 89517763, 12, 640x360 
0x1382CA98, 37353944766171584, 89517799, 89517802, 3, 640x360 
0x1382CA98, 37353944766483176, 89517837, 89517839, 2, 640x360 
0x1382CA98, 37353944766811672, 89517873, 89517875, 2, 640x360 
0x1382CA98, 37353944767149224, 89517903, 89517905, 2, 640x360 
0x1382CA98, 37353944767447288, 89517932, 89517938, 6, 640x360 
0x1382CA98, 37353944767765648, 89517957, 89517960, 3, 640x360 
0x1382CA98, 37353944768087736, 89517992, 89518003, 11, 640x360 
0x1382CA98, 37353944768403880, 89518022, 89518026, 4, 640x360 
0x1382CA98, 37353944768722224, 89518059, 89518063, 4, 640x360 
0x1382CA98, 37353944769047632, 89518098, 89518101, 3, 640x360 
0x1382CA98, 37353944769365800, 89518129, 89518146, 17, 640x360 
0x1382CA98, 37353944769725744, 89518171, 89518174, 3, 640x360 
0x1382CA98, 37353944770172040, 89518206, 89518210, 4, 640x360 
0x1382CA98, 37353944770497952, 89518244, 89518252, 8, 640x360 
0x1382CA98, 37353944770809144, 89518264, 89518272, 8, 640x360 
0x1382CA98, 37353944771127504, 89518294, 89518304, 10, 640x360 
0x1382CA98, 37353944771441752, 89518330, 89518338, 8, 640x360 
0x1382CA98, 37353944771768376, 89518361, 89518371, 10, 640x360 
0x1382CA98, 37353944772088152, 89518389, 89518393, 4, 640x360 
0x1382CA98, 37353944772402544, 89518430, 89518435, 5, 640x360 
0x1382CA98, 37353944772725848, 89518455, 89518458, 3, 640x360 
0x1382CA98, 37353944773042664, 89518496, 89518500, 4, 640x360 
0x1382CA98, 37353944773368760, 89518530, 89518533, 3, 640x360 
0x1382CA98, 37353944773685912, 89518552, 89518555, 3, 640x360 
0x1382CA98, 37353944774161776, 89518603, 89518606, 3, 640x360 
0x1382CA98, 37353944774484088, 89518634, 89518636, 2, 640x360 
0x1382CA98, 37353944774802400, 89518665, 89518667, 2, 640x360 
0x1382CA98, 37353944775125808, 89518698, 89518701, 3, 640x360 
0x1382CA98, 37353944775442768, 89518731, 89518733, 2, 640x360 
0x1382CA98, 37353944775767728, 89518757, 89518760, 3, 640x360 
0x1382CA98, 37353944776099976, 89518799, 89518810, 11, 640x360 
0x1382CA98, 37353944776404072, 89518821, 89518823, 2, 640x360 
0x1382CA98, 37353944776722848, 89518855, 89518858, 3, 640x360 
0x1382CA98, 37353944777055256, 89518897, 89518899, 2, 640x360 
0x1382CA98, 37353944777362264, 89518921, 89518922, 1, 640x360 
0x1382CA98, 37353944777686704, 89518957, 89518962, 5, 640x360 
0x1382CA98, 37353944778161976, 89519007, 89519013, 6, 640x360 
0x1382CA98, 37353944778487688, 89519043, 89519053, 10, 640x360 
0x1382CA98, 37353944778827328, 89519071, 89519075, 4, 640x360 
0x1382CA98, 37353944779128928, 89519102, 89519104, 2, 640x360 
0x1382CA98, 37353944779497208, 89519136, 89519139, 3, 640x360 
0x1382CA98, 37353944779773808, 89519171, 89519173, 2, 640x360 
0x1382CA98, 37353944780110704, 89519200, 89519202, 2, 640x360 
0x1382CA98, 37353944780415616, 89519241, 89519247, 6, 640x360 
0x1382CA98, 37353944780736368, 89519278, 89519282, 4, 640x360 
0x1382CA98, 37353944781059736, 89519294, 89519297, 3, 640x360 
0x1382CA98, 37353944781361848, 89519327, 89519335, 8, 640x360 
0x1382CA98, 37353944781685680, 89519351, 89519355, 4, 640x360 
0x1382CA98, 37353944782161784, 89519398, 89519402, 4, 640x360 
0x1382CA98, 37353944782497528, 89519434, 89519437, 3, 640x360 
0x1382CA98, 37353944782810864, 89519478, 89519481, 3, 640x360 
0x1382CA98, 37353944783125528, 89519503, 89519505, 2, 640x360 
0x1382CA98, 37353944783445736, 89519532, 89519538, 6, 640x360 
0x1382CA98, 37353944783765904, 89519555, 89519558, 3, 640x360 
0x1382CA98, 37353944784099728, 89519589, 89519593, 4, 640x360 
0x1382CA98, 37353944784415648, 89519627, 89519635, 8, 640x360 
0x1382CA98, 37353944784726176, 89519664, 89519671, 7, 640x360 
0x1382CA98, 37353944785042472, 89519696, 89519704, 8, 640x360 
0x1382CA98, 37353944785362888, 89519728, 89519731, 3, 640x360 
0x1382CA98, 37353944785682112, 89519751, 89519754, 3, 640x360 
0x1382CA98, 37353944786008968, 89519787, 89519789, 2, 640x360 
0x1382CA98, 37353944786482112, 89519833, 89519840, 7, 640x360 
0x1382CA98, 37353944786804472, 89519868, 89519872, 4, 640x360 
0x1382CA98, 37353944787125640, 89519899, 89519905, 6, 640x360 
0x1382CA98, 37353944787442424, 89519923, 89519936, 13, 640x360 
0x1382CA98, 37353944787762576, 89519956, 89519959, 3, 640x360 
0x1382CA98, 37353944788094640, 89519991, 89520004, 13, 640x360 
0x1382CA98, 37353944788424656, 89520031, 89520033, 2, 640x360 
0x1382CA98, 37353944788721640, 89520057, 89520060, 3, 640x360 
0x1382CA98, 37353944789045496, 89520087, 89520090, 3, 640x360 
0x1382CA98, 37353944789361808, 89520120, 89520122, 2, 640x360 
0x1382CA98, 37353944789686280, 89520158, 89520171, 13, 640x360 
0x1382CA98, 37353944790021488, 89520197, 89520204, 7, 640x360 
0x1382CA98, 37353944790481704, 89520238, 89520240, 2, 640x360 
0x1382CA98, 37353944790804272, 89520279, 89520283, 4, 640x360 
0x1382CA98, 37353944791124784, 89520301, 89520303, 2, 640x360 
0x1382CA98, 37353944791456056, 89520333, 89520341, 8, 640x360 
0x1382CA98, 37353944791766592, 89520365, 89520378, 13, 640x360 
0x1382CA98, 37353944792088120, 89520398, 89520402, 4, 640x360 
0x1382CA98, 37353944792430768, 89520445, 89520449, 4, 640x360 
0x1382CA98, 37353944792723024, 89520466, 89520468, 2, 640x360 
0x1382CA98, 37353944793045480, 89520484, 89520499, 15, 640x360 
0x1382CA98, 37353944793365240, 89520526, 89520530, 4, 640x360 
0x1382CA98, 37353944793685504, 89520549, 89520555, 6, 640x360 
0x1382CA98, 37353944794016408, 89520596, 89520598, 2, 640x360 
0x1382CA98, 37353944794485088, 89520633, 89520640, 7, 640x360 
0x1382CA98, 37353944794829760, 89520667, 89520670, 3, 640x360 
0x1382CA98, 37353944795122376, 89520696, 89520712, 16, 640x360 
0x1382CA98, 37353944795498440, 89520734, 89520736, 2, 640x360 
0x1382CA98, 37353944795778376, 89520758, 89520780, 22, 640x360 
0x1382CA98, 37353944796127928, 89520796, 89520799, 3, 640x360 
0x1382CA98, 37353944796441232, 89520854, 89520862, 8, 640x360 
0x1382CA98, 37353944796787064, 89520862, 89520866, 4, 640x360 
0x1382CA98, 37353944797041976, 89520889, 89520892, 3, 640x360 
0x1382CA98, 37353944797364352, 89520917, 89520925, 8, 640x360 
0x1382CA98, 37353944797684200, 89520951, 89520953, 2, 640x360 
0x1382CA98, 37353944798005336, 89520985, 89520987, 2, 640x360 
0x1382CA98, 37353944798483352, 89521046, 89521054, 8, 640x360 
0x1382CA98, 37353944798802096, 89521074, 89521088, 14, 640x360 
0x1382CA98, 37353944799128408, 89521109, 89521121, 12, 640x360 
0x1382CA98, 37353944799453776, 89521134, 89521137, 3, 640x360 
0x1382CA98, 37353944799768600, 89521175, 89521190, 15, 640x360 
0x1382CA98, 37353944800110832, 89521201, 89521210, 9, 640x360 
0x1382CA98, 37353944800424160, 89521235, 89521237, 2, 640x360 
0x1382CA98, 37353944800725944, 89521257, 89521270, 13, 640x360 
0x1382CA98, 37353944801047816, 89521289, 89521292, 3, 640x360 
0x1382CA98, 37353944801361920, 89521322, 89521324, 2, 640x360 
0x1382CA98, 37353944801686040, 89521350, 89521356, 6, 640x360 
0x1382CA98, 37353944802004984, 89521381, 89521388, 7, 640x360 
0x1382CA98, 37353944802483800, 89521433, 89521436, 3, 640x360 
0x1382CA98, 37353944802805480, 89521468, 89521475, 7, 640x360 
0x1382CA98, 37353944803126216, 89521500, 89521502, 2, 640x360 
0x1382CA98, 37353944803452608, 89521524, 89521529, 5, 640x360 
0x1382CA98, 37353944803761736, 89521563, 89521565, 2, 640x360 
0x1382CA98, 37353944804087144, 89521588, 89521590, 2, 640x360 
0x1382CA98, 37353944804418632, 89521632, 89521639, 7, 640x360 
0x1382CA98, 37353944804725912, 89521663, 89521665, 2, 640x360 
0x1382CA98, 37353944805044928, 89521689, 89521692, 3, 640x360 
0x1382CA98, 37353944805365024, 89521728, 89521733, 5, 640x360 
0x1382CA98, 37353944805688408, 89521755, 89521757, 2, 640x360 
0x1382CA98, 37353944806001360, 89521792, 89521797, 5, 640x360 
0x1382CA98, 37353944806481552, 89521841, 89521844, 3, 640x360 
0x1382CA98, 37353944806801440, 89521869, 89521876, 7, 640x360 
0x1382CA98, 37353944807121528, 89521894, 89521906, 12, 640x360 
0x1382CA98, 37353944807447112, 89521938, 89521940, 2, 640x360 
0x1382CA98, 37353944807778392, 89521985, 89521999, 14, 640x360 
0x1382CA98, 37353944808093544, 89522007, 89522011, 4, 640x360 
0x1382CA98, 37353944808417416, 89522046, 89522055, 9, 640x360 
0x1382CA98, 37353944808738704, 89522067, 89522071, 4, 640x360 
0x1382CA98, 37353944809045560, 89522092, 89522103, 11, 640x360 
0x1382CA98, 37353944809362256, 89522131, 89522133, 2, 640x360 
0x1382CA98, 37353944809688592, 89522158, 89522162, 4, 640x360 
0x1382CA98, 37353944810012488, 89522196, 89522198, 2, 640x360 
0x1382CA98, 37353944810480520, 89522233, 89522241, 8, 640x360 
0x1382CA98, 37353944810804536, 89522267, 89522276, 9, 640x360 
0x1382CA98, 37353944811120792, 89522291, 89522305, 14, 640x360 
0x1382CA98, 37353944811442768, 89522327, 89522335, 8, 640x360 
0x1382CA98, 37353944811766824, 89522362, 89522369, 7, 640x360 
0x1382CA98, 37353944812089920, 89522392, 89522402, 10, 640x360 
0x1382CA98, 37353944812402568, 89522423, 89522428, 5, 640x360 
0x1382CA98, 37353944812721112, 89522452, 89522454, 2, 640x360 
0x1382CA98, 37353944813041488, 89522488, 89522490, 2, 640x360 
0x1382CA98, 37353944813361656, 89522520, 89522525, 5, 640x360 
0x1382CA98, 37353944813685472, 89522552, 89522559, 7, 640x360 
0x1382CA98, 37353944814002296, 89522585, 89522587, 2, 640x360 
0x1382CA98, 37353944814333672, 89522625, 89522636, 11, 640x360 
0x1382CA98, 37353944814860136, 89522689, 89522699, 10, 640x360 
0x1382CA98, 37353944815259376, 89522714, 89522720, 6, 640x360 
0x1382CA98, 37353944815456992, 89522733, 89522737, 4, 640x360 
0x1382CA98, 37353944815764688, 89522773, 89522780, 7, 640x360 
0x1382CA98, 37353944816107640, 89522802, 89522814, 12, 640x360 
0x1382CA98, 37353944816419528, 89522836, 89522838, 2, 640x360 
0x1382CA98, 37353944816726640, 89522880, 89522883, 3, 640x360 
0x1382CA98, 37353944817050152, 89522896, 89522898, 2, 640x360 
0x1382CA98, 37353944817364544, 89522918, 89522921, 3, 640x360 
0x1382CA98, 37353944817681264, 89522950, 89522958, 8, 640x360 
0x1382CA98, 37353944818005488, 89522984, 89522987, 3, 640x360 
0x1382CA98, 37353944818804664, 89523071, 89523072, 1, 320x180 
0x1382CA98, 37353944819440960, 89523128, 89523130, 2, 320x180 
0x1382CA98, 37353944820081096, 89523189, 89523194, 5, 320x180 
0x1382CA98, 37353944820720800, 89523260, 89523263, 3, 320x180 
0x1382CA98, 37353944821360856, 89523331, 89523333, 2, 320x180 
0x1382CA98, 37353944822011600, 89523390, 89523391, 1, 320x180 
0x1382CA98, 37353944822806032, 89523473, 89523475, 2, 320x180 
0x1382CA98, 37353944823455152, 89523534, 89523538, 4, 320x180 
0x1382CA98, 37353944824724584, 89523660, 89523663, 3, 320x180 
0x1382CA98, 37353944825365360, 89523720, 89523722, 2, 320x180 
0x1382CA98, 37353944826013744, 89523792, 89523795, 3, 320x180 
0x1382CA98, 37353944826805136, 89523875, 89523876, 1, 320x180 
0x1382CA98, 37353944827444920, 89523935, 89523939, 4, 320x180 
0x1382CA98, 37353944828088320, 89524001, 89524002, 1, 320x180 
0x1382CA98, 37353944828726192, 89524062, 89524064, 2, 320x180 
0x1382CA98, 37353944829362872, 89524125, 89524145, 20, 320x180 
0x1382CA98, 37353944830001728, 89524182, 89524190, 8, 320x180 
0x1382CA98, 37353944830799936, 89524272, 89524274, 2, 320x180 
0x1382CA98, 37353944831441424, 89524326, 89524332, 6, 320x180 
0x1382CA98, 37353944832087400, 89524398, 89524405, 7, 320x180 
0x1382CA98, 37353944832723144, 89524465, 89524466, 1, 320x180 
0x1382CA98, 37353944833360744, 89524521, 89524523, 2, 320x180 
0x1382CA98, 37353944834001232, 89524584, 89524586, 2, 320x180 
0x1382CA98, 37353944834801688, 89524665, 89524666, 1, 320x180 
0x1382CA98, 37353944835443480, 89524730, 89524733, 3, 320x180 
0x1382CA98, 37353944836090400, 89524797, 89524799, 2, 320x180 
0x1382CA98, 37353944836721304, 89524856, 89524860, 4, 320x180 
0x1382CA98, 37353944837361080, 89524926, 89524929, 3, 320x180 
0x1382CA98, 37353944838000848, 89524993, 89524998, 5, 320x180 
0x1382CA98, 37353944838641288, 89525050, 89525052, 2, 320x180 
0x1382CA98, 37353944839440192, 89525124, 89525137, 13, 320x180 
0x1382CA98, 37353944840090640, 89525190, 89525201, 11, 320x180 
0x1382CA98, 37353944840721720, 89525265, 89525271, 6, 320x180 
0x1382CA98, 37353944841363448, 89525318, 89525320, 2, 320x180 
0x1382CA98, 37353944842004280, 89525380, 89525382, 2, 320x180 
0x1382CA98, 37353944842641888, 89525448, 89525452, 4, 320x180 
0x1382CA98, 37353944843440656, 89525524, 89525526, 2, 320x180 
0x1382CA98, 37353944844103672, 89525593, 89525602, 9, 320x180 
0x1382CA98, 37353944844724440, 89525662, 89525663, 1, 320x180 
0x1382CA98, 37353944845364416, 89525718, 89525719, 1, 320x180 
0x1382CA98, 37353944846003320, 89525792, 89525795, 3, 320x180 
0x1382CA98, 37353944846646664, 89525851, 89525852, 1, 320x180 
0x1382CA98, 37353944847444584, 89525923, 89525925, 2, 320x180 
0x1382CA98, 37353944848121248, 89525997, 89526004, 7, 320x180 
0x1382CA98, 37353944848721488, 89526055, 89526056, 1, 320x180 
0x1382CA98, 37353944849360856, 89526130, 89526137, 7, 320x180 
0x1382CA98, 37353944850010480, 89526197, 89526199, 2, 320x180 
0x1382CA98, 37353944850677304, 89526264, 89526269, 5, 320x180 
0x1382CA98, 37353944851444024, 89526334, 89526335, 1, 320x180 
0x1382CA98, 37353944852091936, 89526393, 89526403, 10, 320x180 
0x1382CA98, 37353944852723880, 89526456, 89526462, 6, 320x180 
0x1382CA98, 37353944853363912, 89526523, 89526524, 1, 320x180 
0x1382CA98, 37353944854004384, 89526583, 89526584, 1, 320x180 
0x1382CA98, 37353944854646032, 89526651, 89526652, 1, 320x180 
0x1382CA98, 37353944855441120, 89526724, 89526730, 6, 320x180 
0x1382CA98, 37353944856086568, 89526788, 89526790, 2, 320x180 
0x1382CA98, 37353944856720624, 89526853, 89526855, 2, 320x180 
0x1382CA98, 37353944857360424, 89526917, 89526922, 5, 320x180 
0x1382CA98, 37353944858004968, 89526982, 89526984, 2, 320x180 
0x1382CA98, 37353944858646520, 89527050, 89527051, 1, 320x180 
0x1382CA98, 37353944859490144, 89527139, 89527140, 1, 320x180 
0x1382CA98, 37353944860085360, 89527195, 89527200, 5, 320x180 
0x1382CA98, 37353944860723696, 89527258, 89527269, 11, 320x180 
0x1382CA98, 37353944861359712, 89527325, 89527332, 7, 320x180 
0x1382CA98, 37353944862004336, 89527385, 89527390, 5, 320x180 
0x1382CA98, 37353944862640224, 89527450, 89527459, 9, 320x180 
0x1382CA98, 37353944863455104, 89527533, 89527535, 2, 320x180 
0x1382CA98, 37353944864080408, 89527591, 89527596, 5, 320x180 
0x1382CA98, 37353944864722136, 89527662, 89527664, 2, 320x180 
0x1382CA98, 37353944865360320, 89527723, 89527724, 1, 320x180 
0x1382CA98, 37353944866004056, 89527789, 89527796, 7, 320x180 
0x1382CA98, 37353944866646648, 89527853, 89527855, 2, 320x180 
0x1382CA98, 37353944867439360, 89527925, 89527937, 12, 320x180 
0x1382CA98, 37353944868087864, 89527996, 89528002, 6, 320x180 
0x1382CA98, 37353944868724040, 89528056, 89528062, 6, 320x180 
0x1382CA98, 37353944869361056, 89528116, 89528124, 8, 320x180 
0x1382CA98, 37353944870005704, 89528183, 89528188, 5, 320x180 
0x1382CA98, 37353944870640600, 89528247, 89528249, 2, 320x180 
0x1382CA98, 37353944871439720, 89528323, 89528325, 2, 320x180 
0x1382CA98, 37353944872080352, 89528390, 89528394, 4, 320x180 
0x1382CA98, 37353944872725648, 89528454, 89528456, 2, 320x180 
0x1382CA98, 37353944873360504, 89528528, 89528530, 2, 320x180 
0x1382CA98, 37353944874001088, 89528590, 89528592, 2, 320x180 
0x1382CA98, 37353944874642096, 89528651, 89528662, 11, 320x180 
0x1382CA98, 37353944875439864, 89528724, 89528735, 11, 320x180 
0x1382CA98, 37353944876090560, 89528794, 89528801, 7, 320x180 
0x1382CA98, 37353944876719488, 89528861, 89528868, 7, 320x180 
0x1382CA98, 37353944877359712, 89528925, 89528934, 9, 320x180 
0x1382CA98, 37353944878007952, 89528982, 89528984, 2, 320x180 
0x1382CA98, 37353944878643888, 89529055, 89529056, 1, 320x180 
0x1382CA98, 37353944879445968, 89529137, 89529139, 2, 320x180 
0x1382CA98, 37353944880083232, 89529196, 89529197, 1, 320x180 
0x1382CA98, 37353944880724912, 89529278, 89529293, 15, 320x180 
0x1382CA98, 37353944881359496, 89529336, 89529338, 2, 320x180 
0x1382CA98, 37353944882000584, 89529382, 89529383, 1, 320x180 
0x1382CA98, 37353944882644632, 89529459, 89529470, 11, 320x180 
0x1382CA98, 37353944883443544, 89529539, 89529541, 2, 320x180 
0x1382CA98, 37353944884086648, 89529605, 89529607, 2, 320x180 
0x1382CA98, 37353944884725352, 89529656, 89529657, 1, 320x180 
0x1382CA98, 37353944885363200, 89529720, 89529723, 3, 320x180 
0x1382CA98, 37353944886002216, 89529795, 89529802, 7, 320x180 
0x1382CA98, 37353944886644888, 89529855, 89529857, 2, 320x180 
0x1382CA98, 37353944887443224, 89529934, 89529946, 12, 320x180 
0x1382CA98, 37353944888084392, 89530004, 89530005, 1, 320x180 
0x1382CA98, 37353944888719968, 89530060, 89530062, 2, 320x180 
0x1382CA98, 37353944889358704, 89530123, 89530125, 2, 320x180 
0x1382CA98, 37353944889998960, 89530181, 89530186, 5, 320x180 
0x1382CA98, 37353944890643184, 89530261, 89530264, 3, 320x180 
0x1382CA98, 37353944891438728, 89530336, 89530339, 3, 320x180 
0x1382CA98, 37353944892089760, 89530423, 89530430, 7, 320x180 
0x1382CA98, 37353944892732512, 89530461, 89530463, 2, 320x180 
0x1382CA98, 37353944893358672, 89530523, 89530524, 1, 320x180 
0x1382CA98, 37353944894004464, 89530583, 89530589, 6, 320x180 
0x1382CA98, 37353944894652664, 89530653, 89530654, 1, 320x180 
0x1382CA98, 37353944895279176, 89530720, 89530721, 1, 320x180 
0x1382CA98, 37353944896084912, 89530793, 89530796, 3, 320x180 
0x1382CA98, 37353944896719304, 89530860, 89530870, 10, 320x180 
0x1382CA98, 37353944897358664, 89530919, 89530920, 1, 320x180 
0x1382CA98, 37353944897999256, 89530989, 89530990, 1, 320x180 
0x1382CA98, 37353944898643848, 89531049, 89531051, 2, 320x180 
0x1382CA98, 37353944899281160, 89531107, 89531112, 5, 320x180 
0x1382CA98, 37353944900085648, 89531196, 89531205, 9, 320x180 
0x1382CA98, 37353944900719176, 89531262, 89531264, 2, 320x180 
0x1382CA98, 37353944901358560, 89531318, 89531327, 9, 320x180 
0x1382CA98, 37353944901999616, 89531385, 89531386, 1, 320x180 
0x1382CA98, 37353944902646056, 89531456, 89531457, 1, 320x180 
0x1382CA98, 37353944903279744, 89531532, 89531539, 7, 320x180 
0x1382CA98, 37353944904148184, 89531618, 89531626, 8, 320x180 
0x1382CA98, 37353944904745096, 89531678, 89531681, 3, 320x180 
0x1382CA98, 37353944905362496, 89531722, 89531723, 1, 320x180 
0x1382CA98, 37353944906004232, 89531784, 89531785, 1, 320x180 
0x1382CA98, 37353944906960688, 89531885, 89531886, 1, 320x180 
0x1382CA98, 37353944907764544, 89531964, 89531971, 7, 320x180 
0x1382CA98, 37353944908398936, 89532039, 89532040, 1, 320x180 
0x1382CA98, 37353944909039240, 89532091, 89532095, 4, 320x180 
0x1382CA98, 37353944909686728, 89532152, 89532154, 2, 320x180 
0x1382CA98, 37353944910318600, 89532219, 89532220, 1, 320x180 
0x1382CA98, 37353944910963272, 89532279, 89532284, 5, 320x180 
0x1382CA98, 37353944911761672, 89532366, 89532367, 1, 320x180 
0x1382CA98, 37353944912413632, 89532433, 89532435, 2, 320x180 
0x1382CA98, 37353944913038864, 89532492, 89532494, 2, 320x180 
0x1382CA98, 37353944913678368, 89532560, 89532564, 4, 320x180 
0x1382CA98, 37353944914323304, 89532615, 89532618, 3, 320x180 
0x1382CA98, 37353944914963056, 89532688, 89532690, 2, 320x180 
0x1382CA98, 37353944915772792, 89532768, 89532771, 3, 320x180 
0x1382CA98, 37353944916416168, 89532842, 89532847, 5, 320x180 
0x1382CA98, 37353944917049544, 89532901, 89532911, 10, 320x180 
0x1382CA98, 37353944917683960, 89532962, 89532965, 3, 320x180 
0x1382CA98, 37353944918330448, 89533016, 89533020, 4, 320x180 
0x1382CA98, 37353944918976488, 89533084, 89533086, 2, 320x180 
0x1382CA98, 37353944919762232, 89533168, 89533174, 6, 320x180 
0x1382CA98, 37353944920398280, 89533231, 89533233, 2, 320x180 
0x1382CA98, 37353944921038040, 89533289, 89533291, 2, 320x180 
0x1382CA98, 37353944921679976, 89533359, 89533362, 3, 320x180 
0x1382CA98, 37353944922319320, 89533416, 89533424, 8, 320x180 
0x1382CA98, 37353944922958384, 89533485, 89533486, 1, 320x180 
0x1382CA98, 37353944923603152, 89533546, 89533547, 1, 320x180 
0x1382CA98, 37353944924398168, 89533621, 89533622, 1, 320x180 
0x1382CA98, 37353944925038720, 89533683, 89533686, 3, 320x180 
0x1382CA98, 37353944925683728, 89533749, 89533752, 3, 320x180 
0x1382CA98, 37353944926318832, 89533818, 89533819, 1, 320x180 
0x1382CA98, 37353944926960392, 89533881, 89533883, 2, 320x180 
0x1382CA98, 37353944927618304, 89533947, 89533950, 3, 320x180 
0x1382CA98, 37353944928428752, 89534031, 89534038, 7, 320x180 
0x1382CA98, 37353944929037976, 89534096, 89534098, 2, 320x180 
0x1382CA98, 37353944929682168, 89534155, 89534156, 1, 320x180 
0x1382CA98, 37353944930322248, 89534226, 89534236, 10, 320x180 
0x1382CA98, 37353944930987272, 89534282, 89534290, 8, 320x180 
0x1382CA98, 37353944931620160, 89534359, 89534363, 4, 320x180 
0x1382CA98, 37353944932398008, 89534424, 89534425, 1, 320x180 
0x1382CA98, 37353944933037824, 89534485, 89534487, 2, 320x180 
0x1382CA98, 37353944933678680, 89534555, 89534556, 1, 320x180 
0x1382CA98, 37353944934320312, 89534631, 89534635, 4, 320x180 
0x1382CA98, 37353944934958856, 89534697, 89534699, 2, 320x180 
0x1382CA98, 37353944935601040, 89534750, 89534752, 2, 320x180 
0x1382CA98, 37353944936407928, 89534820, 89534822, 2, 320x180 
0x1382CA98, 37353944937040080, 89534887, 89534889, 2, 320x180 
0x1382CA98, 37353944937677880, 89534948, 89534955, 7, 320x180 
0x1382CA98, 37353944938317688, 89535009, 89535012, 3, 320x180 
0x1382CA98, 37353944938962680, 89535077, 89535080, 3, 320x180 
0x1382CA98, 37353944939615040, 89535148, 89535150, 2, 320x180 
0x1382CA98, 37353944940429888, 89535227, 89535239, 12, 320x180 
0x1382CA98, 37353944941038440, 89535299, 89535300, 1, 320x180 
0x1382CA98, 37353944941681560, 89535362, 89535364, 2, 320x180 
0x1382CA98, 37353944942318320, 89535417, 89535419, 2, 320x180 
0x1382CA98, 37353944942958864, 89535474, 89535477, 3, 320x180 
0x1382CA98, 37353944943602048, 89535542, 89535554, 12, 320x180 
0x1382CA98, 37353944944403752, 89535631, 89535633, 2, 320x180 
0x1382CA98, 37353944945044744, 89535696, 89535698, 2, 320x180 
0x1382CA98, 37353944945678512, 89535757, 89535758, 1, 320x180 
0x1382CA98, 37353944946318344, 89535819, 89535824, 5, 320x180 
0x1382CA98, 37353944946958232, 89535876, 89535888, 12, 320x180 
0x1382CA98, 37353944947599264, 89535948, 89535955, 7, 320x180 
0x1382CA98, 37353944948405664, 89536024, 89536028, 4, 320x180 
0x1382CA98, 37353944949041560, 89536087, 89536089, 2, 320x180 
0x1382CA98, 37353944949681496, 89536153, 89536155, 2, 320x180 
0x1382CA98, 37353944950321240, 89536216, 89536224, 8, 320x180 
0x1382CA98, 37353944950958728, 89536281, 89536283, 2, 320x180 
0x1382CA98, 37353944951604624, 89536348, 89536349, 1, 320x180 
0x1382CA98, 37353944952426320, 89536432, 89536436, 4, 320x180 
0x1382CA98, 37353944953049872, 89536502, 89536506, 4, 320x180 
0x1382CA98, 37353944953684952, 89536565, 89536574, 9, 320x180 
0x1382CA98, 37353944954341672, 89536638, 89536640, 2, 320x180 
0x1382CA98, 37353944954964968, 89536704, 89536708, 4, 320x180 
0x1382CA98, 37353944955622472, 89536767, 89536773, 6, 320x180 
0x1382CA98, 37353944956399080, 89536863, 89536880, 17, 320x180 
0x1382CA98, 37353944957108552, 89536921, 89536923, 2, 320x180 
0x1382CA98, 37353944957713896, 89536979, 89536990, 11, 320x180 
0x1382CA98, 37353944958360184, 89537045, 89537050, 5, 320x180 
0x1382CA98, 37353944958958800, 89537097, 89537106, 9, 320x180 
0x1382CA98, 37353944959607680, 89537157, 89537158, 1, 320x180 
0x1382CA98, 37353944960397096, 89537222, 89537225, 3, 320x180 
0x1382CA98, 37353944961040936, 89537292, 89537296, 4, 320x180 
0x1382CA98, 37353944961676912, 89537348, 89537350, 2, 320x180 
0x1382CA98, 37353944962335072, 89537418, 89537420, 2, 320x180 
0x1382CA98, 37353944962958224, 89537484, 89537485, 1, 320x180 
0x1382CA98, 37353944963601976, 89537545, 89537553, 8, 320x180 
0x1382CA98, 37353944964425864, 89537638, 89537640, 2, 320x180 
0x1382CA98, 37353944965041720, 89537690, 89537692, 2, 320x180 
0x1382CA98, 37353944965681144, 89537748, 89537753, 5, 320x180 
0x1382CA98, 37353944966320792, 89537815, 89537817, 2, 320x180 
0x1382CA98, 37353944966961016, 89537876, 89537880, 4, 320x180 
0x1382CA98, 37353944967598144, 89537941, 89537943, 2, 320x180 
0x1382CA98, 37353944968406768, 89538028, 89538046, 18, 320x180 
0x1382CA98, 37353944969129096, 89538117, 89538119, 2, 320x180 
0x1382CA98, 37353944969677040, 89538159, 89538168, 9, 320x180 
0x1382CA98, 37353944970316792, 89538217, 89538219, 2, 320x180 
0x1382CA98, 37353944970956704, 89538277, 89538280, 3, 320x180 
0x1382CA98, 37353944971597704, 89538345, 89538347, 2, 320x180 
0x1382CA98, 37353944972396480, 89538422, 89538423, 1, 320x180 
0x1382CA98, 37353944973037568, 89538486, 89538489, 3, 320x180 
0x1382CA98, 37353944973677616, 89538555, 89538556, 1, 320x180 
0x1382CA98, 37353944974317320, 89538612, 89538616, 4, 320x180 
0x1382CA98, 37353944974956856, 89538678, 89538680, 2, 320x180 
0x1382CA98, 37353944975602352, 89538745, 89538747, 2, 320x180 
0x1382CA98, 37353944976240864, 89538804, 89538806, 2, 320x180 
0x1382CA98, 37353944977037648, 89538891, 89538906, 15, 320x180 
0x1382CA98, 37353944977680496, 89538955, 89538956, 1, 320x180 
0x1382CA98, 37353944978320192, 89539018, 89539026, 8, 320x180 
0x1382CA98, 37353944978957320, 89539077, 89539083, 6, 320x180 
0x1382CA98, 37353944979597480, 89539141, 89539154, 13, 320x180 
0x1382CA98, 37353944980242736, 89539204, 89539206, 2, 320x180 
0x1382CA98, 37353944981036840, 89539303, 89539312, 9, 320x180 
0x1382CA98, 37353944981676968, 89539361, 89539371, 10, 320x180 
0x1382CA98, 37353944982339472, 89539423, 89539424, 1, 320x180 
0x1382CA98, 37353944982959632, 89539485, 89539486, 1, 320x180 
0x1382CA98, 37353944983597168, 89539552, 89539553, 1, 320x180 
0x1382CA98, 37353944984238312, 89539607, 89539619, 12, 320x180 
0x1382CA98, 37353944985040328, 89539685, 89539686, 1, 320x180 
0x1382CA98, 37353944985680728, 89539752, 89539753, 1, 320x180 
0x1382CA98, 37353944986317040, 89539818, 89539828, 10, 320x180 
0x1382CA98, 37353944986957752, 89539875, 89539880, 5, 320x180 
0x1382CA98, 37353944987597168, 89539941, 89539945, 4, 320x180 
0x1382CA98, 37353944988262280, 89540004, 89540006, 2, 320x180 
0x1382CA98, 37353944989036928, 89540090, 89540100, 10, 320x180 
0x1382CA98, 37353944989679968, 89540153, 89540157, 4, 320x180 
0x1382CA98, 37353944990319864, 89540220, 89540221, 1, 320x180 
0x1382CA98, 37353944990956704, 89540275, 89540278, 3, 320x180 
0x1382CA98, 37353944991606968, 89540342, 89540346, 4, 320x180 
0x1382CA98, 37353944992241560, 89540412, 89540413, 1, 320x180 
0x1382CA98, 37353944993040752, 89540491, 89540493, 2, 320x180 
0x1382CA98, 37353944993680928, 89540555, 89540556, 1, 320x180 
0x1382CA98, 37353944994320008, 89540612, 89540615, 3, 320x180 
0x1382CA98, 37353944994961936, 89540685, 89540687, 2, 320x180 
0x1382CA98, 37353944995608256, 89540746, 89540753, 7, 320x180 
0x1382CA98, 37353944996242768, 89540805, 89540812, 7, 320x180 
0x1382CA98, 37353944997041016, 89540897, 89540905, 8, 320x180 
0x1382CA98, 37353944997676784, 89540954, 89540955, 1, 320x180 
0x1382CA98, 37353944998323744, 89541018, 89541026, 8, 320x180 
0x1382CA98, 37353944998971656, 89541089, 89541090, 1, 320x180 
0x1382CA98, 37353944999600872, 89541141, 89541156, 15, 320x180 
0x1382CA98, 37353945000241208, 89541206, 89541207, 1, 320x180 
0x1382CA98, 37353945001035504, 89541296, 89541303, 7, 320x180 
0x1382CA98, 37353945001678264, 89541356, 89541357, 1, 320x180 
0x1382CA98, 37353945002320088, 89541424, 89541426, 2, 320x180 
0x1382CA98, 37353945002957248, 89541476, 89541485, 9, 320x180 
0x1382CA98, 37353945003602344, 89541550, 89541557, 7, 320x180 
0x1382CA98, 37353945004239328, 89541611, 89541614, 3, 320x180 
0x1382CA98, 37353945005035912, 89541688, 89541692, 4, 320x180 
0x1382CA98, 37353945005676616, 89541750, 89541752, 2, 320x180 
0x1382CA98, 37353945006318912, 89541825, 89541830, 5, 320x180 
0x1382CA98, 37353945006965448, 89541888, 89541892, 4, 320x180 
0x1382CA98, 37353945007605080, 89541944, 89541946, 2, 320x180 
0x1382CA98, 37353945008245016, 89542009, 89542021, 12, 320x180 
0x1382CA98, 37353945009035640, 89542106, 89542110, 4, 320x180 
0x1382CA98, 37353945009675608, 89542152, 89542154, 2, 320x180 
0x1382CA98, 37353945010315792, 89542223, 89542224, 1, 320x180 
0x1382CA98, 37353945010955696, 89542275, 89542287, 12, 320x180 
0x1382CA98, 37353945011606824, 89542339, 89542340, 1, 320x180 
0x1382CA98, 37353945012240976, 89542411, 89542419, 8, 320x180 
0x1382CA98, 37353945013035704, 89542489, 89542491, 2, 320x180 
0x1382CA98, 37353945013679384, 89542549, 89542551, 2, 320x180 
0x1382CA98, 37353945014319704, 89542619, 89542626, 7, 320x180 
0x1382CA98, 37353945014967360, 89542683, 89542685, 2, 320x180 
0x1382CA98, 37353945015615824, 89542740, 89542743, 3, 320x180 
0x1382CA98, 37353945016239064, 89542806, 89542809, 3, 320x180 
0x1382CA98, 37353945017035144, 89542889, 89542890, 1, 320x180 
0x1382CA98, 37353945017678264, 89542953, 89542955, 2, 320x180 
0x1382CA98, 37353945018316256, 89543017, 89543019, 2, 320x180 
0x1382CA98, 37353945018956304, 89543089, 89543090, 1, 320x180 
0x1382CA98, 37353945019606952, 89543155, 89543161, 6, 320x180 
0x1382CA98, 37353945020240320, 89543216, 89543222, 6, 320x180 
0x1382CA98, 37353945021035088, 89543294, 89543297, 3, 320x180 
0x1382CA98, 37353945021675368, 89543349, 89543359, 10, 320x180 
0x1382CA98, 37353945022316040, 89543419, 89543421, 2, 320x180 
0x1382CA98, 37353945022955800, 89543478, 89543484, 6, 320x180 
0x1382CA98, 37353945023600720, 89543549, 89543556, 7, 320x180 
0x1382CA98, 37353945024241496, 89543630, 89543634, 4, 320x180 
0x1382CA98, 37353945025036000, 89543697, 89543698, 1, 320x180 
0x1382CA98, 37353945025675152, 89543757, 89543768, 11, 320x180 
0x1382CA98, 37353945026315464, 89543819, 89543820, 1, 320x180 
0x1382CA98, 37353945026955232, 89543875, 89543885, 10, 320x180 
0x1382CA98, 37353945027600616, 89543944, 89543951, 7, 320x180 
0x1382CA98, 37353945028236560, 89544006, 89544010, 4, 320x180 
0x1382CA98, 37353945028876248, 89544071, 89544073, 2, 320x180 
0x1382CA98, 37353945029675488, 89544157, 89544158, 1, 320x180 
0x1382CA98, 37353945030346008, 89544218, 89544220, 2, 320x180 
0x1382CA98, 37353945030963232, 89544285, 89544286, 1, 320x180 
0x1382CA98, 37353945031601616, 89544341, 89544343, 2, 320x180 
0x1382CA98, 37353945032236224, 89544409, 89544418, 9, 320x180 
0x1382CA98, 37353945032875832, 89544471, 89544473, 2, 320x180 
0x1382CA98, 37353945033681504, 89544556, 89544557, 1, 320x180 
0x1382CA98, 37353945034326720, 89544618, 89544620, 2, 320x180 
0x1382CA98, 37353945034956784, 89544688, 89544690, 2, 320x180 
0x1382CA98, 37353945035596248, 89544740, 89544749, 9, 320x180 
0x1382CA98, 37353945036239256, 89544814, 89544815, 1, 320x180 
0x1382CA98, 37353945036875336, 89544877, 89544881, 4, 320x180 
0x1382CA98, 37353945037675800, 89544959, 89544966, 7, 320x180 
0x1382CA98, 37353945038315640, 89545019, 89545021, 2, 320x180 
0x1382CA98, 37353945038959608, 89545091, 89545097, 6, 320x180 
0x1382CA98, 37353945039612760, 89545155, 89545156, 1, 320x180 
0x1382CA98, 37353945040240088, 89545212, 89545214, 2, 320x180 
0x1382CA98, 37353945040875304, 89545281, 89545283, 2, 320x180 
0x1382CA98, 37353945041684728, 89545350, 89545352, 2, 320x180 
0x1382CA98, 37353945042318616, 89545420, 89545425, 5, 320x180 
0x1382CA98, 37353945042957008, 89545483, 89545485, 2, 320x180 
0x1382CA98, 37353945043598864, 89545544, 89545555, 11, 320x180 
0x1382CA98, 37353945044249784, 89545608, 89545613, 5, 320x180 
0x1382CA98, 37353945044875048, 89545673, 89545674, 1, 320x180 
0x1382CA98, 37353945045675712, 89545756, 89545758, 2, 320x180 
0x1382CA98, 37353945046316208, 89545829, 89545830, 1, 320x180 
0x1382CA98, 37353945046957136, 89545874, 89545877, 3, 320x180 
0x1382CA98, 37353945047598256, 89545945, 89545947, 2, 320x180 
0x1382CA98, 37353945048239816, 89546007, 89546009, 2, 320x180 
0x1382CA98, 37353945048880008, 89546069, 89546071, 2, 320x180 
0x1382CA98, 37353945049681360, 89546156, 89546157, 1, 320x180 
0x1382CA98, 37353945050319000, 89546211, 89546214, 3, 320x180 
0x1382CA98, 37353945050955064, 89546278, 89546285, 7, 320x180 
0x1382CA98, 37353945051598856, 89546340, 89546343, 3, 320x180 
0x1382CA98, 37353945052236312, 89546413, 89546419, 6, 320x180 
0x1382CA98, 37353945052878872, 89546481, 89546486, 5, 320x180 
0x1382CA98, 37353945053678264, 89546550, 89546552, 2, 320x180 
0x1382CA98, 37353945054323672, 89546619, 89546620, 1, 320x180 
0x1382CA98, 37353945054962776, 89546675, 89546679, 4, 320x180 
0x1382CA98, 37353945055603992, 89546748, 89546750, 2, 320x180 
0x1382CA98, 37353945056262304, 89546816, 89546817, 1, 320x180 
0x1382CA98, 37353945056877648, 89546879, 89546881, 2, 320x180 
0x1382CA98, 37353945057678128, 89546948, 89546954, 6, 320x180 
0x1382CA98, 37353945058314912, 89547018, 89547020, 2, 320x180 
0x1382CA98, 37353945058957376, 89547089, 89547090, 1, 320x180 
0x1382CA98, 37353945059603648, 89547150, 89547152, 2, 320x180 
0x1382CA98, 37353945060258904, 89547206, 89547209, 3, 320x180 
0x1382CA98, 37353945060878320, 89547273, 89547274, 1, 320x180 
0x1382CA98, 37353945061678800, 89547349, 89547351, 2, 320x180 
0x1382CA98, 37353945062322088, 89547416, 89547419, 3, 320x180 
0x1382CA98, 37353945062958216, 89547481, 89547483, 2, 320x180 
0x1382CA98, 37353945063605096, 89547540, 89547541, 1, 320x180 
0x1382CA98, 37353945064238776, 89547610, 89547613, 3, 320x180 
0x1382CA98, 37353945064875488, 89547672, 89547674, 2, 320x180 
0x1382CA98, 37353945065675424, 89547764, 89547765, 1, 320x180 
0x1382CA98, 37353945066321384, 89547828, 89547831, 3, 320x180 
0x1382CA98, 37353945066954024, 89547890, 89547892, 2, 320x180 
0x1382CA98, 37353945067599264, 89547948, 89547949, 1, 320x180 
0x1382CA98, 37353945068241640, 89548032, 89548038, 6, 320x180 
0x1382CA98, 37353945068889792, 89548086, 89548089, 3, 320x180 
0x1382CA98, 37353945069679176, 89548156, 89548158, 2, 320x180 
0x1382CA98, 37353945070314000, 89548217, 89548219, 2, 320x180 
0x1382CA98, 37353945070956432, 89548285, 89548291, 6, 320x180 
0x1382CA98, 37353945071620480, 89548356, 89548358, 2, 320x180 
0x1382CA98, 37353945072235496, 89548411, 89548418, 7, 320x180 
0x1382CA98, 37353945072874336, 89548476, 89548480, 4, 320x180 
0x1382CA98, 37353945073673576, 89548562, 89548563, 1, 320x180 
0x1382CA98, 37353945074328904, 89548620, 89548621, 1, 320x180 
0x1382CA98, 37353945074995664, 89548690, 89548692, 2, 320x180 
0x1382CA98, 37353945075599576, 89548741, 89548747, 6, 320x180 
0x1382CA98, 37353945076240248, 89548813, 89548814, 1, 320x180 
0x1382CA98, 37353945076874096, 89548883, 89548885, 2, 320x180 
0x1382CA98, 37353945077673512, 89548955, 89548957, 2, 320x180 
0x1382CA98, 37353945078329664, 89549028, 89549037, 9, 320x180 
0x1382CA98, 37353945078956688, 89549077, 89549079, 2, 320x180 
0x1382CA98, 37353945079610216, 89549140, 89549144, 4, 320x180 
0x1382CA98, 37353945080241088, 89549203, 89549204, 1, 320x180 
0x1382CA98, 37353945080874976, 89549267, 89549270, 3, 320x180 
0x1382CA98, 37353945081674608, 89549354, 89549355, 1, 320x180 
0x1382CA98, 37353945082314560, 89549417, 89549419, 2, 320x180 
0x1382CA98, 37353945082954712, 89549479, 89549483, 4, 320x180 
0x1382CA98, 37353945083615776, 89549549, 89549553, 4, 320x180 
0x1382CA98, 37353945084293448, 89549620, 89549621, 1, 320x180 
0x1382CA98, 37353945084874560, 89549674, 89549675, 1, 320x180 
0x1382CA98, 37353945085515328, 89549746, 89549748, 2, 320x180 
0x1382CA98, 37353945086317320, 89549818, 89549825, 7, 320x180 
0x1382CA98, 37353945086957456, 89549884, 89549892, 8, 320x180 
0x1382CA98, 37353945087603720, 89549941, 89549943, 2, 320x180 
0x1382CA98, 37353945088236168, 89550007, 89550011, 4, 320x180 
0x1382CA98, 37353945088874704, 89550081, 89550082, 1, 320x180 
0x1382CA98, 37353945089514848, 89550134, 89550136, 2, 320x180 
0x1382CA98, 37353945090319944, 89550229, 89550231, 2, 320x180 
0x1382CA98, 37353945090955784, 89550286, 89550287, 1, 320x180 
0x1382CA98, 37353945091594432, 89550357, 89550360, 3, 320x180 
0x1382CA98, 37353945092234576, 89550431, 89550434, 3, 320x180 
0x1382CA98, 37353945092877240, 89550471, 89550473, 2, 320x180 
0x1382CA98, 37353945093513912, 89550532, 89550534, 2, 320x180 
0x1382CA98, 37353945094313880, 89550610, 89550614, 4, 320x180 
0x1382CA98, 37353945094955856, 89550678, 89550681, 3, 320x180 
0x1382CA98, 37353945095594272, 89550739, 89550741, 2, 320x180 
0x1382CA98, 37353945096238760, 89550809, 89550811, 2, 320x180 
0x1382CA98, 37353945096874064, 89550880, 89550882, 2, 320x180 
0x1382CA98, 37353945097521640, 89550947, 89550949, 2, 320x180 
0x1382CA98, 37353945098320808, 89551020, 89551021, 1, 320x180 
0x1382CA98, 37353945098960512, 89551090, 89551092, 2, 320x180 
0x1382CA98, 37353945099614136, 89551152, 89551153, 1, 320x180 
0x1382CA98, 37353945100233784, 89551234, 89551238, 4, 320x180 
0x1382CA98, 37353945100877024, 89551283, 89551294, 11, 320x180 
0x1382CA98, 37353945101513568, 89551343, 89551347, 4, 320x180 
0x1382CA98, 37353945102313304, 89551420, 89551421, 1, 320x180 
0x1382CA98, 37353945102953056, 89551491, 89551492, 1, 320x180 
0x1382CA98, 37353945103593464, 89551544, 89551547, 3, 320x180 
0x1382CA98, 37353945104239136, 89551613, 89551615, 2, 320x180 
0x1382CA98, 37353945104877544, 89551680, 89551682, 2, 320x180 
0x1382CA98, 37353945105576304, 89551758, 89551760, 2, 320x180 
0x1382CA98, 37353945106313696, 89551818, 89551827, 9, 320x180 
0x1382CA98, 37353945106953224, 89551886, 89551887, 1, 320x180 
0x1382CA98, 37353945107602648, 89551944, 89551948, 4, 320x180 
0x1382CA98, 37353945108237848, 89552007, 89552009, 2, 320x180 
0x1382CA98, 37353945108876904, 89552080, 89552088, 8, 320x180 
0x1382CA98, 37353945109518080, 89552138, 89552140, 2, 320x180 
0x1382CA98, 37353945110316520, 89552218, 89552220, 2, 320x180 
0x1382CA98, 37353945110957672, 89552291, 89552293, 2, 320x180 
0x1382CA98, 37353945111603776, 89552349, 89552356, 7, 320x180 
0x1382CA98, 37353945112275016, 89552424, 89552425, 1, 320x180 
0x1382CA98, 37353945112879312, 89552482, 89552486, 4, 320x180 
0x1382CA98, 37353945113516904, 89552534, 89552535, 1, 320x180 
0x1382CA98, 37353945114313352, 89552621, 89552622, 1, 320x180 
0x1382CA98, 37353945114959592, 89552690, 89552694, 4, 320x180 
0x1382CA98, 37353945115593480, 89552742, 89552748, 6, 320x180 
0x1382CA98, 37353945116234272, 89552813, 89552815, 2, 320x180 
0x1382CA98, 37353945116874448, 89552878, 89552882, 4, 320x180 
0x1382CA98, 37353945117513904, 89552952, 89552954, 2, 320x180 
0x1382CA98, 37353945118312680, 89553020, 89553021, 1, 320x180 
0x1382CA98, 37353945118953616, 89553092, 89553097, 5, 320x180 
0x1382CA98, 37353945119601536, 89553147, 89553156, 9, 320x180 
0x1382CA98, 37353945120240544, 89553210, 89553221, 11, 320x180 
0x1382CA98, 37353945120872792, 89553270, 89553273, 3, 320x180 
0x1382CA98, 37353945121515432, 89553338, 89553339, 1, 320x180 
0x1382CA98, 37353945122312352, 89553424, 89553425, 1, 320x180 
0x1382CA98, 37353945122953368, 89553479, 89553488, 9, 320x180 
0x1382CA98, 37353945123597936, 89553546, 89553553, 7, 320x180 
0x1382CA98, 37353945124234064, 89553609, 89553621, 12, 320x180 
0x1382CA98, 37353945124876424, 89553678, 89553686, 8, 320x180 
0x1382CA98, 37353945125513248, 89553744, 89553755, 11, 320x180 
0x1382CA98, 37353945126315768, 89553825, 89553827, 2, 320x180 
0x1382CA98, 37353945126952840, 89553886, 89553887, 1, 320x180 
0x1382CA98, 37353945127593056, 89553947, 89553953, 6, 320x180 
0x1382CA98, 37353945128234904, 89554005, 89554007, 2, 320x180 
0x1382CA98, 37353945128873896, 89554072, 89554073, 1, 320x180 
0x1382CA98, 37353945129512816, 89554143, 89554147, 4, 320x180 
0x1382CA98, 37353945130325808, 89554219, 89554223, 4, 320x180 
0x1382CA98, 37353945130955248, 89554283, 89554294, 11, 320x180 
0x1382CA98, 37353945131595552, 89554344, 89554346, 2, 320x180 
0x1382CA98, 37353945132237424, 89554409, 89554411, 2, 320x180 
0x1382CA98, 37353945132877800, 89554478, 89554480, 2, 320x180 
0x1382CA98, 37353945133516864, 89554544, 89554550, 6, 320x180 
0x1382CA98, 37353945134313304, 89554611, 89554619, 8, 320x180 
0x1382CA98, 37353945134964840, 89554686, 89554687, 1, 320x180 
0x1382CA98, 37353945135608064, 89554752, 89554754, 2, 320x180 
0x1382CA98, 37353945136233152, 89554808, 89554812, 4, 320x180 
0x1382CA98, 37353945136873224, 89554883, 89554884, 1, 320x180 
0x1382CA98, 37353945137512704, 89554943, 89554946, 3, 320x180 
0x1382CA98, 37353945138162464, 89555006, 89555007, 1, 320x180 
0x1382CA98, 37353945138952776, 89555085, 89555091, 6, 320x180 
0x1382CA98, 37353945139605512, 89555145, 89555153, 8, 320x180 
0x1382CA98, 37353945140232712, 89555206, 89555208, 2, 320x180 
0x1382CA98, 37353945140876480, 89555279, 89555281, 2, 320x180 
0x1382CA98, 37353945141513152, 89555332, 89555340, 8, 320x180 
0x1382CA98, 37353945142153280, 89555401, 89555408, 7, 320x180 
0x1382CA98, 37353945142953096, 89555483, 89555485, 2, 320x180 
0x1382CA98, 37353945143604224, 89555543, 89555554, 11, 320x180 
0x1382CA98, 37353945144234088, 89555606, 89555607, 1, 320x180 
0x1382CA98, 37353945144877976, 89555670, 89555671, 1, 320x180 
0x1382CA98, 37353945145513160, 89555744, 89555754, 10, 320x180 
0x1382CA98, 37353945146156584, 89555802, 89555803, 1, 320x180 
0x1382CA98, 37353945146956464, 89555891, 89555897, 6, 320x180 
0x1382CA98, 37353945147598368, 89555951, 89555955, 4, 320x180 
0x1382CA98, 37353945148241856, 89556009, 89556012, 3, 320x180 
0x1382CA98, 37353945148873024, 89556074, 89556075, 1, 320x180 
0x1382CA98, 37353945149513152, 89556144, 89556147, 3, 320x180 
0x1382CA98, 37353945150156528, 89556198, 89556201, 3, 320x180 
0x1382CA98, 37353945150952432, 89556285, 89556287, 2, 320x180 
0x1382CA98, 37353945151593432, 89556345, 89556353, 8, 320x180 
0x1382CA98, 37353945152238304, 89556410, 89556422, 12, 320x180 
0x1382CA98, 37353945152876192, 89556475, 89556480, 5, 320x180 
0x1382CA98, 37353945153516576, 89556547, 89556550, 3, 320x180 
0x1382CA98, 37353945154153912, 89556616, 89556618, 2, 320x180 
0x1382CA98, 37353945154955384, 89556688, 89556691, 3, 320x180 
0x1382CA98, 37353945155605328, 89556768, 89556778, 10, 320x180 
0x1382CA98, 37353945156245312, 89556853, 89556881, 28, 320x180 
0x1382CA98, 37353945156874008, 89556883, 89556896, 13, 320x180 
0x1382CA98, 37353945157521104, 89556946, 89556949, 3, 320x180 
0x1382CA98, 37353945158166264, 89557010, 89557018, 8, 320x180 
0x1382CA98, 37353945158971056, 89557102, 89557121, 19, 320x180 
0x1382CA98, 37353945159613184, 89557191, 89557194, 3, 320x180 
0x1382CA98, 37353945160276672, 89557252, 89557254, 2, 320x180 
0x1382CA98, 37353945160877056, 89557285, 89557287, 2, 320x180 
0x1382CA98, 37353945161517688, 89557348, 89557349, 1, 320x180 
0x1382CA98, 37353945162151976, 89557404, 89557409, 5, 320x180 
0x1382CA98, 37353945162956440, 89557478, 89557482, 4, 320x180 
0x1382CA98, 37353945163599408, 89557551, 89557557, 6, 320x180 
0x1382CA98, 37353945164235832, 89557608, 89557615, 7, 320x180 
0x1382CA98, 37353945164875912, 89557684, 89557695, 11, 320x180 
0x1382CA98, 37353945165511944, 89557745, 89557754, 9, 320x180 
0x1382CA98, 37353945166154880, 89557803, 89557804, 1, 320x180 
0x1382CA98, 37353945166955768, 89557891, 89557893, 2, 320x180 
0x1382CA98, 37353945167594008, 89557942, 89557948, 6, 320x180 
0x1382CA98, 37353945168236392, 89558004, 89558006, 2, 320x180 
0x1382CA98, 37353945168876064, 89558069, 89558081, 12, 320x180 
0x1382CA98, 37353945169512456, 89558138, 89558140, 2, 320x180 
0x1382CA98, 37353945170153000, 89558199, 89558207, 8, 320x180 
0x1382CA98, 37353945170951432, 89558285, 89558287, 2, 320x180 
0x1382CA98, 37353945171592920, 89558354, 89558363, 9, 320x180 
0x1382CA98, 37353945172248240, 89558425, 89558428, 3, 320x180 
0x1382CA98, 37353945172891328, 89558474, 89558476, 2, 320x180 
0x1382CA98, 37353945173511656, 89558537, 89558538, 1, 320x180 
0x1382CA98, 37353945174151472, 89558598, 89558599, 1, 320x180 
0x1382CA98, 37353945174951352, 89558680, 89558688, 8, 320x180 
0x1382CA98, 37353945175613328, 89558755, 89558756, 1, 320x180 
0x1382CA98, 37353945176243192, 89558805, 89558806, 1, 320x180 
0x1382CA98, 37353945176871632, 89558871, 89558872, 1, 320x180 
0x1382CA98, 37353945177518296, 89558943, 89558946, 3, 320x180 
0x1382CA98, 37353945178157320, 89559003, 89559006, 3, 320x180 
0x1382CA98, 37353945178955888, 89559076, 89559086, 10, 320x180 
0x1382CA98, 37353945179598848, 89559143, 89559147, 4, 320x180 
0x1382CA98, 37353945180231104, 89559201, 89559202, 1, 320x180 
0x1382CA98, 37353945180871280, 89559270, 89559273, 3, 320x180 
0x1382CA98, 37353945181512416, 89559335, 89559339, 4, 320x180 
0x1382CA98, 37353945182152216, 89559405, 89559406, 1, 320x180 
0x1382CA98, 37353945182951720, 89559476, 89559477, 1, 320x180 
0x1382CA98, 37353945183614592, 89559540, 89559542, 2, 320x180 
0x1382CA98, 37353945184250488, 89559605, 89559606, 1, 320x180 
0x1382CA98, 37353945184871568, 89559684, 89559690, 6, 320x180 
0x1382CA98, 37353945185517776, 89559750, 89559765, 15, 320x180 
0x1382CA98, 37353945186151960, 89559807, 89559808, 1, 320x180 
0x1382CA98, 37353945186950672, 89559892, 89559897, 5, 320x180 
0x1382CA98, 37353945187613800, 89559957, 89559958, 1, 320x180 
0x1382CA98, 37353945188236576, 89560018, 89560019, 1, 320x180 
0x1382CA98, 37353945188875624, 89560075, 89560081, 6, 320x180 
0x1382CA98, 37353945189514624, 89560136, 89560138, 2, 320x180 
0x1382CA98, 37353945190152360, 89560198, 89560200, 2, 320x180 
0x1382CA98, 37353945191273072, 89560317, 89560319, 2, 320x180 
0x1382CA98, 37353945191926536, 89560373, 89560374, 1, 320x180 
0x1382CA98, 37353945192555448, 89560452, 89560455, 3, 320x180 
0x1382CA98, 37353945193191072, 89560516, 89560522, 6, 320x180 
0x1382CA98, 37353945193847712, 89560589, 89560590, 1, 320x180 
0x1382CA98, 37353945194473712, 89560642, 89560646, 4, 320x180 
0x1382CA98, 37353945195272128, 89560717, 89560724, 7, 320x180 
0x1382CA98, 37353945195911088, 89560782, 89560784, 2, 320x180 
0x1382CA98, 37353945196558256, 89560849, 89560850, 1, 320x180 
0x1382CA98, 37353945197191592, 89560906, 89560907, 1, 320x180 
0x1382CA98, 37353945197845960, 89560969, 89560974, 5, 320x180 
0x1382CA98, 37353945198471320, 89561030, 89561032, 2, 320x180 
0x1382CA98, 37353945199274272, 89561126, 89561138, 12, 320x180 
0x1382CA98, 37353945199912504, 89561184, 89561186, 2, 320x180 
0x1382CA98, 37353945200561232, 89561256, 89561258, 2, 320x180 
0x1382CA98, 37353945201190920, 89561311, 89561318, 7, 320x180 
0x1382CA98, 37353945201835800, 89561364, 89561365, 1, 320x180 
0x1382CA98, 37353945202472184, 89561435, 89561436, 1, 320x180 
0x1382CA98, 37353945203274576, 89561524, 89561527, 3, 320x180 
0x1382CA98, 37353945203912760, 89561583, 89561584, 1, 320x180 
0x1382CA98, 37353945204552528, 89561640, 89561643, 3, 320x180 
0x1382CA98, 37353945205193280, 89561708, 89561710, 2, 320x180 
0x1382CA98, 37353945205832584, 89561765, 89561767, 2, 320x180 
0x1382CA98, 37353945206473728, 89561833, 89561836, 3, 320x180 
0x1382CA98, 37353945207272240, 89561916, 89561918, 2, 320x180 
0x1382CA98, 37353945207914272, 89561977, 89561985, 8, 320x180 
0x1382CA98, 37353945208553360, 89562034, 89562036, 2, 320x180 
0x1382CA98, 37353945209191624, 89562100, 89562101, 1, 320x180 
0x1382CA98, 37353945209831208, 89562163, 89562165, 2, 320x180 
0x1382CA98, 37353945210471824, 89562227, 89562234, 7, 320x180 
0x1382CA98, 37353945211273888, 89562332, 89562334, 2, 320x180 
0x1382CA98, 37353945211912640, 89562385, 89562386, 1, 320x180 
0x1382CA98, 37353945212553072, 89562448, 89562452, 4, 320x180 
0x1382CA98, 37353945213193624, 89562513, 89562515, 2, 320x180 
0x1382CA98, 37353945213832744, 89562575, 89562577, 2, 320x180 
0x1382CA98, 37353945214473536, 89562637, 89562641, 4, 320x180 
0x1382CA98, 37353945215273640, 89562715, 89562717, 2, 320x180 
0x1382CA98, 37353945215915584, 89562785, 89562786, 1, 320x180 
0x1382CA98, 37353945216554784, 89562846, 89562848, 2, 320x180 
0x1382CA98, 37353945217190776, 89562900, 89562901, 1, 320x180 
0x1382CA98, 37353945217831288, 89562967, 89562968, 1, 320x180 
0x1382CA98, 37353945218471848, 89563032, 89563033, 1, 320x180 
0x1382CA98, 37353945219112032, 89563103, 89563106, 3, 320x180 
0x1382CA98, 37353945219918104, 89563170, 89563172, 2, 320x180 
0x1382CA98, 37353945220551016, 89563235, 89563236, 1, 320x180 
0x1382CA98, 37353945221190880, 89563301, 89563302, 1, 320x180 
0x1382CA98, 37353945221831096, 89563367, 89563373, 6, 320x180 
0x1382CA98, 37353945222471280, 89563430, 89563433, 3, 320x180 
0x1382CA98, 37353945223111264, 89563491, 89563495, 4, 320x180 
0x1382CA98, 37353945223924168, 89563584, 89563586, 2, 320x180 
0x1382CA98, 37353945224552024, 89563647, 89563651, 4, 320x180 
0x1382CA98, 37353945225194576, 89563713, 89563714, 1, 320x180 
0x1382CA98, 37353945225834752, 89563764, 89563766, 2, 320x180 
0x1382CA98, 37353945226475528, 89563831, 89563832, 1, 320x180 
0x1382CA98, 37353945227111656, 89563892, 89563895, 3, 320x180 
0x1382CA98, 37353945227914984, 89563974, 89563978, 4, 320x180 
0x1382CA98, 37353945228551120, 89564038, 89564039, 1, 320x180 
0x1382CA98, 37353945229191480, 89564099, 89564101, 2, 320x180 
0x1382CA98, 37353945229831200, 89564166, 89564167, 1, 320x180 
0x1382CA98, 37353945230471248, 89564227, 89564229, 2, 320x180 
0x1382CA98, 37353945231111408, 89564297, 89564303, 6, 320x180 
0x1382CA98, 37353945231911888, 89564375, 89564379, 4, 320x180 
0x1382CA98, 37353945232550040, 89564443, 89564446, 3, 320x180 
0x1382CA98, 37353945233190944, 89564501, 89564502, 1, 320x180 
0x1382CA98, 37353945233831336, 89564566, 89564567, 1, 320x180 
0x1382CA98, 37353945234792520, 89564659, 89564663, 4, 640x360 
0x1382CA98, 37353945235111528, 89564690, 89564693, 3, 640x360 
0x1382CA98, 37353945235592392, 89564754, 89564756, 2, 640x360 
0x1382CA98, 37353945235912352, 89564780, 89564783, 3, 640x360 
0x1382CA98, 37353945236237880, 89564808, 89564812, 4, 640x360 
0x1382CA98, 37353945236554248, 89564845, 89564852, 7, 640x360 
0x1382CA98, 37353945236871848, 89564877, 89564881, 4, 640x360 
0x1382CA98, 37353945237191840, 89564905, 89564908, 3, 640x360 
0x1382CA98, 37353945237512760, 89564938, 89564940, 2, 640x360 
0x1382CA98, 37353945237834704, 89564964, 89564966, 2, 640x360 
0x1382CA98, 37353945238151080, 89564996, 89564999, 3, 640x360 
0x1382CA98, 37353945238470632, 89565027, 89565032, 5, 640x360 
0x1382CA98, 37353945238791152, 89565062, 89565064, 2, 640x360 
0x1382CA98, 37353945239110952, 89565093, 89565095, 2, 640x360 
0x1382CA98, 37353945239590472, 89565139, 89565141, 2, 640x360 
0x1382CA98, 37353945239910344, 89565170, 89565172, 2, 640x360 
0x1382CA98, 37353945240230264, 89565207, 89565210, 3, 640x360 
0x1382CA98, 37353945240551112, 89565239, 89565241, 2, 640x360 
0x1382CA98, 37353945240870664, 89565270, 89565272, 2, 640x360 
0x1382CA98, 37353945241190976, 89565301, 89565303, 2, 640x360 
0x1382CA98, 37353945241510376, 89565332, 89565335, 3, 640x360 
0x1382CA98, 37353945241831080, 89565363, 89565365, 2, 640x360 
0x1382CA98, 37353945242150392, 89565394, 89565398, 4, 640x360 
0x1382CA98, 37353945242470680, 89565430, 89565435, 5, 640x360 
0x1382CA98, 37353945242791064, 89565461, 89565464, 3, 640x360 
0x1382CA98, 37353945243111160, 89565492, 89565496, 4, 640x360 
0x1382CA98, 37353945243430968, 89565523, 89565527, 4, 640x360 
0x1382CA98, 37353945243909296, 89565570, 89565572, 2, 640x360 
0x1382CA98, 37353945244230512, 89565603, 89565606, 3, 640x360 
0x1382CA98, 37353945244554560, 89565637, 89565640, 3, 640x360 
0x1382CA98, 37353945244869880, 89565673, 89565682, 9, 640x360 
0x1382CA98, 37353945245190144, 89565704, 89565705, 1, 640x360 
0x1382CA98, 37353945245509808, 89565736, 89565738, 2, 640x360 
0x1382CA98, 37353945245830240, 89565763, 89565774, 11, 640x360 
0x1382CA98, 37353945246149872, 89565800, 89565802, 2, 640x360 
0x1382CA98, 37353945246469888, 89565832, 89565839, 7, 640x360 
0x1382CA98, 37353945246790096, 89565868, 89565871, 3, 640x360 
0x1382CA98, 37353945247113200, 89565897, 89565903, 6, 640x360 
0x1382CA98, 37353945247430352, 89565921, 89565923, 2, 640x360 
0x1382CA98, 37353945247914160, 89565975, 89565986, 11, 640x360 
0x1382CA98, 37353945248230432, 89566014, 89566016, 2, 640x360 
0x1382CA98, 37353945248549856, 89566039, 89566041, 2, 640x360 
0x1382CA98, 37353945248874856, 89566070, 89566073, 3, 640x360 
0x1382CA98, 37353945249190136, 89566102, 89566104, 2, 640x360 
0x1382CA98, 37353945249515160, 89566133, 89566137, 4, 640x360 
0x1382CA98, 37353945249829816, 89566164, 89566170, 6, 640x360 
0x1382CA98, 37353945250150296, 89566201, 89566203, 2, 640x360 
0x1382CA98, 37353945250470088, 89566234, 89566242, 8, 640x360 
0x1382CA98, 37353945250790216, 89566260, 89566264, 4, 640x360 
0x1382CA98, 37353945251110560, 89566291, 89566297, 6, 640x360 
0x1382CA98, 37353945251434400, 89566322, 89566324, 2, 640x360 
0x1382CA98, 37353945251909240, 89566378, 89566381, 3, 640x360 
0x1382CA98, 37353945252230064, 89566415, 89566417, 2, 640x360 
0x1382CA98, 37353945252550680, 89566438, 89566441, 3, 640x360 
0x1382CA98, 37353945252870464, 89566473, 89566476, 3, 640x360 
0x1382CA98, 37353945253194976, 89566499, 89566502, 3, 640x360 
0x1382CA98, 37353945253512744, 89566537, 89566539, 2, 640x360 
0x1382CA98, 37353945253839600, 89566572, 89566574, 2, 640x360 
0x1382CA98, 37353945254150296, 89566603, 89566605, 2, 640x360 
0x1382CA98, 37353945254473032, 89566634, 89566640, 6, 640x360 
0x1382CA98, 37353945254794912, 89566660, 89566663, 3, 640x360 
0x1382CA98, 37353945255109992, 89566691, 89566694, 3, 640x360 
0x1382CA98, 37353945255432496, 89566725, 89566731, 6, 640x360 
0x1382CA98, 37353945255926056, 89566773, 89566776, 3, 640x360 
0x1382CA98, 37353945256234312, 89566813, 89566820, 7, 640x360 
0x1382CA98, 37353945256549304, 89566840, 89566843, 3, 640x360 
0x1382CA98, 37353945256870288, 89566876, 89566886, 10, 640x360 
0x1382CA98, 37353945257189936, 89566913, 89566922, 9, 640x360 
0x1382CA98, 37353945257513216, 89566942, 89566944, 2, 640x360 
0x1382CA98, 37353945257830064, 89566974, 89566976, 2, 640x360 
0x1382CA98, 37353945258153072, 89567002, 89567008, 6, 640x360 
0x1382CA98, 37353945258473784, 89567044, 89567048, 4, 640x360 
0x1382CA98, 37353945258793912, 89567062, 89567065, 3, 640x360 
0x1382CA98, 37353945259110048, 89567096, 89567098, 2, 640x360 
0x1382CA98, 37353945259431048, 89567123, 89567125, 2, 640x360 
0x1382CA98, 37353945259912912, 89567175, 89567179, 4, 640x360 
0x1382CA98, 37353945260229688, 89567209, 89567213, 4, 640x360 
0x1382CA98, 37353945260549288, 89567247, 89567255, 8, 640x360 
0x1382CA98, 37353945260869608, 89567272, 89567275, 3, 640x360 
0x1382CA98, 37353945261194816, 89567304, 89567307, 3, 640x360 
0x1382CA98, 37353945261515024, 89567335, 89567341, 6, 640x360 
0x1382CA98, 37353945261834200, 89567367, 89567370, 3, 640x360 
0x1382CA98, 37353945262152800, 89567403, 89567411, 8, 640x360 
0x1382CA98, 37353945262474104, 89567436, 89567438, 2, 640x360 
0x1382CA98, 37353945262791456, 89567468, 89567471, 3, 640x360 
0x1382CA98, 37353945263109768, 89567495, 89567504, 9, 640x360 
0x1382CA98, 37353945263443064, 89567525, 89567528, 3, 640x360 
0x1382CA98, 37353945263924896, 89567579, 89567588, 9, 640x360 
0x1382CA98, 37353945264229176, 89567618, 89567624, 6, 640x360 
0x1382CA98, 37353945264549328, 89567652, 89567655, 3, 640x360 
0x1382CA98, 37353945264874480, 89567675, 89567679, 4, 640x360 
0x1382CA98, 37353945265189896, 89567713, 89567719, 6, 640x360 
0x1382CA98, 37353945265513992, 89567739, 89567741, 2, 640x360 
0x1382CA98, 37353945265841832, 89567775, 89567782, 7, 640x360 
0x1382CA98, 37353945266150880, 89567802, 89567804, 2, 640x360 
0x1382CA98, 37353945266469064, 89567829, 89567834, 5, 640x360 
0x1382CA98, 37353945266789776, 89567863, 89567873, 10, 640x360 
0x1382CA98, 37353945267109984, 89567899, 89567905, 6, 640x360 
0x1382CA98, 37353945267436344, 89567924, 89567928, 4, 640x360 
0x1382CA98, 37353945267919424, 89567978, 89567983, 5, 640x360 
0x1382CA98, 37353945268247568, 89568011, 89568013, 2, 640x360 
0x1382CA98, 37353945268553416, 89568039, 89568041, 2, 640x360 
0x1382CA98, 37353945268874424, 89568075, 89568078, 3, 640x360 
0x1382CA98, 37353945269190360, 89568109, 89568111, 2, 640x360 
0x1382CA98, 37353945269513320, 89568137, 89568139, 2, 640x360 
0x1382CA98, 37353945269831976, 89568175, 89568177, 2, 640x360 
0x1382CA98, 37353945270149056, 89568198, 89568203, 5, 640x360 
0x1382CA98, 37353945270478624, 89568236, 89568238, 2, 640x360 
0x1382CA98, 37353945270788776, 89568261, 89568266, 5, 640x360 
0x1382CA98, 37353945271114832, 89568309, 89568324, 15, 640x360 
0x1382CA98, 37353945271450616, 89568351, 89568362, 11, 640x360 
0x1382CA98, 37353945271757112, 89568374, 89568386, 12, 640x360 
0x1382CA98, 37353945272235024, 89568411, 89568418, 7, 640x360 
0x1382CA98, 37353945272550048, 89568448, 89568456, 8, 640x360 
0x1382CA98, 37353945272869632, 89568476, 89568483, 7, 640x360 
0x1382CA98, 37353945273196632, 89568519, 89568522, 3, 640x360 
0x1382CA98, 37353945273508952, 89568535, 89568539, 4, 640x360 
0x1382CA98, 37353945273829288, 89568569, 89568574, 5, 640x360 
0x1382CA98, 37353945274148688, 89568602, 89568604, 2, 640x360 
0x1382CA98, 37353945274471336, 89568634, 89568636, 2, 640x360 
0x1382CA98, 37353945274789072, 89568664, 89568667, 3, 640x360 
0x1382CA98, 37353945275110400, 89568696, 89568702, 6, 640x360 
0x1382CA98, 37353945275429816, 89568732, 89568738, 6, 640x360 
0x1382CA98, 37353945275756704, 89568763, 89568772, 9, 640x360 
0x1382CA98, 37353945276228984, 89568809, 89568815, 6, 640x360 
0x1382CA98, 37353945276548880, 89568839, 89568841, 2, 640x360 
0x1382CA98, 37353945276869224, 89568868, 89568870, 2, 640x360 
0x1382CA98, 37353945277193096, 89568902, 89568905, 3, 640x360 
0x1382CA98, 37353945277512440, 89568943, 89568949, 6, 640x360 
0x1382CA98, 37353945277836424, 89568971, 89568973, 2, 640x360 
0x1382CA98, 37353945278156528, 89569000, 89569006, 6, 640x360 
0x1382CA98, 37353945278471216, 89569030, 89569035, 5, 640x360 
0x1382CA98, 37353945278798544, 89569061, 89569074, 13, 640x360 
0x1382CA98, 37353945279109880, 89569094, 89569106, 12, 640x360 
0x1382CA98, 37353945279437328, 89569135, 89569141, 6, 640x360 
0x1382CA98, 37353945279768576, 89569166, 89569169, 3, 640x360 
0x1382CA98, 37353945280233896, 89569214, 89569216, 2, 640x360 
0x1382CA98, 37353945280553600, 89569248, 89569250, 2, 640x360 
0x1382CA98, 37353945280910120, 89569275, 89569278, 3, 640x360 
0x1382CA98, 37353945281188568, 89569301, 89569306, 5, 640x360 
0x1382CA98, 37353945281513376, 89569342, 89569347, 5, 640x360 
0x1382CA98, 37353945281832640, 89569370, 89569372, 2, 640x360 
0x1382CA98, 37353945282157168, 89569403, 89569406, 3, 640x360 
0x1382CA98, 37353945282494040, 89569438, 89569439, 1, 640x360 
0x1382CA98, 37353945282800672, 89569470, 89569472, 2, 640x360 
0x1382CA98, 37353945283117032, 89569503, 89569505, 2, 640x360 
0x1382CA98, 37353945283435368, 89569536, 89569537, 1, 640x360 
0x1382CA98, 37353945283755792, 89569561, 89569565, 4, 640x360 
0x1382CA98, 37353945284233456, 89569611, 89569615, 4, 640x360 
0x1382CA98, 37353945284559248, 89569640, 89569642, 2, 640x360 
0x1382CA98, 37353945284869296, 89569670, 89569672, 2, 640x360 
0x1382CA98, 37353945285193648, 89569706, 89569710, 4, 640x360 
0x1382CA98, 37353945285523912, 89569739, 89569741, 2, 640x360 
0x1382CA98, 37353945285832856, 89569766, 89569769, 3, 640x360 
0x1382CA98, 37353945286152984, 89569797, 89569802, 5, 640x360 
0x1382CA98, 37353945286468968, 89569840, 89569842, 2, 640x360 
0x1382CA98, 37353945286793872, 89569868, 89569877, 9, 640x360 
0x1382CA98, 37353945287110328, 89569895, 89569899, 4, 640x360 
0x1382CA98, 37353945287441296, 89569929, 89569939, 10, 640x360 
0x1382CA98, 37353945287758408, 89569964, 89569971, 7, 640x360 
0x1382CA98, 37353945288228640, 89570009, 89570021, 12, 640x360 
0x1382CA98, 37353945288548504, 89570035, 89570037, 2, 640x360 
0x1382CA98, 37353945288868768, 89570068, 89570071, 3, 640x360 
0x1382CA98, 37353945289188640, 89570106, 89570108, 2, 640x360 
0x1382CA98, 37353945289508976, 89570145, 89570150, 5, 640x360 
0x1382CA98, 37353945289834136, 89570171, 89570177, 6, 640x360 
0x1382CA98, 37353945290148976, 89570203, 89570205, 2, 640x360 
0x1382CA98, 37353945290487912, 89570241, 89570243, 2, 640x360 
0x1382CA98, 37353945290793320, 89570274, 89570277, 3, 640x360 
0x1382CA98, 37353945291109440, 89570308, 89570310, 2, 640x360 
0x1382CA98, 37353945291435240, 89570341, 89570344, 3, 640x360 
0x1382CA98, 37353945291760888, 89570364, 89570373, 9, 640x360 
0x1382CA98, 37353945292228848, 89570417, 89570423, 6, 640x360 
0x1382CA98, 37353945292553584, 89570443, 89570455, 12, 640x360 
0x1382CA98, 37353945292869960, 89570475, 89570478, 3, 640x360 
0x1382CA98, 37353945293192168, 89570506, 89570509, 3, 640x360 
0x1382CA98, 37353945293516560, 89570539, 89570541, 2, 640x360 
0x1382CA98, 37353945293833512, 89570566, 89570569, 3, 640x360 
0x1382CA98, 37353945294154400, 89570603, 89570611, 8, 640x360 
0x1382CA98, 37353945294472880, 89570634, 89570637, 3, 640x360 
0x1382CA98, 37353945294790704, 89570664, 89570671, 7, 640x360 
0x1382CA98, 37353945295108928, 89570695, 89570704, 9, 640x360 
0x1382CA98, 37353945295438656, 89570732, 89570742, 10, 640x360 
0x1382CA98, 37353945295762408, 89570760, 89570766, 6, 640x360 
0x1382CA98, 37353945296072472, 89570801, 89570803, 2, 640x360 
0x1382CA98, 37353945296547640, 89570836, 89570838, 2, 640x360 
0x1382CA98, 37353945296870104, 89570876, 89570880, 4, 640x360 
0x1382CA98, 37353945297193504, 89570903, 89570906, 3, 640x360 
0x1382CA98, 37353945297508120, 89570942, 89570944, 2, 640x360 
0x1382CA98, 37353945297829976, 89570975, 89570978, 3, 640x360 
0x1382CA98, 37353945298168368, 89571006, 89571009, 3, 640x360 
0x1382CA98, 37353945298476216, 89571044, 89571055, 11, 640x360 
0x1382CA98, 37353945298788696, 89571074, 89571076, 2, 640x360 
0x1382CA98, 37353945299118232, 89571102, 89571104, 2, 640x360 
0x1382CA98, 37353945299429056, 89571135, 89571137, 2, 640x360 
0x1382CA98, 37353945299748136, 89571165, 89571167, 2, 640x360 
0x1382CA98, 37353945300077776, 89571191, 89571195, 4, 640x360 
0x1382CA98, 37353945300551856, 89571248, 89571250, 2, 640x360 
0x1382CA98, 37353945300872592, 89571272, 89571274, 2, 640x360 
0x1382CA98, 37353945301189016, 89571305, 89571307, 2, 640x360 
0x1382CA98, 37353945301507856, 89571347, 89571350, 3, 640x360 
0x1382CA98, 37353945301829368, 89571376, 89571381, 5, 640x360 
0x1382CA98, 37353945302150560, 89571407, 89571408, 1, 640x360 
0x1382CA98, 37353945302471304, 89571436, 89571439, 3, 640x360 
0x1382CA98, 37353945302806696, 89571475, 89571477, 2, 640x360 
0x1382CA98, 37353945303121784, 89571499, 89571508, 9, 640x360 
0x1382CA98, 37353945303443936, 89571525, 89571532, 7, 640x360 
0x1382CA98, 37353945303752968, 89571557, 89571560, 3, 640x360 
0x1382CA98, 37353945304070184, 89571598, 89571601, 3, 640x360 
0x1382CA98, 37353945304551840, 89571648, 89571650, 2, 640x360 
0x1382CA98, 37353945304867512, 89571674, 89571677, 3, 640x360 
0x1382CA98, 37353945305187680, 89571701, 89571704, 3, 640x360 
0x1382CA98, 37353945305521808, 89571738, 89571739, 1, 640x360 
0x1382CA98, 37353945305837272, 89571769, 89571786, 17, 640x360 
0x1382CA98, 37353945306157152, 89571800, 89571806, 6, 640x360 
0x1382CA98, 37353945306485272, 89571855, 89571859, 4, 640x360 
0x1382CA98, 37353945306801704, 89571885, 89571887, 2, 640x360 
0x1382CA98, 37353945307115552, 89571904, 89571907, 3, 640x360 
0x1382CA98, 37353945307434000, 89571937, 89571939, 2, 640x360 
0x1382CA98, 37353945307756160, 89571965, 89571973, 8, 640x360 
0x1382CA98, 37353945308068904, 89572001, 89572007, 6, 640x360 
0x1382CA98, 37353945308559616, 89572075, 89572086, 11, 640x360 
0x1382CA98, 37353945308887552, 89572087, 89572113, 26, 640x360 
0x1382CA98, 37353945309261648, 89572155, 89572162, 7, 640x360 
0x1382CA98, 37353945309846264, 89572191, 89572198, 7, 640x360 
0x1382CA98, 37353945310189872, 89572222, 89572229, 7, 640x360 
0x1382CA98, 37353945310479320, 89572256, 89572278, 22, 640x360 
0x1382CA98, 37353945310842464, 89572284, 89572294, 10, 640x360 
0x1382CA98, 37353945311114520, 89572313, 89572322, 9, 640x360 
0x1382CA98, 37353945311446456, 89572355, 89572358, 3, 640x360 
0x1382CA98, 37353945311787248, 89572402, 89572408, 6, 640x360 
0x1382CA98, 37353945312135984, 89572408, 89572423, 15, 640x360 
0x1382CA98, 37353945312548352, 89572460, 89572478, 18, 640x360 
0x1382CA98, 37353945312944600, 89572491, 89572494, 3, 640x360 
0x1382CA98, 37353945313192664, 89572517, 89572528, 11, 640x360 
0x1382CA98, 37353945313509000, 89572548, 89572556, 8, 640x360 
0x1382CA98, 37353945313835184, 89572570, 89572581, 11, 640x360 
0x1382CA98, 37353945314149496, 89572607, 89572612, 5, 640x360 
0x1382CA98, 37353945314473056, 89572643, 89572647, 4, 640x360 
0x1382CA98, 37353945314787680, 89572664, 89572670, 6, 640x360 
0x1382CA98, 37353945315107728, 89572697, 89572701, 4, 640x360 
0x1382CA98, 37353945315428576, 89572731, 89572733, 2, 640x360 
0x1382CA98, 37353945315747784, 89572764, 89572767, 3, 640x360 
0x1382CA98, 37353945316073136, 89572795, 89572805, 10, 640x360 
0x1382CA98, 37353945316547144, 89572846, 89572852, 6, 640x360 
0x1382CA98, 37353945316867192, 89572874, 89572877, 3, 640x360 
0x1382CA98, 37353945317194240, 89572918, 89572932, 14, 640x360 
0x1382CA98, 37353945317509040, 89572939, 89572942, 3, 640x360 
0x1382CA98, 37353945317827624, 89572966, 89572968, 2, 640x360 
0x1382CA98, 37353945318147408, 89572999, 89573001, 2, 640x360 
0x1382CA98, 37353945318468872, 89573029, 89573034, 5, 640x360 
0x1382CA98, 37353945318788848, 89573060, 89573063, 3, 640x360 
0x1382CA98, 37353945319108760, 89573095, 89573105, 10, 640x360 
0x1382CA98, 37353945319454984, 89573139, 89573141, 2, 640x360 
0x1382CA98, 37353945319757688, 89573180, 89573183, 3, 640x360 
0x1382CA98, 37353945320081504, 89573201, 89573204, 3, 640x360 
0x1382CA98, 37353945320547216, 89573243, 89573250, 7, 640x360 
0x1382CA98, 37353945320879216, 89573277, 89573288, 11, 640x360 
0x1382CA98, 37353945321187984, 89573306, 89573307, 1, 640x360 
0x1382CA98, 37353945321514336, 89573342, 89573347, 5, 640x360 
0x1382CA98, 37353945321827200, 89573363, 89573365, 2, 640x360 
0x1382CA98, 37353945322152016, 89573394, 89573400, 6, 640x360 
0x1382CA98, 37353945322468352, 89573433, 89573436, 3, 640x360 
0x1382CA98, 37353945322803888, 89573469, 89573475, 6, 640x360 
0x1382CA98, 37353945323128000, 89573495, 89573499, 4, 640x360 
0x1382CA98, 37353945323443960, 89573530, 89573534, 4, 640x360 
0x1382CA98, 37353945323756472, 89573557, 89573574, 17, 640x360 
0x1382CA98, 37353945324115008, 89573595, 89573603, 8, 640x360 
0x1382CA98, 37353945324391104, 89573621, 89573623, 2, 640x360 
0x1382CA98, 37353945324870776, 89573673, 89573674, 1, 640x360 
0x1382CA98, 37353945325191048, 89573700, 89573705, 5, 640x360 
0x1382CA98, 37353945325511168, 89573741, 89573743, 2, 640x360 
0x1382CA98, 37353945325831360, 89573764, 89573767, 3, 640x360 
0x1382CA98, 37353945326151336, 89573801, 89573803, 2, 640x360 
0x1382CA98, 37353945326468400, 89573828, 89573837, 9, 640x360 
0x1382CA98, 37353945326787640, 89573869, 89573875, 6, 640x360 
0x1382CA98, 37353945327108112, 89573900, 89573902, 2, 640x360 
0x1382CA98, 37353945327427600, 89573936, 89573938, 2, 640x360 
0x1382CA98, 37353945327747872, 89573967, 89573970, 3, 640x360 
0x1382CA98, 37353945328071088, 89573998, 89574000, 2, 640x360 
0x1382CA98, 37353945328392400, 89574029, 89574033, 4, 640x360 
0x1382CA98, 37353945328866968, 89574081, 89574083, 2, 640x360 
0x1382CA98, 37353945329186968, 89574101, 89574108, 7, 640x360 
0x1382CA98, 37353945329506872, 89574136, 89574138, 2, 640x360 
0x1382CA98, 37353945329827072, 89574166, 89574173, 7, 640x360 
0x1382CA98, 37353945330156144, 89574204, 89574205, 1, 640x360 
0x1382CA98, 37353945330478840, 89574234, 89574243, 9, 640x360 
0x1382CA98, 37353945330789312, 89574264, 89574268, 4, 640x360 
0x1382CA98, 37353945331108648, 89574303, 89574305, 2, 640x360 
0x1382CA98, 37353945331437696, 89574335, 89574338, 3, 640x360 
0x1382CA98, 37353945331747808, 89574368, 89574370, 2, 640x360 
0x1382CA98, 37353945332075504, 89574403, 89574406, 3, 640x360 
0x1382CA98, 37353945332387720, 89574423, 89574428, 5, 640x360 
0x1382CA98, 37353945332866568, 89574475, 89574480, 5, 640x360 
0x1382CA98, 37353945333196224, 89574503, 89574505, 2, 640x360 
0x1382CA98, 37353945333507800, 89574539, 89574542, 3, 640x360 
0x1382CA98, 37353945333832112, 89574573, 89574584, 11, 640x360 
0x1382CA98, 37353945334147416, 89574603, 89574604, 1, 640x360 
0x1382CA98, 37353945334472424, 89574634, 89574639, 5, 640x360 
0x1382CA98, 37353945334794824, 89574674, 89574676, 2, 640x360 
0x1382CA98, 37353945335109520, 89574695, 89574705, 10, 640x360 
0x1382CA98, 37353945335432440, 89574736, 89574737, 1, 640x360 
0x1382CA98, 37353945335756992, 89574768, 89574772, 4, 640x360 
0x1382CA98, 37353945336073720, 89574805, 89574812, 7, 640x360 
0x1382CA98, 37353945336391216, 89574834, 89574840, 6, 640x360 
0x1382CA98, 37353945336867064, 89574876, 89574883, 7, 640x360 
0x1382CA98, 37353945337205824, 89574931, 89574939, 8, 640x360 
0x1382CA98, 37353945337511048, 89574965, 89574973, 8, 640x360 
0x1382CA98, 37353945337842840, 89574988, 89574990, 2, 640x360 
0x1382CA98, 37353945338149568, 89575004, 89575012, 8, 640x360 
0x1382CA98, 37353945338468640, 89575038, 89575041, 3, 640x360 
0x1382CA98, 37353945338792488, 89575070, 89575072, 2, 640x360 
0x1382CA98, 37353945339107616, 89575096, 89575106, 10, 640x360 
0x1382CA98, 37353945339442416, 89575139, 89575141, 2, 640x360 
0x1382CA98, 37353945339747216, 89575166, 89575170, 4, 640x360 
0x1382CA98, 37353945340090736, 89575200, 89575207, 7, 640x360 
0x1382CA98, 37353945340389000, 89575235, 89575238, 3, 640x360 
0x1382CA98, 37353945340870088, 89575273, 89575275, 2, 640x360 
0x1382CA98, 37353945341191656, 89575305, 89575307, 2, 640x360 
0x1382CA98, 37353945341510736, 89575337, 89575340, 3, 640x360 
0x1382CA98, 37353945341827064, 89575368, 89575370, 2, 640x360 
0x1382CA98, 37353945342147800, 89575402, 89575408, 6, 640x360 
0x1382CA98, 37353945342467720, 89575440, 89575443, 3, 640x360 
0x1382CA98, 37353945342788192, 89575479, 89575481, 2, 640x360 
0x1382CA98, 37353945343110208, 89575502, 89575504, 2, 640x360 
0x1382CA98, 37353945343436256, 89575532, 89575540, 8, 640x360 
0x1382CA98, 37353945343770936, 89575584, 89575587, 3, 640x360 
0x1382CA98, 37353945344138712, 89575619, 89575622, 3, 640x360 
0x1382CA98, 37353945344431384, 89575636, 89575642, 6, 640x360 
0x1382CA98, 37353945344866624, 89575677, 89575682, 5, 640x360 
0x1382CA98, 37353945345186656, 89575715, 89575718, 3, 640x360 
0x1382CA98, 37353945345512800, 89575741, 89575745, 4, 640x360 
0x1382CA98, 37353945345836672, 89575790, 89575801, 11, 640x360 
0x1382CA98, 37353945346163552, 89575821, 89575841, 20, 640x360 
0x1382CA98, 37353945346477448, 89575845, 89575858, 13, 640x360 
0x1382CA98, 37353945346807936, 89575888, 89575923, 35, 640x360 
0x1382CA98, 37353945347159880, 89575934, 89575941, 7, 640x360 
0x1382CA98, 37353945347499000, 89575962, 89575975, 13, 640x360 
0x1382CA98, 37353945347850544, 89575987, 89575999, 12, 640x360 
0x1382CA98, 37353945348073728, 89576007, 89576015, 8, 640x360 
0x1382CA98, 37353945348392280, 89576045, 89576055, 10, 640x360 
0x1382CA98, 37353945348866720, 89576082, 89576084, 2, 640x360 
0x1382CA98, 37353945349189840, 89576117, 89576120, 3, 640x360 
0x1382CA98, 37353945349507024, 89576149, 89576163, 14, 640x360 
0x1382CA98, 37353945349850232, 89576199, 89576205, 6, 640x360 
0x1382CA98, 37353945350204784, 89576216, 89576219, 3, 640x360 
0x1382CA98, 37353945350473608, 89576241, 89576244, 3, 640x360 
0x1382CA98, 37353945350797088, 89576275, 89576278, 3, 640x360 
0x1382CA98, 37353945351162032, 89576315, 89576319, 4, 640x360 
0x1382CA98, 37353945351437288, 89576327, 89576340, 13, 640x360 
0x1382CA98, 37353945351754784, 89576360, 89576371, 11, 640x360 
0x1382CA98, 37353945352068056, 89576390, 89576393, 3, 640x360 
0x1382CA98, 37353945352392112, 89576434, 89576442, 8, 640x360 
0x1382CA98, 37353945352713760, 89576465, 89576467, 2, 640x360 
0x1382CA98, 37353945353192792, 89576506, 89576508, 2, 640x360 
0x1382CA98, 37353945353506520, 89576533, 89576536, 3, 640x360 
0x1382CA98, 37353945353830920, 89576574, 89576581, 7, 640x360 
0x1382CA98, 37353945354146952, 89576602, 89576604, 2, 640x360 
0x1382CA98, 37353945354489192, 89576639, 89576641, 2, 640x360 
0x1382CA98, 37353945354789064, 89576660, 89576664, 4, 640x360 
0x1382CA98, 37353945355110928, 89576701, 89576708, 7, 640x360 
0x1382CA98, 37353945355432880, 89576734, 89576738, 4, 640x360 
0x1382CA98, 37353945355747152, 89576762, 89576766, 4, 640x360 
0x1382CA98, 37353945356073424, 89576794, 89576798, 4, 640x360 
0x1382CA98, 37353945356387184, 89576840, 89576844, 4, 640x360 
0x1382CA98, 37353945356723488, 89576901, 89576921, 20, 640x360 
0x1382CA98, 37353945357194336, 89576921, 89576938, 17, 640x360 
0x1382CA98, 37353945357518928, 89576998, 89577007, 9, 640x360 
0x1382CA98, 37353945358156208, 89577023, 89577032, 9, 640x360 
0x1382CA98, 37353945358471808, 89577040, 89577050, 10, 640x360 
0x1382CA98, 37353945358809376, 89577089, 89577103, 14, 640x360 
0x1382CA98, 37353945359131504, 89577111, 89577123, 12, 640x360 
0x1382CA98, 37353945359466992, 89577158, 89577171, 13, 640x360 
0x1382CA98, 37353945359780184, 89577186, 89577213, 27, 640x360 
0x1382CA98, 37353945360100992, 89577240, 89577257, 17, 640x360 
0x1382CA98, 37353945360772600, 89577268, 89577280, 12, 640x360 
0x1382CA98, 37353945361202904, 89577314, 89577317, 3, 640x360 
0x1382CA98, 37353945361506040, 89577344, 89577347, 3, 640x360 
0x1382CA98, 37353945361833840, 89577371, 89577374, 3, 640x360 
0x1382CA98, 37353945362146536, 89577408, 89577410, 2, 640x360 
0x1382CA98, 37353945362468464, 89577441, 89577443, 2, 640x360 
0x1382CA98, 37353945362790312, 89577476, 89577482, 6, 640x360 
0x1382CA98, 37353945363110920, 89577499, 89577504, 5, 640x360 
0x1382CA98, 37353945363431544, 89577533, 89577536, 3, 640x360 
0x1382CA98, 37353945363751176, 89577559, 89577566, 7, 640x360 
0x1382CA98, 37353945364071480, 89577591, 89577594, 3, 640x360 
0x1382CA98, 37353945364386672, 89577635, 89577645, 10, 640x360 
0x1382CA98, 37353945364713368, 89577658, 89577668, 10, 640x360 
0x1382CA98, 37353945365186408, 89577706, 89577711, 5, 640x360 
0x1382CA98, 37353945365507728, 89577746, 89577756, 10, 640x360 
0x1382CA98, 37353945365840248, 89577776, 89577788, 12, 640x360 
0x1382CA98, 37353945366147344, 89577807, 89577815, 8, 640x360 
0x1382CA98, 37353945366468528, 89577839, 89577841, 2, 640x360 
0x1382CA98, 37353945366794304, 89577871, 89577872, 1, 640x360 
0x1382CA98, 37353945367107664, 89577901, 89577903, 2, 640x360 
0x1382CA98, 37353945367476200, 89577935, 89577938, 3, 640x360 
0x1382CA98, 37353945367753984, 89577960, 89577972, 12, 640x360 
0x1382CA98, 37353945368073264, 89577992, 89578000, 8, 640x360 
0x1382CA98, 37353945368387080, 89578032, 89578034, 2, 640x360 
0x1382CA98, 37353945368719304, 89578066, 89578068, 2, 640x360 
0x1382CA98, 37353945369185960, 89578107, 89578111, 4, 640x360 
0x1382CA98, 37353945369506000, 89578138, 89578140, 2, 640x360 
0x1382CA98, 37353945369831520, 89578176, 89578181, 5, 640x360 
0x1382CA98, 37353945370149312, 89578206, 89578208, 2, 640x360 
0x1382CA98, 37353945370466352, 89578236, 89578247, 11, 640x360 
0x1382CA98, 37353945370787448, 89578263, 89578272, 9, 640x360 
0x1382CA98, 37353945371108080, 89578297, 89578303, 6, 640x360 
0x1382CA98, 37353945371434008, 89578329, 89578341, 12, 640x360 
0x1382CA98, 37353945371754800, 89578358, 89578362, 4, 640x360 
0x1382CA98, 37353945372066832, 89578391, 89578397, 6, 640x360 
0x1382CA98, 37353945372408184, 89578432, 89578435, 3, 640x360 
0x1382CA98, 37353945372714760, 89578458, 89578461, 3, 640x360 
0x1382CA98, 37353945373186416, 89578507, 89578510, 3, 640x360 
0x1382CA98, 37353945373511400, 89578536, 89578538, 2, 640x360 
0x1382CA98, 37353945373826128, 89578570, 89578572, 2, 640x360 
0x1382CA98, 37353945374157256, 89578602, 89578605, 3, 640x360 
0x1382CA98, 37353945374472280, 89578645, 89578648, 3, 640x360 
0x1382CA98, 37353945374786768, 89578669, 89578683, 14, 640x360 
0x1382CA98, 37353945375119784, 89578703, 89578716, 13, 640x360 
0x1382CA98, 37353945375468160, 89578739, 89578743, 4, 640x360 
0x1382CA98, 37353945375758272, 89578771, 89578773, 2, 640x360 
0x1382CA98, 37353945376070968, 89578798, 89578802, 4, 640x360 
0x1382CA98, 37353945376386416, 89578825, 89578828, 3, 640x360 
0x1382CA98, 37353945376707880, 89578852, 89578855, 3, 640x360 
0x1382CA98, 37353945377509064, 89578933, 89578942, 9, 640x360 
0x1382CA98, 37353945377829408, 89578967, 89578971, 4, 640x360 
0x1382CA98, 37353945378145944, 89578999, 89579007, 8, 640x360 
0x1382CA98, 37353945378468640, 89579029, 89579038, 9, 640x360 
0x1382CA98, 37353945378790488, 89579073, 89579080, 7, 640x360 
0x1382CA98, 37353945379108616, 89579114, 89579122, 8, 640x360 
0x1382CA98, 37353945379440368, 89579142, 89579147, 5, 640x360 
0x1382CA98, 37353945379750528, 89579173, 89579175, 2, 640x360 
0x1382CA98, 37353945380066696, 89579200, 89579206, 6, 640x360 
0x1382CA98, 37353945380386208, 89579223, 89579226, 3, 640x360 
0x1382CA98, 37353945380711024, 89579264, 89579266, 2, 640x360 
0x1382CA98, 37353945381031256, 89579286, 89579289, 3, 640x360 
0x1382CA98, 37353945381509584, 89579338, 89579340, 2, 640x360 
0x1382CA98, 37353945381840056, 89579389, 89579397, 8, 640x360 
0x1382CA98, 37353945382155032, 89579425, 89579437, 12, 640x360 
0x1382CA98, 37353945382473472, 89579437, 89579441, 4, 640x360 
0x1382CA98, 37353945382788952, 89579473, 89579490, 17, 640x360 
0x1382CA98, 37353945383206040, 89579526, 89579534, 8, 640x360 
0x1382CA98, 37353945383442800, 89579540, 89579548, 8, 640x360 
0x1382CA98, 37353945383778960, 89579569, 89579573, 4, 640x360 
0x1382CA98, 37353945384079160, 89579603, 89579617, 14, 640x360 
0x1382CA98, 37353945384391520, 89579638, 89579641, 3, 640x360 
0x1382CA98, 37353945384711144, 89579658, 89579665, 7, 640x360 
0x1382CA98, 37353945385035440, 89579691, 89579700, 9, 640x360 
0x1382CA98, 37353945385505568, 89579738, 89579744, 6, 640x360 
0x1382CA98, 37353945385829056, 89579766, 89579769, 3, 640x360 
0x1382CA98, 37353945386148336, 89579806, 89579808, 2, 640x360 
0x1382CA98, 37353945386469552, 89579834, 89579843, 9, 640x360 
0x1382CA98, 37353945386794784, 89579869, 89579874, 5, 640x360 
0x1382CA98, 37353945387110944, 89579899, 89579902, 3, 640x360 
0x1382CA98, 37353945387425856, 89579925, 89579927, 2, 640x360 
0x1382CA98, 37353945387752616, 89579963, 89579967, 4, 640x360 
0x1382CA98, 37353945388066872, 89579990, 89579994, 4, 640x360 
0x1382CA98, 37353945388391280, 89580033, 89580035, 2, 640x360 
0x1382CA98, 37353945388726136, 89580073, 89580080, 7, 640x360 
0x1382CA98, 37353945389029560, 89580097, 89580100, 3, 640x360 
0x1382CA98, 37353945389506672, 89580148, 89580150, 2, 640x360 
0x1382CA98, 37353945389835440, 89580181, 89580183, 2, 640x360 
0x1382CA98, 37353945390145760, 89580200, 89580206, 6, 640x360 
0x1382CA98, 37353945390478160, 89580240, 89580253, 13, 640x360 
0x1382CA98, 37353945390830280, 89580273, 89580276, 3, 640x360 
0x1382CA98, 37353945391171712, 89580308, 89580316, 8, 640x360 
0x1382CA98, 37353945391442200, 89580338, 89580340, 2, 640x360 
0x1382CA98, 37353945391747504, 89580363, 89580367, 4, 640x360 
0x1382CA98, 37353945392069488, 89580394, 89580400, 6, 640x360 
0x1382CA98, 37353945392389872, 89580432, 89580439, 7, 640x360 
0x1382CA98, 37353945392706376, 89580467, 89580472, 5, 640x360 
0x1382CA98, 37353945393027528, 89580505, 89580508, 3, 640x360 
0x1382CA98, 37353945393508600, 89580548, 89580556, 8, 640x360 
0x1382CA98, 37353945393830768, 89580575, 89580581, 6, 640x360 
0x1382CA98, 37353945394146976, 89580603, 89580605, 2, 640x360 
0x1382CA98, 37353945394467856, 89580643, 89580645, 2, 640x360 
0x1382CA98, 37353945394790616, 89580671, 89580674, 3, 640x360 
0x1382CA98, 37353945395106992, 89580703, 89580706, 3, 640x360 
0x1382CA98, 37353945395446256, 89580727, 89580738, 11, 640x360 
0x1382CA98, 37353945395751712, 89580758, 89580763, 5, 640x360 
0x1382CA98, 37353945396067712, 89580791, 89580804, 13, 640x360 
0x1382CA98, 37353945396385688, 89580824, 89580828, 4, 640x360 
0x1382CA98, 37353945396705632, 89580854, 89580856, 2, 640x360 
0x1382CA98, 37353945397026232, 89580894, 89580907, 13, 640x360 
0x1382CA98, 37353945397505520, 89580940, 89580942, 2, 640x360 
0x1382CA98, 37353945397834408, 89580967, 89580971, 4, 640x360 
0x1382CA98, 37353945398149536, 89581005, 89581012, 7, 640x360 
0x1382CA98, 37353945398465944, 89581039, 89581078, 39, 640x360 
0x1382CA98, 37353945398805472, 89581085, 89581092, 7, 640x360 
0x1382CA98, 37353945399124592, 89581109, 89581123, 14, 640x360 
0x1382CA98, 37353945399462648, 89581150, 89581164, 14, 640x360 
0x1382CA98, 37353945399764200, 89581193, 89581204, 11, 640x360 
0x1382CA98, 37353945400113008, 89581211, 89581232, 21, 640x360 
0x1382CA98, 37353945400414624, 89581239, 89581244, 5, 640x360 
0x1382CA98, 37353945400706472, 89581268, 89581272, 4, 640x360 
0x1382CA98, 37353945401026616, 89581295, 89581305, 10, 640x360 
0x1382CA98, 37353945401511272, 89581339, 89581343, 4, 640x360 
0x1382CA98, 37353945401830048, 89581372, 89581385, 13, 640x360 
0x1382CA98, 37353945402146752, 89581402, 89581405, 3, 640x360 
0x1382CA98, 37353945402471648, 89581442, 89581447, 5, 640x360 
0x1382CA98, 37353945402784968, 89581472, 89581474, 2, 640x360 
0x1382CA98, 37353945403106888, 89581502, 89581504, 2, 640x360 
0x1382CA98, 37353945403426088, 89581536, 89581538, 2, 640x360 
0x1382CA98, 37353945403745928, 89581567, 89581569, 2, 640x360 
0x1382CA98, 37353945404072136, 89581590, 89581594, 4, 640x360 
0x1382CA98, 37353945404398560, 89581622, 89581625, 3, 640x360 
0x1382CA98, 37353945404712576, 89581653, 89581656, 3, 640x360 
0x1382CA98, 37353945405038816, 89581690, 89581692, 2, 640x360 
0x1382CA98, 37353945405351264, 89581716, 89581718, 2, 640x360 
0x1382CA98, 37353945405830056, 89581762, 89581764, 2, 640x360 
0x1382CA98, 37353945406145960, 89581793, 89581797, 4, 640x360 
0x1382CA98, 37353945406469872, 89581833, 89581836, 3, 640x360 
0x1382CA98, 37353945406785872, 89581858, 89581860, 2, 640x360 
0x1382CA98, 37353945407110328, 89581894, 89581897, 3, 640x360 
0x1382CA98, 37353945407430168, 89581925, 89581932, 7, 640x360 
0x1382CA98, 37353945407746072, 89581956, 89581960, 4, 640x360 
0x1382CA98, 37353945408070424, 89581996, 89581999, 3, 640x360 
0x1382CA98, 37353945408390928, 89582024, 89582028, 4, 640x360 
0x1382CA98, 37353945408709928, 89582055, 89582061, 6, 640x360 
0x1382CA98, 37353945409029200, 89582086, 89582090, 4, 640x360 
0x1382CA98, 37353945409345728, 89582119, 89582128, 9, 640x360 
0x1382CA98, 37353945409824704, 89582173, 89582175, 2, 640x360 
0x1382CA98, 37353945410146736, 89582203, 89582205, 2, 640x360 
0x1382CA98, 37353945410465480, 89582228, 89582235, 7, 640x360 
0x1382CA98, 37353945410804808, 89582267, 89582275, 8, 640x360 
0x1382CA98, 37353945411108352, 89582299, 89582302, 3, 640x360 
0x1382CA98, 37353945411428024, 89582338, 89582341, 3, 640x360 
0x1382CA98, 37353945411751664, 89582368, 89582373, 5, 640x360 
0x1382CA98, 37353945412083592, 89582404, 89582407, 3, 640x360 
0x1382CA98, 37353945412410272, 89582434, 89582437, 3, 640x360 
0x1382CA98, 37353945412708688, 89582466, 89582468, 2, 640x360 
0x1382CA98, 37353945413025152, 89582489, 89582491, 2, 640x360 
0x1382CA98, 37353945413349256, 89582518, 89582522, 4, 640x360 
0x1382CA98, 37353945413825904, 89582564, 89582567, 3, 640x360 
0x1382CA98, 37353945414145896, 89582600, 89582602, 2, 640x360 
0x1382CA98, 37353945414469824, 89582637, 89582640, 3, 640x360 
0x1382CA98, 37353945414825704, 89582684, 89582700, 16, 640x360 
0x1382CA98, 37353945415111000, 89582706, 89582720, 14, 640x360 
0x1382CA98, 37353945415454000, 89582740, 89582764, 24, 640x360 
0x1382CA98, 37353945415804352, 89582781, 89582783, 2, 640x360 
0x1382CA98, 37353945416073656, 89582792, 89582806, 14, 640x360 
0x1382CA98, 37353945416390288, 89582841, 89582843, 2, 640x360 
0x1382CA98, 37353945416707688, 89582866, 89582871, 5, 640x360 
0x1382CA98, 37353945417025216, 89582903, 89582905, 2, 640x360 
0x1382CA98, 37353945417346432, 89582925, 89582927, 2, 640x360 
0x1382CA98, 37353945417828416, 89582968, 89582970, 2, 640x360 
0x1382CA98, 37353945418144512, 89583003, 89583010, 7, 640x360 
0x1382CA98, 37353945418465448, 89583048, 89583051, 3, 640x360 
0x1382CA98, 37353945418785712, 89583068, 89583072, 4, 640x360 
0x1382CA98, 37353945419110272, 89583098, 89583107, 9, 640x360 
0x1382CA98, 37353945419445824, 89583130, 89583138, 8, 640x360 
0x1382CA98, 37353945419751200, 89583156, 89583162, 6, 640x360 
0x1382CA98, 37353945420064992, 89583205, 89583207, 2, 640x360 
0x1382CA98, 37353945420384800, 89583232, 89583238, 6, 640x360 
0x1382CA98, 37353945420705592, 89583262, 89583271, 9, 640x360 
0x1382CA98, 37353945421025248, 89583289, 89583291, 2, 640x360 
0x1382CA98, 37353945421345000, 89583318, 89583321, 3, 640x360 
0x1382CA98, 37353945421824776, 89583400, 89583408, 8, 640x360 
0x1382CA98, 37353945422153584, 89583434, 89583443, 9, 640x360 
0x1382CA98, 37353945422467848, 89583443, 89583462, 19, 640x360 
0x1382CA98, 37353945422792144, 89583476, 89583486, 10, 640x360 
0x1382CA98, 37353945423128968, 89583511, 89583527, 16, 640x360 
0x1382CA98, 37353945423471760, 89583547, 89583551, 4, 640x360 
0x1382CA98, 37353945423759336, 89583567, 89583574, 7, 640x360 
0x1382CA98, 37353945424065704, 89583600, 89583603, 3, 640x360 
0x1382CA98, 37353945424388840, 89583625, 89583630, 5, 640x360 
0x1382CA98, 37353945424704752, 89583656, 89583660, 4, 640x360 
0x1382CA98, 37353945425025656, 89583699, 89583707, 8, 640x360 
0x1382CA98, 37353945425357568, 89583747, 89583756, 9, 640x360 
0x1382CA98, 37353945425831048, 89583803, 89583817, 14, 640x360 
0x1382CA98, 37353945426158944, 89583818, 89583855, 37, 640x360 
0x1382CA98, 37353945426480968, 89583871, 89583905, 34, 640x360 
0x1382CA98, 37353945426933112, 89583963, 89583984, 21, 640x360 
0x1382CA98, 37353945427823888, 89584008, 89584015, 7, 640x360 
0x1382CA98, 37353945428124032, 89584051, 89584057, 6, 640x360 
0x1382CA98, 37353945428556432, 89584082, 89584087, 5, 640x360 
0x1382CA98, 37353945428935208, 89584140, 89584144, 4, 640x360 
0x1382CA98, 37353945429636568, 89584170, 89584180, 10, 640x360 
0x1382CA98, 37353945429877464, 89584195, 89584207, 12, 640x360 
0x1382CA98, 37353945430157800, 89584227, 89584243, 16, 640x360 
0x1382CA98, 37353945430440744, 89584267, 89584271, 4, 640x360 
0x1382CA98, 37353945430872440, 89584281, 89584291, 10, 640x360 
0x1382CA98, 37353945431047896, 89584303, 89584318, 15, 640x360 
0x1382CA98, 37353945431582072, 89584354, 89584357, 3, 640x360 
0x1382CA98, 37353945431763384, 89584380, 89584384, 4, 640x360 
0x1382CA98, 37353945432065160, 89584415, 89584420, 5, 640x360 
0x1382CA98, 37353945432428040, 89584434, 89584437, 3, 640x360 
0x1382CA98, 37353945432704848, 89584469, 89584482, 13, 640x360 
0x1382CA98, 37353945433094112, 89584507, 89584524, 17, 640x360 
0x1382CA98, 37353945433348200, 89584532, 89584540, 8, 640x360 
0x1382CA98, 37353945433691672, 89584567, 89584570, 3, 640x360 
0x1382CA98, 37353945434147952, 89584609, 89584615, 6, 640x360 
0x1382CA98, 37353945434464520, 89584634, 89584636, 2, 640x360 
0x1382CA98, 37353945434794120, 89584669, 89584672, 3, 640x360 
0x1382CA98, 37353945435104792, 89584702, 89584704, 2, 640x360 
0x1382CA98, 37353945435430096, 89584734, 89584736, 2, 640x360 
0x1382CA98, 37353945435745232, 89584763, 89584767, 4, 640x360 
0x1382CA98, 37353945436064480, 89584794, 89584800, 6, 640x360 
0x1382CA98, 37353945436395056, 89584834, 89584836, 2, 640x360 
0x1382CA98, 37353945436708512, 89584858, 89584864, 6, 640x360 
0x1382CA98, 37353945437036616, 89584896, 89584903, 7, 640x360 
0x1382CA98, 37353945437344912, 89584923, 89584925, 2, 640x360 
0x1382CA98, 37353945437664624, 89584954, 89584957, 3, 640x360 
0x1382CA98, 37353945438143904, 89585002, 89585004, 2, 640x360 
0x1382CA98, 37353945438470328, 89585037, 89585039, 2, 640x360 
0x1382CA98, 37353945438790296, 89585065, 89585068, 3, 640x360 
0x1382CA98, 37353945439104680, 89585098, 89585101, 3, 640x360 
0x1382CA98, 37353945439452504, 89585137, 89585140, 3, 640x360 
0x1382CA98, 37353945439758328, 89585175, 89585178, 3, 640x360 
0x1382CA98, 37353945440073192, 89585204, 89585206, 2, 640x360 
0x1382CA98, 37353945440385368, 89585234, 89585242, 8, 640x360 
0x1382CA98, 37353945440708552, 89585270, 89585272, 2, 640x360 
0x1382CA98, 37353945441029504, 89585293, 89585299, 6, 640x360 
0x1382CA98, 37353945441358432, 89585333, 89585335, 2, 640x360 
0x1382CA98, 37353945441664424, 89585364, 89585366, 2, 640x360 
0x1382CA98, 37353945442143928, 89585405, 89585407, 2, 640x360 
0x1382CA98, 37353945442464352, 89585435, 89585438, 3, 640x360 
0x1382CA98, 37353945442784800, 89585469, 89585472, 3, 640x360 
0x1382CA98, 37353945443107752, 89585504, 89585511, 7, 640x360 
0x1382CA98, 37353945443430648, 89585530, 89585534, 4, 640x360 
0x1382CA98, 37353945443750544, 89585562, 89585574, 12, 640x360 
0x1382CA98, 37353945444066552, 89585602, 89585609, 7, 640x360 
0x1382CA98, 37353945444385288, 89585625, 89585634, 9, 640x360 
0x1382CA98, 37353945444708560, 89585657, 89585660, 3, 640x360 
0x1382CA98, 37353945445028272, 89585697, 89585700, 3, 640x360 
0x1382CA98, 37353945445348904, 89585725, 89585727, 2, 640x360 
0x1382CA98, 37353945445668672, 89585758, 89585761, 3, 640x360 
0x1382CA98, 37353945446143888, 89585797, 89585803, 6, 640x360 
0x1382CA98, 37353945446465584, 89585837, 89585842, 5, 640x360 
0x1382CA98, 37353945446792920, 89585875, 89585876, 1, 640x360 
0x1382CA98, 37353945447104040, 89585903, 89585909, 6, 640x360 
0x1382CA98, 37353945447441208, 89585933, 89585935, 2, 640x360 
0x1382CA98, 37353945447747696, 89585957, 89585959, 2, 640x360 
0x1382CA98, 37353945448076224, 89585989, 89585992, 3, 640x360 
0x1382CA98, 37353945448391552, 89586029, 89586032, 3, 640x360 
0x1382CA98, 37353945448704328, 89586058, 89586060, 2, 640x360 
0x1382CA98, 37353945449024424, 89586086, 89586088, 2, 640x360 
0x1382CA98, 37353945449349688, 89586117, 89586120, 3, 640x360 
0x1382CA98, 37353945449665360, 89586148, 89586155, 7, 640x360 
0x1382CA98, 37353945450144096, 89586204, 89586207, 3, 640x360 
0x1382CA98, 37353945450464496, 89586237, 89586240, 3, 640x360 
0x1382CA98, 37353945450786584, 89586274, 89586276, 2, 640x360 
0x1382CA98, 37353945451131464, 89586303, 89586311, 8, 640x360 
0x1382CA98, 37353945451467648, 89586339, 89586341, 2, 640x360 
0x1382CA98, 37353945451763152, 89586369, 89586379, 10, 640x360 
0x1382CA98, 37353945452090224, 89586399, 89586414, 15, 640x360 
0x1382CA98, 37353945452386784, 89586428, 89586434, 6, 640x360 
0x1382CA98, 37353945452707784, 89586464, 89586474, 10, 640x360 
0x1382CA98, 37353945453030776, 89586491, 89586493, 2, 640x360 
0x1382CA98, 37353945453344920, 89586524, 89586526, 2, 640x360 
0x1382CA98, 37353945453668104, 89586556, 89586558, 2, 640x360 
0x1382CA98, 37353945454145512, 89586605, 89586612, 7, 640x360 
0x1382CA98, 37353945454467264, 89586635, 89586642, 7, 640x360 
0x1382CA98, 37353945454783848, 89586664, 89586670, 6, 640x360 
0x1382CA98, 37353945455116592, 89586696, 89586700, 4, 640x360 
0x1382CA98, 37353945455434728, 89586749, 89586756, 7, 640x360 
0x1382CA98, 37353945455771456, 89586773, 89586775, 2, 640x360 
0x1382CA98, 37353945456063944, 89586795, 89586807, 12, 640x360 
0x1382CA98, 37353945456384040, 89586826, 89586829, 3, 640x360 
0x1382CA98, 37353945456711784, 89586852, 89586855, 3, 640x360 
0x1382CA98, 37353945457034480, 89586900, 89586909, 9, 640x360 
0x1382CA98, 37353945457360184, 89586933, 89586949, 16, 640x360 
0x1382CA98, 37353945457711328, 89586969, 89586978, 9, 640x360 
0x1382CA98, 37353945458016592, 89586994, 89586998, 4, 640x360 
0x1382CA98, 37353945458464760, 89587042, 89587055, 13, 640x360 
0x1382CA98, 37353945458788752, 89587085, 89587088, 3, 640x360 
0x1382CA98, 37353945459123840, 89587110, 89587117, 7, 640x360 
0x1382CA98, 37353945459448744, 89587148, 89587153, 5, 640x360 
0x1382CA98, 37353945459776624, 89587171, 89587181, 10, 640x360 
0x1382CA98, 37353945460065368, 89587214, 89587229, 15, 640x360 
0x1382CA98, 37353945460461008, 89587242, 89587272, 30, 640x360 
0x1382CA98, 37353945460715184, 89587272, 89587280, 8, 640x360 
0x1382CA98, 37353945461048168, 89587315, 89587318, 3, 640x360 
0x1382CA98, 37353945461348648, 89587327, 89587335, 8, 640x360 
0x1382CA98, 37353945461666920, 89587361, 89587372, 11, 640x360 
0x1382CA98, 37353945461993432, 89587390, 89587393, 3, 640x360 
0x1382CA98, 37353945462464048, 89587435, 89587437, 2, 640x360 
0x1382CA98, 37353945462783280, 89587465, 89587469, 4, 640x360 
0x1382CA98, 37353945463104136, 89587496, 89587503, 7, 640x360 
0x1382CA98, 37353945463423584, 89587529, 89587534, 5, 640x360 
0x1382CA98, 37353945463749224, 89587564, 89587572, 8, 640x360 
0x1382CA98, 37353945464071272, 89587597, 89587605, 8, 640x360 
0x1382CA98, 37353945464387480, 89587632, 89587649, 17, 640x360 
0x1382CA98, 37353945464709040, 89587665, 89587672, 7, 640x360 
0x1382CA98, 37353945465024312, 89587698, 89587701, 3, 640x360 
0x1382CA98, 37353945465348216, 89587725, 89587731, 6, 640x360 
0x1382CA98, 37353945465684464, 89587785, 89587787, 2, 640x360 
0x1382CA98, 37353945466030744, 89587796, 89587806, 10, 640x360 
0x1382CA98, 37353945466465400, 89587842, 89587844, 2, 640x360 
0x1382CA98, 37353945466792928, 89587874, 89587878, 4, 640x360 
0x1382CA98, 37353945467112096, 89587905, 89587908, 3, 640x360 
0x1382CA98, 37353945467431784, 89587937, 89587938, 1, 640x360 
0x1382CA98, 37353945467750408, 89587961, 89587976, 15, 640x360 
0x1382CA98, 37353945468067040, 89588004, 89588007, 3, 640x360 
0x1382CA98, 37353945468421120, 89588041, 89588044, 3, 640x360 
0x1382CA98, 37353945468704896, 89588060, 89588066, 6, 640x360 
0x1382CA98, 37353945469023552, 89588092, 89588093, 1, 640x360 
0x1382CA98, 37353945469347880, 89588123, 89588125, 2, 640x360 
0x1382CA98, 37353945469663848, 89588157, 89588159, 2, 640x360 
0x1382CA98, 37353945469995448, 89588186, 89588194, 8, 640x360 
0x1382CA98, 37353945470467352, 89588241, 89588243, 2, 640x360 
0x1382CA98, 37353945470785000, 89588269, 89588276, 7, 640x360 
0x1382CA98, 37353945471107024, 89588301, 89588303, 2, 640x360 
0x1382CA98, 37353945471431168, 89588324, 89588328, 4, 640x360 
0x1382CA98, 37353945471758976, 89588363, 89588371, 8, 640x360 
0x1382CA98, 37353945472067184, 89588393, 89588398, 5, 640x360 
0x1382CA98, 37353945472383792, 89588424, 89588426, 2, 640x360 
0x1382CA98, 37353945472703920, 89588453, 89588455, 2, 640x360 
0x1382CA98, 37353945473023456, 89588486, 89588489, 3, 640x360 
0x1382CA98, 37353945473343808, 89588527, 89588532, 5, 640x360 
0x1382CA98, 37353945473680168, 89588552, 89588554, 2, 640x360 
0x1382CA98, 37353945473994896, 89588586, 89588591, 5, 640x360 
0x1382CA98, 37353945474466648, 89588636, 89588639, 3, 640x360 
0x1382CA98, 37353945474784280, 89588661, 89588671, 10, 640x360 
0x1382CA98, 37353945475105048, 89588710, 89588715, 5, 640x360 
0x1382CA98, 37353945475429944, 89588737, 89588739, 2, 640x360 
0x1382CA98, 37353945475756888, 89588772, 89588775, 3, 640x360 
0x1382CA98, 37353945476064744, 89588791, 89588795, 4, 640x360 
0x1382CA98, 37353945476383560, 89588835, 89588841, 6, 640x360 
0x1382CA98, 37353945476705312, 89588864, 89588866, 2, 640x360 
0x1382CA98, 37353945477024744, 89588892, 89588894, 2, 640x360 
0x1382CA98, 37353945477351352, 89588931, 89588934, 3, 640x360 
0x1382CA98, 37353945477663432, 89588953, 89588955, 2, 640x360 
0x1382CA98, 37353945477988464, 89588986, 89588988, 2, 640x360 
0x1382CA98, 37353945478465592, 89589039, 89589046, 7, 640x360 
0x1382CA98, 37353945478783432, 89589062, 89589075, 13, 640x360 
0x1382CA98, 37353945479109696, 89589105, 89589114, 9, 640x360 
0x1382CA98, 37353945479442432, 89589129, 89589142, 13, 640x360 
0x1382CA98, 37353945479768632, 89589167, 89589169, 2, 640x360 
0x1382CA98, 37353945480112408, 89589205, 89589208, 3, 640x360 
0x1382CA98, 37353945480382984, 89589225, 89589231, 6, 640x360 
0x1382CA98, 37353945480708992, 89589257, 89589258, 1, 640x360 
0x1382CA98, 37353945481023176, 89589293, 89589298, 5, 640x360 
0x1382CA98, 37353945481343584, 89589329, 89589338, 9, 640x360 
0x1382CA98, 37353945481669224, 89589362, 89589371, 9, 640x360 
0x1382CA98, 37353945481986952, 89589385, 89589387, 2, 640x360 
0x1382CA98, 37353945482483096, 89589436, 89589438, 2, 640x360 
0x1382CA98, 37353945482783200, 89589459, 89589462, 3, 640x360 
0x1382CA98, 37353945483108440, 89589496, 89589500, 4, 640x360 
0x1382CA98, 37353945483428480, 89589529, 89589532, 3, 640x360 
0x1382CA98, 37353945483747136, 89589560, 89589565, 5, 640x360 
0x1382CA98, 37353945484065800, 89589599, 89589602, 3, 640x360 
0x1382CA98, 37353945484387096, 89589625, 89589627, 2, 640x360 
0x1382CA98, 37353945484704088, 89589664, 89589672, 8, 640x360 
0x1382CA98, 37353945485025216, 89589696, 89589704, 8, 640x360 
0x1382CA98, 37353945485343656, 89589725, 89589726, 1, 640x360 
0x1382CA98, 37353945485667368, 89589754, 89589756, 2, 640x360 
0x1382CA98, 37353945485987968, 89589785, 89589787, 2, 640x360 
0x1382CA98, 37353945486304320, 89589817, 89589820, 3, 640x360 
0x1382CA98, 37353945486786888, 89589859, 89589873, 14, 640x360 
0x1382CA98, 37353945487106832, 89589895, 89589903, 8, 640x360 
0x1382CA98, 37353945487423968, 89589932, 89589936, 4, 640x360 
0x1382CA98, 37353945487742816, 89589964, 89589969, 5, 640x360 
0x1382CA98, 37353945488063328, 89590002, 89590005, 3, 640x360 
0x1382CA98, 37353945488383104, 89590033, 89590036, 3, 640x360 
0x1382CA98, 37353945488702856, 89590062, 89590067, 5, 640x360 
0x1382CA98, 37353945489022992, 89590088, 89590094, 6, 640x360 
0x1382CA98, 37353945489347096, 89590127, 89590134, 7, 640x360 
0x1382CA98, 37353945489668136, 89590150, 89590152, 2, 640x360 
0x1382CA98, 37353945489997944, 89590186, 89590190, 4, 640x360 
0x1382CA98, 37353945490303264, 89590212, 89590218, 6, 640x360 
0x1382CA98, 37353945490786720, 89590269, 89590280, 11, 640x360 
0x1382CA98, 37353945491119112, 89590295, 89590308, 13, 640x360 
0x1382CA98, 37353945491463448, 89590351, 89590356, 5, 640x360 
0x1382CA98, 37353945491760792, 89590369, 89590381, 12, 640x360 
0x1382CA98, 37353945492073056, 89590390, 89590406, 16, 640x360 
0x1382CA98, 37353945492387200, 89590434, 89590439, 5, 640x360 
0x1382CA98, 37353945492703704, 89590461, 89590473, 12, 640x360 
0x1382CA98, 37353945493023312, 89590495, 89590503, 8, 640x360 
0x1382CA98, 37353945493343392, 89590526, 89590531, 5, 640x360 
0x1382CA98, 37353945493663864, 89590558, 89590560, 2, 640x360 
0x1382CA98, 37353945493987272, 89590591, 89590593, 2, 640x360 
0x1382CA98, 37353945494307552, 89590620, 89590623, 3, 640x360 
0x1382CA98, 37353945494783336, 89590675, 89590678, 3, 640x360 
0x1382CA98, 37353945495107096, 89590694, 89590706, 12, 640x360 
0x1382CA98, 37353945495439816, 89590733, 89590736, 3, 640x360 
0x1382CA98, 37353945495752960, 89590760, 89590771, 11, 640x360 
0x1382CA98, 37353945496068944, 89590794, 89590804, 10, 640x360 
0x1382CA98, 37353945496383952, 89590828, 89590833, 5, 640x360 
0x1382CA98, 37353945496707784, 89590853, 89590855, 2, 640x360 
0x1382CA98, 37353945497022688, 89590887, 89590906, 19, 640x360 
0x1382CA98, 37353945497364512, 89590925, 89590933, 8, 640x360 
0x1382CA98, 37353945497689296, 89590953, 89590955, 2, 640x360 
0x1382CA98, 37353945497985544, 89590987, 89590989, 2, 640x360 
0x1382CA98, 37353945498330032, 89591017, 89591019, 2, 640x360 
0x1382CA98, 37353945498782856, 89591076, 89591078, 2, 640x360 
0x1382CA98, 37353945499108376, 89591107, 89591109, 2, 640x360 
0x1382CA98, 37353945499437752, 89591135, 89591144, 9, 640x360 
0x1382CA98, 37353945499743920, 89591165, 89591168, 3, 640x360 
0x1382CA98, 37353945500064928, 89591200, 89591203, 3, 640x360 
0x1382CA98, 37353945500385096, 89591224, 89591227, 3, 640x360 
0x1382CA98, 37353945500704232, 89591264, 89591267, 3, 640x360 
0x1382CA98, 37353945501030264, 89591296, 89591299, 3, 640x360 
0x1382CA98, 37353945501342744, 89591320, 89591322, 2, 640x360 
0x1382CA98, 37353945501668584, 89591358, 89591360, 2, 640x360 
0x1382CA98, 37353945501993824, 89591390, 89591392, 2, 640x360 
0x1382CA98, 37353945502307584, 89591414, 89591420, 6, 640x360 
0x1382CA98, 37353945502784696, 89591462, 89591466, 4, 640x360 
0x1382CA98, 37353945503103224, 89591493, 89591498, 5, 640x360 
0x1382CA98, 37353945503443704, 89591526, 89591531, 5, 640x360 
0x1382CA98, 37353945503747936, 89591559, 89591563, 4, 640x360 
0x1382CA98, 37353945504068240, 89591593, 89591604, 11, 640x360 
0x1382CA98, 37353945504383488, 89591621, 89591623, 2, 640x360 
0x1382CA98, 37353945504703200, 89591657, 89591659, 2, 640x360 
0x1382CA98, 37353945505023288, 89591686, 89591689, 3, 640x360 
0x1382CA98, 37353945505343152, 89591720, 89591722, 2, 640x360 
0x1382CA98, 37353945505663312, 89591751, 89591754, 3, 640x360 
0x1382CA98, 37353945505984392, 89591786, 89591788, 2, 640x360 
0x1382CA98, 37353945506309064, 89591820, 89591822, 2, 640x360 
0x1382CA98, 37353945506782360, 89591869, 89591871, 2, 640x360 
0x1382CA98, 37353945507102720, 89591901, 89591904, 3, 640x360 
0x1382CA98, 37353945507423136, 89591934, 89591937, 3, 640x360 
0x1382CA98, 37353945507747328, 89591964, 89591967, 3, 640x360 
0x1382CA98, 37353945508085928, 89592026, 89592033, 7, 640x360 
0x1382CA98, 37353945508386296, 89592048, 89592083, 35, 640x360 
0x1382CA98, 37353945508715768, 89592092, 89592098, 6, 640x360 
0x1382CA98, 37353945509099840, 89592108, 89592115, 7, 640x360 
0x1382CA98, 37353945509345752, 89592125, 89592130, 5, 640x360 
0x1382CA98, 37353945509662496, 89592160, 89592166, 6, 640x360 
0x1382CA98, 37353945509992136, 89592195, 89592198, 3, 640x360 
0x1382CA98, 37353945510786632, 89592261, 89592264, 3, 640x360 
0x1382CA98, 37353945511105608, 89592293, 89592307, 14, 640x360 
0x1382CA98, 37353945511434760, 89592330, 89592340, 10, 640x360 
0x1382CA98, 37353945511754568, 89592364, 89592373, 9, 640x360 
0x1382CA98, 37353945512067160, 89592392, 89592398, 6, 640x360 
0x1382CA98, 37353945512409400, 89592425, 89592429, 4, 640x360 
0x1382CA98, 37353945512708376, 89592457, 89592460, 3, 640x360 
0x1382CA98, 37353945513023048, 89592485, 89592492, 7, 640x360 
0x1382CA98, 37353945513352984, 89592533, 89592539, 6, 640x360 
0x1382CA98, 37353945513678072, 89592558, 89592562, 4, 640x360 
0x1382CA98, 37353945514007064, 89592591, 89592595, 4, 640x360 
0x1382CA98, 37353945514348960, 89592619, 89592621, 2, 640x360 
0x1382CA98, 37353945514670872, 89592655, 89592657, 2, 640x360 
0x1382CA98, 37353945515111608, 89592698, 89592705, 7, 640x360 
0x1382CA98, 37353945515429384, 89592731, 89592739, 8, 640x360 
0x1382CA98, 37353945515747632, 89592757, 89592761, 4, 640x360 
0x1382CA98, 37353945516066400, 89592793, 89592803, 10, 640x360 
0x1382CA98, 37353945516382240, 89592832, 89592839, 7, 640x360 
0x1382CA98, 37353945516710136, 89592865, 89592868, 3, 640x360 
0x1382CA98, 37353945517027064, 89592885, 89592887, 2, 640x360 
0x1382CA98, 37353945517351400, 89592918, 89592921, 3, 640x360 
0x1382CA98, 37353945517668408, 89592950, 89592953, 3, 640x360 
0x1382CA98, 37353945517985920, 89592983, 89592987, 4, 640x360 
0x1382CA98, 37353945518307104, 89593020, 89593022, 2, 640x360 
0x1382CA98, 37353945518627048, 89593053, 89593055, 2, 640x360 
0x1382CA98, 37353945519107032, 89593107, 89593109, 2, 640x360 
0x1382CA98, 37353945519449784, 89593125, 89593140, 15, 640x360 
0x1382CA98, 37353945519763240, 89593158, 89593161, 3, 640x360 
0x1382CA98, 37353945520063200, 89593190, 89593193, 3, 640x360 
0x1382CA98, 37353945520381952, 89593225, 89593228, 3, 640x360 
0x1382CA98, 37353945520702616, 89593261, 89593269, 8, 640x360 
0x1382CA98, 37353945521023952, 89593293, 89593299, 6, 640x360 
0x1382CA98, 37353945521357720, 89593323, 89593326, 3, 640x360 
0x1382CA98, 37353945521673632, 89593353, 89593355, 2, 640x360 
0x1382CA98, 37353945521983264, 89593387, 89593389, 2, 640x360 
0x1382CA98, 37353945522324200, 89593420, 89593422, 2, 640x360 
0x1382CA98, 37353945522638416, 89593454, 89593456, 2, 640x360 
0x1382CA98, 37353945523104384, 89593498, 89593504, 6, 640x360 
0x1382CA98, 37353945523440528, 89593529, 89593536, 7, 640x360 
0x1382CA98, 37353945523742560, 89593561, 89593572, 11, 640x360 
0x1382CA98, 37353945524070864, 89593595, 89593601, 6, 640x360 
0x1382CA98, 37353945524383440, 89593641, 89593650, 9, 640x360 
0x1382CA98, 37353945524712496, 89593677, 89593682, 5, 640x360 
0x1382CA98, 37353945525039464, 89593717, 89593721, 4, 640x360 
0x1382CA98, 37353945525349480, 89593725, 89593729, 4, 640x360 
0x1382CA98, 37353945525672056, 89593759, 89593764, 5, 640x360 
0x1382CA98, 37353945525986768, 89593783, 89593785, 2, 640x360 
0x1382CA98, 37353945526319824, 89593819, 89593822, 3, 640x360 
0x1382CA98, 37353945526630992, 89593851, 89593853, 2, 640x360 
0x1382CA98, 37353945527102088, 89593896, 89593901, 5, 640x360 
0x1382CA98, 37353945527422616, 89593926, 89593935, 9, 640x360 
0x1382CA98, 37353945527747472, 89593959, 89593972, 13, 640x360 
0x1382CA98, 37353945528071000, 89593997, 89594008, 11, 640x360 
0x1382CA98, 37353945528391160, 89594035, 89594038, 3, 640x360 
0x1382CA98, 37353945528701904, 89594054, 89594056, 2, 640x360 
0x1382CA98, 37353945529024320, 89594089, 89594091, 2, 640x360 
0x1382CA98, 37353945529342008, 89594130, 89594134, 4, 640x360 
0x1382CA98, 37353945529662152, 89594150, 89594160, 10, 640x360 
0x1382CA98, 37353945530005688, 89594185, 89594188, 3, 640x360 
0x1382CA98, 37353945530305968, 89594228, 89594233, 5, 640x360 
0x1382CA98, 37353945530624032, 89594251, 89594254, 3, 640x360 
0x1382CA98, 37353945531105448, 89594295, 89594303, 8, 640x360 
0x1382CA98, 37353945531435304, 89594326, 89594338, 12, 640x360 
0x1382CA98, 37353945531749368, 89594364, 89594367, 3, 640x360 
0x1382CA98, 37353945532065136, 89594390, 89594392, 2, 640x360 
0x1382CA98, 37353945532413736, 89594426, 89594432, 6, 640x360 
0x1382CA98, 37353945532702712, 89594454, 89594456, 2, 640x360 
0x1382CA98, 37353945533022896, 89594497, 89594504, 7, 640x360 
0x1382CA98, 37353945533344704, 89594518, 89594525, 7, 640x360 
0x1382CA98, 37353945533679136, 89594552, 89594554, 2, 640x360 
0x1382CA98, 37353945533984152, 89594586, 89594588, 2, 640x360 
0x1382CA98, 37353945534317616, 89594617, 89594620, 3, 640x360 
0x1382CA98, 37353945534631808, 89594653, 89594655, 2, 640x360 
0x1382CA98, 37353945535103968, 89594697, 89594705, 8, 640x360 
0x1382CA98, 37353945535439912, 89594730, 89594742, 12, 640x360 
0x1382CA98, 37353945535749592, 89594763, 89594767, 4, 640x360 
0x1382CA98, 37353945536090856, 89594792, 89594802, 10, 640x360 
0x1382CA98, 37353945536384400, 89594834, 89594836, 2, 640x360 
0x1382CA98, 37353945536702464, 89594858, 89594861, 3, 640x360 
0x1382CA98, 37353945537023200, 89594889, 89594891, 2, 640x360 
0x1382CA98, 37353945537342520, 89594916, 89594923, 7, 640x360 
0x1382CA98, 37353945537662304, 89594958, 89594961, 3, 640x360 
0x1382CA98, 37353945537988312, 89594986, 89594988, 2, 640x360 
0x1382CA98, 37353945538313200, 89595021, 89595023, 2, 640x360 
0x1382CA98, 37353945538622136, 89595048, 89595051, 3, 640x360 
0x1382CA98, 37353945538946824, 89595077, 89595084, 7, 640x360 
0x1382CA98, 37353945539438720, 89595126, 89595142, 16, 640x360 
0x1382CA98, 37353945539775128, 89595163, 89595172, 9, 640x360 
0x1382CA98, 37353945540062736, 89595192, 89595199, 7, 640x360 
0x1382CA98, 37353945540414096, 89595223, 89595226, 3, 640x360 
0x1382CA98, 37353945540705760, 89595255, 89595258, 3, 640x360 
0x1382CA98, 37353945541025872, 89595290, 89595292, 2, 640x360 
0x1382CA98, 37353945541343752, 89595319, 89595321, 2, 640x360 
0x1382CA98, 37353945541661616, 89595355, 89595356, 1, 640x360 
0x1382CA98, 37353945541983824, 89595393, 89595396, 3, 640x360 
0x1382CA98, 37353945542308808, 89595425, 89595428, 3, 640x360 
0x1382CA98, 37353945542623448, 89595453, 89595455, 2, 640x360 
0x1382CA98, 37353945542947664, 89595486, 89595489, 3, 640x360 
0x1382CA98, 37353945543429384, 89595534, 89595536, 2, 640x360 
0x1382CA98, 37353945543742936, 89595558, 89595561, 3, 640x360 
0x1382CA98, 37353945544065832, 89595590, 89595594, 4, 640x360 
0x1382CA98, 37353945544381584, 89595628, 89595638, 10, 640x360 
0x1382CA98, 37353945544701888, 89595660, 89595670, 10, 640x360 
0x1382CA98, 37353945545022352, 89595698, 89595704, 6, 640x360 
0x1382CA98, 37353945545343016, 89595725, 89595728, 3, 640x360 
0x1382CA98, 37353945545672376, 89595752, 89595755, 3, 640x360 
0x1382CA98, 37353945545997560, 89595785, 89595788, 3, 640x360 
0x1382CA98, 37353945546309360, 89595820, 89595822, 2, 640x360 
0x1382CA98, 37353945546636864, 89595851, 89595853, 2, 640x360 
0x1382CA98, 37353945546942488, 89595875, 89595881, 6, 640x360 
0x1382CA98, 37353945547425824, 89595930, 89595932, 2, 640x360 
0x1382CA98, 37353945547747032, 89595961, 89595967, 6, 640x360 
0x1382CA98, 37353945548066912, 89595988, 89595991, 3, 640x360 
0x1382CA98, 37353945548385744, 89596031, 89596033, 2, 640x360 
0x1382CA98, 37353945548706472, 89596058, 89596063, 5, 640x360 
0x1382CA98, 37353945549021776, 89596094, 89596098, 4, 640x360 
0x1382CA98, 37353945549341864, 89596122, 89596124, 2, 640x360 
0x1382CA98, 37353945549662040, 89596151, 89596159, 8, 640x360 
0x1382CA98, 37353945549981768, 89596186, 89596190, 4, 640x360 
0x1382CA98, 37353945550312056, 89596225, 89596229, 4, 640x360 
0x1382CA98, 37353945550630384, 89596256, 89596259, 3, 640x360 
0x1382CA98, 37353945550948704, 89596289, 89596292, 3, 640x360 
0x1382CA98, 37353945551436648, 89596350, 89596353, 3, 640x360 
0x1382CA98, 37353945551746240, 89596361, 89596373, 12, 640x360 
0x1382CA98, 37353945552064328, 89596398, 89596411, 13, 640x360 
0x1382CA98, 37353945552387832, 89596430, 89596434, 4, 640x360 
0x1382CA98, 37353945552707832, 89596455, 89596457, 2, 640x360 
0x1382CA98, 37353945553021928, 89596492, 89596495, 3, 640x360 
0x1382CA98, 37353945553342296, 89596521, 89596522, 1, 640x360 
0x1382CA98, 37353945553665288, 89596555, 89596557, 2, 640x360 
0x1382CA98, 37353945553982248, 89596590, 89596592, 2, 640x360 
0x1382CA98, 37353945554305488, 89596621, 89596623, 2, 640x360 
0x1382CA98, 37353945554624232, 89596657, 89596659, 2, 640x360 
0x1382CA98, 37353945554943736, 89596681, 89596683, 2, 640x360 
0x1382CA98, 37353945555432656, 89596730, 89596733, 3, 640x360 
0x1382CA98, 37353945555755680, 89596758, 89596761, 3, 640x360 
0x1382CA98, 37353945556098840, 89596797, 89596805, 8, 640x360 
0x1382CA98, 37353945556381992, 89596825, 89596831, 6, 640x360 
0x1382CA98, 37353945556704072, 89596852, 89596858, 6, 640x360 
0x1382CA98, 37353945557021704, 89596889, 89596892, 3, 640x360 
0x1382CA98, 37353945557341392, 89596917, 89596925, 8, 640x360 
0x1382CA98, 37353945557698968, 89596956, 89596959, 3, 640x360 
0x1382CA98, 37353945558005008, 89596989, 89596991, 2, 640x360 
0x1382CA98, 37353945558304408, 89597019, 89597022, 3, 640x360 
0x1382CA98, 37353945558622152, 89597055, 89597057, 2, 640x360 
0x1382CA98, 37353945558950592, 89597088, 89597091, 3, 640x360 
0x1382CA98, 37353945559444112, 89597138, 89597141, 3, 640x360 
0x1382CA98, 37353945559758680, 89597174, 89597178, 4, 640x360 
0x1382CA98, 37353945560077696, 89597205, 89597213, 8, 640x360 
0x1382CA98, 37353945560382760, 89597252, 89597257, 5, 640x360 
0x1382CA98, 37353945560715424, 89597275, 89597284, 9, 640x360 
0x1382CA98, 37353945561045640, 89597292, 89597305, 13, 640x360 
0x1382CA98, 37353945561341512, 89597331, 89597339, 8, 640x360 
0x1382CA98, 37353945561678912, 89597367, 89597380, 13, 640x360 
0x1382CA98, 37353945561984472, 89597408, 89597427, 19, 640x360 
0x1382CA98, 37353945562307640, 89597441, 89597453, 12, 640x360 
0x1382CA98, 37353945562656768, 89597469, 89597481, 12, 640x360 
0x1382CA98, 37353945562946904, 89597487, 89597508, 21, 640x360 
0x1382CA98, 37353945563464128, 89597548, 89597568, 20, 640x360 
0x1382CA98, 37353945563760736, 89597585, 89597592, 7, 640x360 
0x1382CA98, 37353945564096464, 89597623, 89597628, 5, 640x360 
0x1382CA98, 37353945564437536, 89597649, 89597652, 3, 640x360 
0x1382CA98, 37353945564707104, 89597670, 89597683, 13, 640x360 
0x1382CA98, 37353945565024360, 89597712, 89597722, 10, 640x360 
0x1382CA98, 37353945565374328, 89597732, 89597744, 12, 640x360 
0x1382CA98, 37353945565661488, 89597758, 89597762, 4, 640x360 
0x1382CA98, 37353945565984544, 89597785, 89597787, 2, 640x360 
0x1382CA98, 37353945566301976, 89597823, 89597825, 2, 640x360 
0x1382CA98, 37353945566622368, 89597851, 89597853, 2, 640x360 
0x1382CA98, 37353945566944520, 89597885, 89597887, 2, 640x360 
0x1382CA98, 37353945567261208, 89597909, 89597917, 8, 640x360 
0x1382CA98, 37353945567755224, 89597969, 89597971, 2, 640x360 
0x1382CA98, 37353945568061952, 89597999, 89598001, 2, 640x360 
0x1382CA98, 37353945568381432, 89598031, 89598035, 4, 640x360 
0x1382CA98, 37353945568701320, 89598060, 89598064, 4, 640x360 
0x1382CA98, 37353945569023616, 89598089, 89598091, 2, 640x360 
0x1382CA98, 37353945569382280, 89598131, 89598134, 3, 640x360 
0x1382CA98, 37353945569661192, 89598155, 89598157, 2, 640x360 
0x1382CA98, 37353945569986192, 89598186, 89598189, 3, 640x360 
0x1382CA98, 37353945570305216, 89598219, 89598221, 2, 640x360 
0x1382CA98, 37353945570624592, 89598248, 89598252, 4, 640x360 
0x1382CA98, 37353945570942392, 89598276, 89598282, 6, 640x360 
0x1382CA98, 37353945571270984, 89598308, 89598311, 3, 640x360 
0x1382CA98, 37353945571744680, 89598359, 89598362, 3, 640x360 
0x1382CA98, 37353945572077968, 89598391, 89598404, 13, 640x360 
0x1382CA98, 37353945572385248, 89598426, 89598438, 12, 640x360 
0x1382CA98, 37353945572701104, 89598456, 89598458, 2, 640x360 
0x1382CA98, 37353945573020624, 89598484, 89598495, 11, 640x360 
0x1382CA98, 37353945573346240, 89598521, 89598524, 3, 640x360 
0x1382CA98, 37353945573685040, 89598553, 89598555, 2, 640x360 
0x1382CA98, 37353945573985032, 89598586, 89598592, 6, 640x360 
0x1382CA98, 37353945574300696, 89598617, 89598619, 2, 640x360 
0x1382CA98, 37353945574621696, 89598643, 89598650, 7, 640x360 
0x1382CA98, 37353945574942248, 89598683, 89598686, 3, 640x360 
0x1382CA98, 37353945575262072, 89598707, 89598711, 4, 640x360 
0x1382CA98, 37353945575764760, 89598800, 89598803, 3, 640x360 
0x1382CA98, 37353945576088488, 89598805, 89598818, 13, 640x360 
0x1382CA98, 37353945576388032, 89598847, 89598857, 10, 640x360 
0x1382CA98, 37353945576724408, 89598887, 89598892, 5, 640x360 
0x1382CA98, 37353945577057080, 89598905, 89598907, 2, 640x360 
0x1382CA98, 37353945577345136, 89598926, 89598930, 4, 640x360 
0x1382CA98, 37353945577660472, 89598958, 89598962, 4, 640x360 
0x1382CA98, 37353945577987920, 89598991, 89598993, 2, 640x360 
0x1382CA98, 37353945578301464, 89599017, 89599019, 2, 640x360 
0x1382CA98, 37353945578623416, 89599045, 89599055, 10, 640x360 
0x1382CA98, 37353945578941576, 89599085, 89599092, 7, 640x360 
0x1382CA98, 37353945579263040, 89599117, 89599123, 6, 640x360 
0x1382CA98, 37353945579748240, 89599164, 89599172, 8, 640x360 
0x1382CA98, 37353945580060456, 89599195, 89599207, 12, 640x360 
0x1382CA98, 37353945580382384, 89599233, 89599239, 6, 640x360 
0x1382CA98, 37353945580704504, 89599265, 89599267, 2, 640x360 
0x1382CA98, 37353945581024384, 89599294, 89599304, 10, 640x360 
0x1382CA98, 37353945581342112, 89599318, 89599331, 13, 640x360 
0x1382CA98, 37353945581665912, 89599350, 89599357, 7, 640x360 
0x1382CA98, 37353945581980640, 89599384, 89599386, 2, 640x360 
0x1382CA98, 37353945582306544, 89599419, 89599422, 3, 640x360 
0x1382CA98, 37353945582624440, 89599452, 89599455, 3, 640x360 
0x1382CA98, 37353945582941864, 89599479, 89599486, 7, 640x360 
0x1382CA98, 37353945583266456, 89599515, 89599517, 2, 640x360 
0x1382CA98, 37353945583746456, 89599568, 89599571, 3, 640x360 
0x1382CA98, 37353945584060584, 89599598, 89599603, 5, 640x360 
0x1382CA98, 37353945584383728, 89599626, 89599632, 6, 640x360 
0x1382CA98, 37353945584701136, 89599659, 89599664, 5, 640x360 
0x1382CA98, 37353945585036640, 89599701, 89599708, 7, 640x360 
0x1382CA98, 37353945585349784, 89599724, 89599731, 7, 640x360 
0x1382CA98, 37353945585660888, 89599757, 89599760, 3, 640x360 
0x1382CA98, 37353945585981912, 89599798, 89599801, 3, 640x360 
0x1382CA98, 37353945586311304, 89599818, 89599821, 3, 640x360 
0x1382CA98, 37353945586620680, 89599848, 89599856, 8, 640x360 
0x1382CA98, 37353945586945728, 89599880, 89599887, 7, 640x360 
0x1382CA98, 37353945587267240, 89599914, 89599920, 6, 640x360 
0x1382CA98, 37353945587746744, 89599963, 89599965, 2, 640x360 
0x1382CA98, 37353945588065144, 89599993, 89600005, 12, 640x360 
0x1382CA98, 37353945588380928, 89600026, 89600032, 6, 640x360 
0x1382CA98, 37353945588700624, 89600063, 89600070, 7, 640x360 
0x1382CA98, 37353945589020112, 89600091, 89600094, 3, 640x360 
0x1382CA98, 37353945589340232, 89600117, 89600119, 2, 640x360 
0x1382CA98, 37353945589670976, 89600155, 89600157, 2, 640x360 
0x1382CA98, 37353945589980976, 89600185, 89600187, 2, 640x360 
0x1382CA98, 37353945590309200, 89600220, 89600222, 2, 640x360 
0x1382CA98, 37353945590635624, 89600246, 89600250, 4, 640x360 
0x1382CA98, 37353945590941432, 89600273, 89600276, 3, 640x360 
0x1382CA98, 37353945591268056, 89600309, 89600317, 8, 640x360 
0x1382CA98, 37353945591767672, 89600366, 89600368, 2, 640x360 
0x1382CA98, 37353945592069576, 89600392, 89600394, 2, 640x360 
0x1382CA98, 37353945592384728, 89600420, 89600422, 2, 640x360 
0x1382CA98, 37353945592700392, 89600451, 89600454, 3, 640x360 
0x1382CA98, 37353945593020528, 89600483, 89600491, 8, 640x360 
0x1382CA98, 37353945593340584, 89600515, 89600522, 7, 640x360 
0x1382CA98, 37353945593660320, 89600557, 89600572, 15, 640x360 
0x1382CA98, 37353945593986880, 89600600, 89600609, 9, 640x360 
0x1382CA98, 37353945594346776, 89600625, 89600630, 5, 640x360 
0x1382CA98, 37353945594635296, 89600658, 89600663, 5, 640x360 
0x1382CA98, 37353945594960328, 89600687, 89600689, 2, 640x360 
0x1382CA98, 37353945595260544, 89600717, 89600722, 5, 640x360 
0x1382CA98, 37353945595584784, 89600746, 89600750, 4, 640x360 
0x1382CA98, 37353945596060168, 89600799, 89600808, 9, 640x360 
0x1382CA98, 37353945596384968, 89600841, 89600847, 6, 640x360 
0x1382CA98, 37353945596703632, 89600856, 89600860, 4, 640x360 
0x1382CA98, 37353945597049896, 89600907, 89600914, 7, 640x360 
0x1382CA98, 37353945597353928, 89600927, 89600942, 15, 640x360 
0x1382CA98, 37353945597666776, 89600971, 89600980, 9, 640x360 
0x1382CA98, 37353945597982432, 89600991, 89600995, 4, 640x360 
0x1382CA98, 37353945598340544, 89601024, 89601028, 4, 640x360 
0x1382CA98, 37353945598623928, 89601065, 89601074, 9, 640x360 
0x1382CA98, 37353945598947656, 89601090, 89601092, 2, 640x360 
0x1382CA98, 37353945599261616, 89601113, 89601122, 9, 640x360 
0x1382CA98, 37353945599610384, 89601154, 89601156, 2, 640x360 
0x1382CA98, 37353945600060016, 89601193, 89601204, 11, 640x360 
0x1382CA98, 37353945600380368, 89601226, 89601233, 7, 640x360 
0x1382CA98, 37353945600704688, 89601255, 89601257, 2, 640x360 
0x1382CA98, 37353945601041824, 89601290, 89601295, 5, 640x360 
0x1382CA98, 37353945601343568, 89601317, 89601320, 3, 640x360 
0x1382CA98, 37353945601664440, 89601360, 89601364, 4, 640x360 
0x1382CA98, 37353945601987136, 89601386, 89601387, 1, 640x360 
0x1382CA98, 37353945602302664, 89601413, 89601417, 4, 640x360 
0x1382CA98, 37353945602634224, 89601446, 89601449, 3, 640x360 
0x1382CA98, 37353945602940720, 89601481, 89601489, 8, 640x360 
0x1382CA98, 37353945603265904, 89601514, 89601517, 3, 640x360 
0x1382CA98, 37353945603586992, 89601541, 89601545, 4, 640x360 
0x1382CA98, 37353945604068424, 89601602, 89601605, 3, 640x360 
0x1382CA98, 37353945604420416, 89601632, 89601635, 3, 640x360 
0x1382CA98, 37353945604705312, 89601659, 89601662, 3, 640x360 
0x1382CA98, 37353945605021392, 89601691, 89601696, 5, 640x360 
0x1382CA98, 37353945605339608, 89601725, 89601728, 3, 640x360 
0x1382CA98, 37353945605679072, 89601770, 89601776, 6, 640x360 
0x1382CA98, 37353945605984112, 89601810, 89601817, 7, 640x360 
0x1382CA98, 37353945606303992, 89601820, 89601831, 11, 640x360 
0x1382CA98, 37353945606634648, 89601854, 89601860, 6, 640x360 
0x1382CA98, 37353945606948456, 89601891, 89601901, 10, 640x360 
0x1382CA98, 37353945607267176, 89601916, 89601934, 18, 640x360 
0x1382CA98, 37353945607634064, 89601957, 89601965, 8, 640x360 
0x1382CA98, 37353945608073920, 89601994, 89602010, 16, 640x360 
0x1382CA98, 37353945608398832, 89602035, 89602038, 3, 640x360 
0x1382CA98, 37353945608703368, 89602054, 89602056, 2, 640x360 
0x1382CA98, 37353945609023048, 89602089, 89602091, 2, 640x360 
0x1382CA98, 37353945609343704, 89602118, 89602121, 3, 640x360 
0x1382CA98, 37353945609663376, 89602158, 89602161, 3, 640x360 
0x1382CA98, 37353945609983632, 89602191, 89602193, 2, 640x360 
0x1382CA98, 37353945610300648, 89602223, 89602226, 3, 640x360 
0x1382CA98, 37353945610620576, 89602248, 89602252, 4, 640x360 
0x1382CA98, 37353945610943672, 89602279, 89602284, 5, 640x360 
0x1382CA98, 37353945611260200, 89602309, 89602315, 6, 640x360 
0x1382CA98, 37353945611580832, 89602351, 89602354, 3, 640x360 
0x1382CA98, 37353945612060728, 89602401, 89602404, 3, 640x360 
0x1382CA98, 37353945612386288, 89602434, 89602436, 2, 640x360 
0x1382CA98, 37353945612700104, 89602455, 89602459, 4, 640x360 
0x1382CA98, 37353945613021208, 89602488, 89602492, 4, 640x360 
0x1382CA98, 37353945613339720, 89602521, 89602531, 10, 640x360 
0x1382CA98, 37353945613659336, 89602559, 89602561, 2, 640x360 
0x1382CA98, 37353945613989248, 89602585, 89602593, 8, 640x360 
0x1382CA98, 37353945614303400, 89602622, 89602625, 3, 640x360 
0x1382CA98, 37353945614620080, 89602647, 89602653, 6, 640x360 
0x1382CA98, 37353945614940144, 89602678, 89602687, 9, 640x360 
0x1382CA98, 37353945615260048, 89602712, 89602718, 6, 640x360 
0x1382CA98, 37353945615580864, 89602743, 89602753, 10, 640x360 
0x1382CA98, 37353945616064184, 89602790, 89602792, 2, 640x360 
0x1382CA98, 37353945616383744, 89602831, 89602833, 2, 640x360 
0x1382CA98, 37353945616712008, 89602865, 89602867, 2, 640x360 
0x1382CA98, 37353945617020040, 89602886, 89602889, 3, 640x360 
0x1382CA98, 37353945617344520, 89602917, 89602922, 5, 640x360 
0x1382CA98, 37353945617669808, 89602950, 89602953, 3, 640x360 
0x1382CA98, 37353945617980160, 89602986, 89602989, 3, 640x360 
0x1382CA98, 37353945618300264, 89603020, 89603022, 2, 640x360 
0x1382CA98, 37353945618624016, 89603048, 89603058, 10, 640x360 
0x1382CA98, 37353945618941288, 89603082, 89603088, 6, 640x360 
0x1382CA98, 37353945619263328, 89603110, 89603121, 11, 640x360 
0x1382CA98, 37353945619585992, 89603143, 89603158, 15, 640x360 
0x1382CA98, 37353945620059416, 89603190, 89603193, 3, 640x360 
0x1382CA98, 37353945620379392, 89603225, 89603227, 2, 640x360 
0x1382CA98, 37353945620699504, 89603257, 89603259, 2, 640x360 
0x1382CA98, 37353945621023120, 89603290, 89603293, 3, 640x360 
0x1382CA98, 37353945621340760, 89603319, 89603326, 7, 640x360 
0x1382CA98, 37353945621661424, 89603357, 89603358, 1, 640x360 
0x1382CA98, 37353945621980072, 89603386, 89603388, 2, 640x360 
0x1382CA98, 37353945622306520, 89603431, 89603435, 4, 640x360 
0x1382CA98, 37353945622620592, 89603451, 89603457, 6, 640x360 
0x1382CA98, 37353945622940408, 89603481, 89603483, 2, 640x360 
0x1382CA98, 37353945623263072, 89603511, 89603518, 7, 640x360 
0x1382CA98, 37353945623602064, 89603542, 89603546, 4, 640x360 
0x1382CA98, 37353945623900248, 89603583, 89603586, 3, 640x360 
0x1382CA98, 37353945624379536, 89603632, 89603634, 2, 640x360 
0x1382CA98, 37353945624704360, 89603662, 89603666, 4, 640x360 
0x1382CA98, 37353945625023896, 89603685, 89603687, 2, 640x360 
0x1382CA98, 37353945625339216, 89603718, 89603728, 10, 640x360 
0x1382CA98, 37353945625662096, 89603753, 89603756, 3, 640x360 
0x1382CA98, 37353945625985376, 89603785, 89603790, 5, 640x360 
0x1382CA98, 37353945626305208, 89603822, 89603828, 6, 640x360 
0x1382CA98, 37353945626622576, 89603851, 89603859, 8, 640x360 
0x1382CA98, 37353945626941432, 89603890, 89603891, 1, 640x360 
0x1382CA98, 37353945627266016, 89603921, 89603923, 2, 640x360 
0x1382CA98, 37353945627580480, 89603954, 89603956, 2, 640x360 
0x1382CA98, 37353945627911096, 89603986, 89603989, 3, 640x360 
0x1382CA98, 37353945628378984, 89604031, 89604034, 3, 640x360 
0x1382CA98, 37353945628699024, 89604056, 89604058, 2, 640x360 
0x1382CA98, 37353945629019600, 89604085, 89604093, 8, 640x360 
0x1382CA98, 37353945629346416, 89604122, 89604124, 2, 640x360 
0x1382CA98, 37353945629673184, 89604156, 89604157, 1, 640x360 
0x1382CA98, 37353945629994624, 89604186, 89604188, 2, 640x360 
0x1382CA98, 37353945630311488, 89604219, 89604221, 2, 640x360 
0x1382CA98, 37353945630631920, 89604254, 89604256, 2, 640x360 
0x1382CA98, 37353945630946712, 89604287, 89604289, 2, 640x360 
0x1382CA98, 37353945631260576, 89604314, 89604316, 2, 640x360 
0x1382CA98, 37353945631590984, 89604349, 89604351, 2, 640x360 
0x1382CA98, 37353945631902432, 89604382, 89604385, 3, 640x360 
0x1382CA98, 37353945632380064, 89604427, 89604432, 5, 640x360 
0x1382CA98, 37353945632704368, 89604457, 89604468, 11, 640x360 
0x1382CA98, 37353945633020408, 89604488, 89604495, 7, 640x360 
0x1382CA98, 37353945633343280, 89604531, 89604534, 3, 640x360 
0x1382CA98, 37353945633660032, 89604553, 89604559, 6, 640x360 
0x1382CA98, 37353945633982744, 89604586, 89604588, 2, 640x360 
0x1382CA98, 37353945634303808, 89604618, 89604620, 2, 640x360 
0x1382CA98, 37353945634625304, 89604646, 89604650, 4, 640x360 
0x1382CA98, 37353945634944024, 89604680, 89604682, 2, 640x360 
0x1382CA98, 37353945635270312, 89604712, 89604714, 2, 640x360 
0x1382CA98, 37353945635590448, 89604743, 89604745, 2, 640x360 
0x1382CA98, 37353945635923848, 89604787, 89604789, 2, 640x360 
0x1382CA98, 37353945636379632, 89604832, 89604834, 2, 640x360 
0x1382CA98, 37353945636701952, 89604854, 89604861, 7, 640x360 
0x1382CA98, 37353945637028272, 89604891, 89604893, 2, 640x360 
0x1382CA98, 37353945637342336, 89604922, 89604924, 2, 640x360 
0x1382CA98, 37353945637670008, 89604953, 89604960, 7, 640x360 
0x1382CA98, 37353945637987704, 89604981, 89604987, 6, 640x360 
0x1382CA98, 37353945638304776, 89605022, 89605028, 6, 640x360 
0x1382CA98, 37353945638623296, 89605051, 89605058, 7, 640x360 
0x1382CA98, 37353945638943104, 89605086, 89605092, 6, 640x360 
0x1382CA98, 37353945639267544, 89605131, 89605140, 9, 640x360 
0x1382CA98, 37353945639607336, 89605158, 89605160, 2, 640x360 
0x1382CA98, 37353945639902232, 89605175, 89605179, 4, 640x360 
0x1382CA98, 37353945640378992, 89605232, 89605235, 3, 640x360 
0x1382CA98, 37353945640702800, 89605262, 89605266, 4, 640x360 
0x1382CA98, 37353945641023656, 89605295, 89605299, 4, 640x360 
0x1382CA98, 37353945641339544, 89605318, 89605325, 7, 640x360 
0x1382CA98, 37353945641660160, 89605351, 89605359, 8, 640x360 
0x1382CA98, 37353945641979704, 89605380, 89605383, 3, 640x360 
0x1382CA98, 37353945642302200, 89605419, 89605429, 10, 640x360 
0x1382CA98, 37353945642619656, 89605446, 89605455, 9, 640x360 
0x1382CA98, 37353945642944600, 89605493, 89605499, 6, 640x360 
0x1382CA98, 37353945643268752, 89605511, 89605526, 15, 640x360 
0x1382CA98, 37353945643605624, 89605553, 89605559, 6, 640x360 
0x1382CA98, 37353945643905272, 89605586, 89605588, 2, 640x360 
0x1382CA98, 37353945644378568, 89605630, 89605637, 7, 640x360 
0x1382CA98, 37353945644704408, 89605657, 89605659, 2, 640x360 
0x1382CA98, 37353945645029808, 89605690, 89605692, 2, 640x360 
0x1382CA98, 37353945645348224, 89605723, 89605725, 2, 640x360 
0x1382CA98, 37353945645663496, 89605754, 89605759, 5, 640x360 
0x1382CA98, 37353945645983736, 89605784, 89605792, 8, 640x360 
0x1382CA98, 37353945646305040, 89605824, 89605826, 2, 640x360 
0x1382CA98, 37353945646622592, 89605862, 89605866, 4, 640x360 
0x1382CA98, 37353945646949600, 89605880, 89605883, 3, 640x360 
0x1382CA98, 37353945647261208, 89605919, 89605921, 2, 640x360 
0x1382CA98, 37353945647607784, 89605952, 89605954, 2, 640x360 
0x1382CA98, 37353945647907736, 89605978, 89605982, 4, 640x360 
0x1382CA98, 37353945648224600, 89606007, 89606010, 3, 640x360 
0x1382CA98, 37353945648702336, 89606064, 89606068, 4, 640x360 
0x1382CA98, 37353945649019208, 89606085, 89606088, 3, 640x360 
0x1382CA98, 37353945649348448, 89606124, 89606128, 4, 640x360 
0x1382CA98, 37353945649681592, 89606159, 89606163, 4, 640x360 
0x1382CA98, 37353945650004160, 89606193, 89606206, 13, 640x360 
0x1382CA98, 37353945650331800, 89606220, 89606222, 2, 640x360 
0x1382CA98, 37353945650656552, 89606254, 89606257, 3, 640x360 
0x1382CA98, 37353945650939144, 89606299, 89606316, 17, 640x360 
0x1382CA98, 37353945651282032, 89606324, 89606327, 3, 640x360 
0x1382CA98, 37353945651584352, 89606351, 89606353, 2, 640x360 
0x1382CA98, 37353945651905168, 89606381, 89606388, 7, 640x360 
0x1382CA98, 37353945652218784, 89606416, 89606419, 3, 640x360 
0x1382CA98, 37353945652702352, 89606459, 89606461, 2, 640x360 
0x1382CA98, 37353945653018472, 89606487, 89606490, 3, 640x360 
0x1382CA98, 37353945653338472, 89606518, 89606524, 6, 640x360 
0x1382CA98, 37353945653668152, 89606552, 89606554, 2, 640x360 
0x1382CA98, 37353945653980336, 89606586, 89606588, 2, 640x360 
0x1382CA98, 37353945654306240, 89606619, 89606621, 2, 640x360 
0x1382CA98, 37353945654636488, 89606654, 89606656, 2, 640x360 
0x1382CA98, 37353945654949040, 89606687, 89606689, 2, 640x360 
0x1382CA98, 37353945655263488, 89606711, 89606716, 5, 640x360 
0x1382CA98, 37353945655579296, 89606742, 89606745, 3, 640x360 
0x1382CA98, 37353945655911928, 89606775, 89606778, 3, 640x360 
0x1382CA98, 37353945656224896, 89606808, 89606810, 2, 640x360 
0x1382CA98, 37353945656699360, 89606856, 89606860, 4, 640x360 
0x1382CA98, 37353945657026104, 89606893, 89606896, 3, 640x360 
0x1382CA98, 37353945657342520, 89606934, 89606953, 19, 640x360 
0x1382CA98, 37353945657717416, 89606961, 89606967, 6, 640x360 
0x1382CA98, 37353945657979192, 89606989, 89606993, 4, 640x360 
0x1382CA98, 37353945658301344, 89607022, 89607030, 8, 640x360 
0x1382CA98, 37353945658618672, 89607042, 89607045, 3, 640x360 
0x1382CA98, 37353945658945320, 89607096, 89607101, 5, 640x360 
0x1382CA98, 37353945659278240, 89607124, 89607127, 3, 640x360 
0x1382CA98, 37353945659579480, 89607158, 89607161, 3, 640x360 
0x1382CA98, 37353945659900440, 89607188, 89607195, 7, 640x360 
0x1382CA98, 37353945660253640, 89607234, 89607249, 15, 640x360 
0x1382CA98, 37353945660713424, 89607274, 89607279, 5, 640x360 
0x1382CA98, 37353945661022328, 89607290, 89607293, 3, 640x360 
0x1382CA98, 37353945661349984, 89607338, 89607347, 9, 640x360 
0x1382CA98, 37353945661658840, 89607358, 89607361, 3, 640x360 
0x1382CA98, 37353945661979760, 89607389, 89607393, 4, 640x360 
0x1382CA98, 37353945662299144, 89607421, 89607423, 2, 640x360 
0x1382CA98, 37353945662619000, 89607454, 89607456, 2, 640x360 
0x1382CA98, 37353945662938920, 89607485, 89607487, 2, 640x360 
0x1382CA98, 37353945663262936, 89607511, 89607521, 10, 640x360 
0x1382CA98, 37353945663580056, 89607555, 89607558, 3, 640x360 
0x1382CA98, 37353945663921416, 89607587, 89607590, 3, 640x360 
0x1382CA98, 37353945664220688, 89607613, 89607623, 10, 640x360 
0x1382CA98, 37353945664702088, 89607658, 89607663, 5, 640x360 
0x1382CA98, 37353945665022320, 89607684, 89607693, 9, 640x360 
0x1382CA98, 37353945665342184, 89607719, 89607722, 3, 640x360 
0x1382CA98, 37353945665659336, 89607753, 89607761, 8, 640x360 
0x1382CA98, 37353945665980288, 89607788, 89607790, 2, 640x360 
0x1382CA98, 37353945666303376, 89607819, 89607829, 10, 640x360 
0x1382CA98, 37353945666621784, 89607847, 89607850, 3, 640x360 
0x1382CA98, 37353945666945840, 89607881, 89607885, 4, 640x360 
0x1382CA98, 37353945667261952, 89607911, 89607922, 11, 640x360 
0x1382CA98, 37353945667583112, 89607947, 89607957, 10, 640x360 
0x1382CA98, 37353945667907632, 89607983, 89607986, 3, 640x360 
0x1382CA98, 37353945668226176, 89608019, 89608022, 3, 640x360 
0x1382CA98, 37353945668697840, 89608060, 89608066, 6, 640x360 
0x1382CA98, 37353945669030816, 89608086, 89608090, 4, 640x360 
0x1382CA98, 37353945669338544, 89608125, 89608133, 8, 640x360 
0x1382CA98, 37353945669658776, 89608162, 89608166, 4, 640x360 
0x1382CA98, 37353945669991888, 89608193, 89608211, 18, 640x360 
0x1382CA98, 37353945670322792, 89608225, 89608227, 2, 640x360 
0x1382CA98, 37353945670677528, 89608257, 89608259, 2, 640x360 
0x1382CA98, 37353945670947560, 89608297, 89608312, 15, 640x360 
0x1382CA98, 37353945671279128, 89608322, 89608332, 10, 640x360 
0x1382CA98, 37353945671607496, 89608349, 89608358, 9, 640x360 
0x1382CA98, 37353945671907384, 89608377, 89608391, 14, 640x360 
0x1382CA98, 37353945672220648, 89608410, 89608422, 12, 640x360 
0x1382CA98, 37353945672697720, 89608459, 89608462, 3, 640x360 
0x1382CA98, 37353945673017944, 89608484, 89608486, 2, 640x360 
0x1382CA98, 37353945673342024, 89608521, 89608523, 2, 640x360 
0x1382CA98, 37353945673661768, 89608554, 89608556, 2, 640x360 
0x1382CA98, 37353945673981720, 89608586, 89608588, 2, 640x360 
0x1382CA98, 37353945674299152, 89608612, 89608621, 9, 640x360 
0x1382CA98, 37353945674619024, 89608644, 89608658, 14, 640x360 
0x1382CA98, 37353945674955344, 89608686, 89608696, 10, 640x360 
0x1382CA98, 37353945675260088, 89608720, 89608722, 2, 640x360 
0x1382CA98, 37353945675586960, 89608756, 89608764, 8, 640x360 
0x1382CA98, 37353945675912384, 89608778, 89608783, 5, 640x360 
0x1382CA98, 37353945676222040, 89608812, 89608822, 10, 640x360 
0x1382CA98, 37353945676538192, 89608837, 89608839, 2, 640x360 
0x1382CA98, 37353945677021640, 89608890, 89608892, 2, 640x360 
0x1382CA98, 37353945677338376, 89608916, 89608919, 3, 640x360 
0x1382CA98, 37353945677658560, 89608951, 89608953, 2, 640x360 
0x1382CA98, 37353945677978632, 89608986, 89608988, 2, 640x360 
0x1382CA98, 37353945678303352, 89609013, 89609023, 10, 640x360 
0x1382CA98, 37353945678622968, 89609046, 89609049, 3, 640x360 
0x1382CA98, 37353945678938592, 89609077, 89609083, 6, 640x360 
0x1382CA98, 37353945679266504, 89609126, 89609153, 27, 640x360 
0x1382CA98, 37353945679682784, 89609176, 89609183, 7, 640x360 
0x1382CA98, 37353945679943640, 89609198, 89609205, 7, 640x360 
0x1382CA98, 37353945680221192, 89609236, 89609247, 11, 640x360 
0x1382CA98, 37353945680727560, 89609274, 89609280, 6, 640x360 
0x1382CA98, 37353945681020344, 89609306, 89609315, 9, 640x360 
0x1382CA98, 37353945681345944, 89609320, 89609325, 5, 640x360 
0x1382CA98, 37353945681679008, 89609362, 89609374, 12, 640x360 
0x1382CA98, 37353945681982584, 89609402, 89609414, 12, 640x360 
0x1382CA98, 37353945682301104, 89609438, 89609446, 8, 640x360 
0x1382CA98, 37353945682622200, 89609454, 89609458, 4, 640x360 
0x1382CA98, 37353945682956784, 89609490, 89609492, 2, 640x360 
0x1382CA98, 37353945683264152, 89609517, 89609521, 4, 640x360 
0x1382CA98, 37353945683608752, 89609554, 89609558, 4, 640x360 
0x1382CA98, 37353945683900696, 89609591, 89609604, 13, 640x360 
0x1382CA98, 37353945684286048, 89609633, 89609636, 3, 640x360 
0x1382CA98, 37353945684544776, 89609649, 89609657, 8, 640x360 
0x1382CA98, 37353945685020960, 89609699, 89609708, 9, 640x360 
0x1382CA98, 37353945685347896, 89609732, 89609745, 13, 640x360 
0x1382CA98, 37353945685664504, 89609759, 89609773, 14, 640x360 
0x1382CA98, 37353945686040440, 89609801, 89609809, 8, 640x360 
0x1382CA98, 37353945686304280, 89609828, 89609834, 6, 640x360 
0x1382CA98, 37353945686627240, 89609860, 89609868, 8, 640x360 
0x1382CA98, 37353945686949192, 89609886, 89609897, 11, 640x360 
0x1382CA98, 37353945687269408, 89609918, 89609920, 2, 640x360 
0x1382CA98, 37353945687594064, 89609944, 89609963, 19, 640x360 
0x1382CA98, 37353945687899232, 89610004, 89610011, 7, 640x360 
0x1382CA98, 37353945688290800, 89610038, 89610041, 3, 640x360 
0x1382CA98, 37353945688545112, 89610049, 89610052, 3, 640x360 
0x1382CA98, 37353945689017920, 89610093, 89610100, 7, 640x360 
0x1382CA98, 37353945689342856, 89610133, 89610140, 7, 640x360 
0x1382CA98, 37353945689675120, 89610176, 89610183, 7, 640x360 
0x1382CA98, 37353945689981704, 89610208, 89610213, 5, 640x360 
0x1382CA98, 37353945690359152, 89610243, 89610261, 18, 640x360 
0x1382CA98, 37353945690650504, 89610270, 89610274, 4, 640x360 
0x1382CA98, 37353945690966064, 89610290, 89610295, 5, 640x360 
0x1382CA98, 37353945691265664, 89610323, 89610325, 2, 640x360 
0x1382CA98, 37353945691602760, 89610355, 89610358, 3, 640x360 
0x1382CA98, 37353945691904832, 89610382, 89610386, 4, 640x360 
0x1382CA98, 37353945692267680, 89610432, 89610440, 8, 640x360 
0x1382CA98, 37353945692547504, 89610452, 89610461, 9, 640x360 
0x1382CA98, 37353945693017696, 89610493, 89610499, 6, 640x360 
0x1382CA98, 37353945693340976, 89610534, 89610538, 4, 640x360 
0x1382CA98, 37353945693660328, 89610558, 89610561, 3, 640x360 
0x1382CA98, 37353945693987336, 89610595, 89610602, 7, 640x360 
0x1382CA98, 37353945694307520, 89610624, 89610626, 2, 640x360 
0x1382CA98, 37353945694618264, 89610652, 89610654, 2, 640x360 
0x1382CA98, 37353945694937616, 89610682, 89610690, 8, 640x360 
0x1382CA98, 37353945695269064, 89610726, 89610733, 7, 640x360 
0x1382CA98, 37353945695617912, 89610769, 89610775, 6, 640x360 
0x1382CA98, 37353945695913032, 89610787, 89610790, 3, 640x360 
0x1382CA98, 37353945696219480, 89610819, 89610835, 16, 640x360 
0x1382CA98, 37353945696543064, 89610854, 89610857, 3, 640x360 
0x1382CA98, 37353945697022752, 89610895, 89610901, 6, 640x360 
0x1382CA98, 37353945697341528, 89610932, 89610935, 3, 640x360 
0x1382CA98, 37353945697657424, 89610958, 89610963, 5, 640x360 
0x1382CA98, 37353945698004616, 89611000, 89611013, 13, 640x360 
0x1382CA98, 37353945698303472, 89611040, 89611043, 3, 640x360 
0x1382CA98, 37353945698647168, 89611075, 89611077, 2, 640x360 
0x1382CA98, 37353945698992384, 89611101, 89611114, 13, 640x360 
0x1382CA98, 37353945699309776, 89611129, 89611163, 34, 640x360 
0x1382CA98, 37353945699589720, 89611167, 89611185, 18, 640x360 
0x1382CA98, 37353945699932536, 89611211, 89611221, 10, 640x360 
0x1382CA98, 37353945700260608, 89611221, 89611224, 3, 640x360 
0x1382CA98, 37353945700540272, 89611254, 89611257, 3, 640x360 
0x1382CA98, 37353945700858920, 89611276, 89611284, 8, 640x360 
0x1382CA98, 37353945701341104, 89611331, 89611335, 4, 640x360 
0x1382CA98, 37353945701658584, 89611355, 89611358, 3, 640x360 
0x1382CA98, 37353945701981752, 89611392, 89611398, 6, 640x360 
0x1382CA98, 37353945702309816, 89611425, 89611427, 2, 640x360 
0x1382CA98, 37353945702618920, 89611452, 89611454, 2, 640x360 
0x1382CA98, 37353945702941376, 89611502, 89611512, 10, 640x360 
0x1382CA98, 37353945703292760, 89611527, 89611537, 10, 640x360 
0x1382CA98, 37353945703660144, 89611557, 89611561, 4, 640x360 
0x1382CA98, 37353945703910880, 89611587, 89611588, 1, 640x360 
0x1382CA98, 37353945704218200, 89611607, 89611610, 3, 640x360 
0x1382CA98, 37353945704538856, 89611641, 89611643, 2, 640x360 
0x1382CA98, 37353945704861880, 89611680, 89611684, 4, 640x360 
0x1382CA98, 37353945705361104, 89611730, 89611733, 3, 640x360 
0x1382CA98, 37353945705668920, 89611752, 89611754, 2, 640x360 
0x1382CA98, 37353945705979296, 89611792, 89611793, 1, 640x360 
0x1382CA98, 37353945706302480, 89611821, 89611823, 2, 640x360 
0x1382CA98, 37353945706620368, 89611842, 89611845, 3, 640x360 
0x1382CA98, 37353945706937160, 89611883, 89611891, 8, 640x360 
0x1382CA98, 37353945707264424, 89611908, 89611915, 7, 640x360 
0x1382CA98, 37353945707589152, 89611947, 89611949, 2, 640x360 
0x1382CA98, 37353945707916568, 89611981, 89611989, 8, 640x360 
0x1382CA98, 37353945708222344, 89612011, 89612019, 8, 640x360 
0x1382CA98, 37353945708555904, 89612043, 89612047, 4, 640x360 
0x1382CA98, 37353945708857680, 89612076, 89612079, 3, 640x360 
0x1382CA98, 37353945709339200, 89612117, 89612129, 12, 640x360 
0x1382CA98, 37353945709661368, 89612157, 89612158, 1, 640x360 
0x1382CA98, 37353945709982888, 89612191, 89612193, 2, 640x360 
0x1382CA98, 37353945710297488, 89612219, 89612221, 2, 640x360 
0x1382CA98, 37353945710624816, 89612245, 89612248, 3, 640x360 
0x1382CA98, 37353945710939288, 89612284, 89612286, 2, 640x360 
0x1382CA98, 37353945711266392, 89612309, 89612315, 6, 640x360 
0x1382CA98, 37353945711608560, 89612341, 89612345, 4, 640x360 
0x1382CA98, 37353945711898040, 89612374, 89612380, 6, 640x360 
0x1382CA98, 37353945712224344, 89612414, 89612419, 5, 640x360 
0x1382CA98, 37353945712552816, 89612439, 89612441, 2, 640x360 
0x1382CA98, 37353945712870000, 89612480, 89612483, 3, 640x360 
0x1382CA98, 37353945713336592, 89612530, 89612539, 9, 640x360 
0x1382CA98, 37353945713672304, 89612559, 89612562, 3, 640x360 
0x1382CA98, 37353945713976648, 89612585, 89612587, 2, 640x360 
0x1382CA98, 37353945714308648, 89612633, 89612636, 3, 640x360 
0x1382CA98, 37353945714632288, 89612655, 89612657, 2, 640x360 
0x1382CA98, 37353945714944464, 89612686, 89612693, 7, 640x360 
0x1382CA98, 37353945715278944, 89612724, 89612727, 3, 640x360 
0x1382CA98, 37353945715604664, 89612748, 89612752, 4, 640x360 
0x1382CA98, 37353945715899536, 89612785, 89612788, 3, 640x360 
0x1382CA98, 37353945716223784, 89612823, 89612834, 11, 640x360 
0x1382CA98, 37353945716609168, 89612855, 89612859, 4, 640x360 
0x1382CA98, 37353945716858592, 89612876, 89612892, 16, 640x360 
0x1382CA98, 37353945717336488, 89612927, 89612941, 14, 640x360 
0x1382CA98, 37353945717668496, 89612960, 89612977, 17, 640x360 
0x1382CA98, 37353945717987432, 89613018, 89613022, 4, 640x360 
0x1382CA98, 37353945718322112, 89613041, 89613053, 12, 640x360 
0x1382CA98, 37353945718644216, 89613076, 89613082, 6, 640x360 
0x1382CA98, 37353945718954488, 89613101, 89613109, 8, 640x360 
0x1382CA98, 37353945719285160, 89613124, 89613135, 11, 640x360 
0x1382CA98, 37353945719599400, 89613171, 89613174, 3, 640x360 
0x1382CA98, 37353945719963760, 89613194, 89613199, 5, 640x360 
0x1382CA98, 37353945720220368, 89613234, 89613239, 5, 640x360 
0x1382CA98, 37353945720553320, 89613250, 89613252, 2, 640x360 
0x1382CA98, 37353945720857888, 89613280, 89613285, 5, 640x360 
0x1382CA98, 37353945721340000, 89613324, 89613352, 28, 640x360 
0x1382CA98, 37353945721678592, 89613364, 89613374, 10, 640x360 
0x1382CA98, 37353945722010160, 89613400, 89613408, 8, 640x360 
0x1382CA98, 37353945722303408, 89613419, 89613430, 11, 640x360 
0x1382CA98, 37353945722619304, 89613447, 89613451, 4, 640x360 
0x1382CA98, 37353945722951856, 89613480, 89613491, 11, 640x360 
0x1382CA98, 37353945723279256, 89613520, 89613526, 6, 640x360 
0x1382CA98, 37353945723582728, 89613551, 89613566, 15, 640x360 
0x1382CA98, 37353945723907904, 89613586, 89613593, 7, 640x360 
0x1382CA98, 37353945724220224, 89613617, 89613622, 5, 640x360 
0x1382CA98, 37353945724537736, 89613654, 89613658, 4, 640x360 
0x1382CA98, 37353945724859800, 89613685, 89613692, 7, 640x360 
0x1382CA98, 37353945725339648, 89613738, 89613740, 2, 640x360 
0x1382CA98, 37353945725669352, 89613778, 89613791, 13, 640x360 
0x1382CA98, 37353945725979688, 89613799, 89613808, 9, 640x360 
0x1382CA98, 37353945726303976, 89613825, 89613828, 3, 640x360 
0x1382CA98, 37353945726616552, 89613844, 89613859, 15, 640x360 
0x1382CA98, 37353945726952160, 89613892, 89613899, 7, 640x360 
0x1382CA98, 37353945727264208, 89613925, 89613927, 2, 640x360 
0x1382CA98, 37353945727606632, 89613952, 89613974, 22, 640x360 
0x1382CA98, 37353945727902672, 89613991, 89614015, 24, 640x360 
0x1382CA98, 37353945728301928, 89614060, 89614074, 14, 640x360 
0x1382CA98, 37353945728575968, 89614089, 89614098, 9, 640x360 
0x1382CA98, 37353945728874920, 89614122, 89614131, 9, 640x360 
0x1382CA98, 37353945729302144, 89614151, 89614154, 3, 640x360 
0x1382CA98, 37353945729657440, 89614183, 89614188, 5, 640x360 
0x1382CA98, 37353945730011528, 89614204, 89614207, 3, 640x360 
0x1382CA98, 37353945730316648, 89614231, 89614236, 5, 640x360 
0x1382CA98, 37353945730636296, 89614253, 89614255, 2, 640x360 
0x1382CA98, 37353945730936992, 89614290, 89614305, 15, 640x360 
0x1382CA98, 37353945731295080, 89614323, 89614325, 2, 640x360 
0x1382CA98, 37353945731595496, 89614355, 89614359, 4, 640x360 
0x1382CA98, 37353945731922520, 89614399, 89614401, 2, 640x360 
0x1382CA98, 37353945732243648, 89614420, 89614422, 2, 640x360 
0x1382CA98, 37353945732541856, 89614440, 89614443, 3, 640x360 
0x1382CA98, 37353945732857688, 89614485, 89614491, 6, 640x360 
0x1382CA98, 37353945733178880, 89614502, 89614513, 11, 640x360 
0x1382CA98, 37353945733660352, 89614557, 89614559, 2, 640x360 
0x1382CA98, 37353945733980880, 89614589, 89614591, 2, 640x360 
0x1382CA98, 37353945734314448, 89614619, 89614625, 6, 640x360 
0x1382CA98, 37353945734618704, 89614657, 89614661, 4, 640x360 
0x1382CA98, 37353945734944216, 89614686, 89614688, 2, 640x360 
0x1382CA98, 37353945735260336, 89614714, 89614723, 9, 640x360 
0x1382CA98, 37353945735607592, 89614753, 89614756, 3, 640x360 
0x1382CA98, 37353945735914096, 89614785, 89614788, 3, 640x360 
0x1382CA98, 37353945736221416, 89614819, 89614822, 3, 640x360 
0x1382CA98, 37353945736540400, 89614857, 89614862, 5, 640x360 
0x1382CA98, 37353945736859488, 89614887, 89614894, 7, 640x360 
0x1382CA98, 37353945737178848, 89614909, 89614912, 3, 640x360 
0x1382CA98, 37353945737667984, 89614960, 89614965, 5, 640x360 
0x1382CA98, 37353945737976448, 89614988, 89614990, 2, 640x360 
0x1382CA98, 37353945738299576, 89615031, 89615041, 10, 640x360 
0x1382CA98, 37353945738619912, 89615071, 89615073, 2, 640x360 
0x1382CA98, 37353945738937024, 89615098, 89615101, 3, 640x360 
0x1382CA98, 37353945739278376, 89615122, 89615138, 16, 640x360 
0x1382CA98, 37353945739589936, 89615151, 89615154, 3, 640x360 
0x1382CA98, 37353945739909312, 89615187, 89615195, 8, 640x360 
0x1382CA98, 37353945740223056, 89615217, 89615223, 6, 640x360 
0x1382CA98, 37353945740536600, 89615244, 89615249, 5, 640x360 
0x1382CA98, 37353945740856448, 89615273, 89615275, 2, 640x360 
0x1382CA98, 37353945741177592, 89615302, 89615304, 2, 640x360 
0x1382CA98, 37353945741681008, 89615353, 89615365, 12, 640x360 
0x1382CA98, 37353945741979552, 89615398, 89615402, 4, 640x360 
0x1382CA98, 37353945742328872, 89615423, 89615425, 2, 640x360 
0x1382CA98, 37353945742672744, 89615451, 89615454, 3, 640x360 
0x1382CA98, 37353945742951864, 89615484, 89615492, 8, 640x360 
0x1382CA98, 37353945743270952, 89615519, 89615525, 6, 640x360 
0x1382CA98, 37353945743592624, 89615553, 89615555, 2, 640x360 
0x1382CA98, 37353945743900624, 89615581, 89615584, 3, 640x360 
0x1382CA98, 37353945744217984, 89615606, 89615609, 3, 640x360 
0x1382CA98, 37353945744536752, 89615636, 89615648, 12, 640x360 
0x1382CA98, 37353945744866488, 89615682, 89615685, 3, 640x360 
0x1382CA98, 37353945745183040, 89615707, 89615710, 3, 640x360 
0x1382CA98, 37353945745658768, 89615754, 89615761, 7, 640x360 
0x1382CA98, 37353945745975904, 89615787, 89615791, 4, 640x360 
0x1382CA98, 37353945746305152, 89615829, 89615833, 4, 640x360 
0x1382CA98, 37353945746624944, 89615852, 89615856, 4, 640x360 
0x1382CA98, 37353945746937608, 89615877, 89615883, 6, 640x360 
0x1382CA98, 37353945747276808, 89615916, 89615919, 3, 640x360 
0x1382CA98, 37353945747586880, 89615942, 89615945, 3, 640x360 
0x1382CA98, 37353945747906768, 89615976, 89615979, 3, 640x360 
0x1382CA98, 37353945748222176, 89616007, 89616009, 2, 640x360 
0x1382CA98, 37353945748536448, 89616039, 89616041, 2, 640x360 
0x1382CA98, 37353945748856768, 89616069, 89616072, 3, 640x360 
0x1382CA98, 37353945749177288, 89616109, 89616114, 5, 640x360 
0x1382CA98, 37353945749656632, 89616157, 89616159, 2, 640x360 
0x1382CA98, 37353945749976848, 89616185, 89616188, 3, 640x360 
0x1382CA98, 37353945750296848, 89616219, 89616221, 2, 640x360 
0x1382CA98, 37353945750620664, 89616244, 89616250, 6, 640x360 
0x1382CA98, 37353945750939792, 89616275, 89616280, 5, 640x360 
0x1382CA98, 37353945751278432, 89616315, 89616322, 7, 640x360 
0x1382CA98, 37353945751595912, 89616344, 89616356, 12, 640x360 
0x1382CA98, 37353945751905256, 89616381, 89616391, 10, 640x360 
0x1382CA98, 37353945752217304, 89616415, 89616417, 2, 640x360 
0x1382CA98, 37353945752536472, 89616440, 89616442, 2, 640x360 
0x1382CA98, 37353945752856488, 89616470, 89616473, 3, 640x360 
0x1382CA98, 37353945753177296, 89616501, 89616508, 7, 640x360 
0x1382CA98, 37353945753659016, 89616552, 89616554, 2, 640x360 
0x1382CA98, 37353945753976424, 89616578, 89616587, 9, 640x360 
0x1382CA98, 37353945754301112, 89616614, 89616619, 5, 640x360 
0x1382CA98, 37353945754617112, 89616645, 89616650, 5, 640x360 
0x1382CA98, 37353945754940416, 89616676, 89616680, 4, 640x360 
0x1382CA98, 37353945755262336, 89616708, 89616713, 5, 640x360 
0x1382CA98, 37353945755585760, 89616741, 89616744, 3, 640x360 
0x1382CA98, 37353945755907552, 89616771, 89616774, 3, 640x360 
0x1382CA98, 37353945756216984, 89616803, 89616805, 2, 640x360 
0x1382CA98, 37353945756536992, 89616835, 89616837, 2, 640x360 
0x1382CA98, 37353945756857048, 89616872, 89616874, 2, 640x360 
0x1382CA98, 37353945757180592, 89616904, 89616906, 2, 640x360 
0x1382CA98, 37353945757500768, 89616936, 89616938, 2, 640x360 
0x1382CA98, 37353945757980720, 89616983, 89616986, 3, 640x360 
0x1382CA98, 37353945758304304, 89617016, 89617019, 3, 640x360 
0x1382CA98, 37353945758616304, 89617047, 89617050, 3, 640x360 
0x1382CA98, 37353945758936608, 89617076, 89617082, 6, 640x360 
0x1382CA98, 37353945759256664, 89617107, 89617111, 4, 640x360 
0x1382CA98, 37353945759605040, 89617146, 89617152, 6, 640x360 
0x1382CA98, 37353945759909784, 89617176, 89617185, 9, 640x360 
0x1382CA98, 37353945760226384, 89617208, 89617210, 2, 640x360 
0x1382CA98, 37353945760549296, 89617240, 89617242, 2, 640x360 
0x1382CA98, 37353945760856912, 89617274, 89617279, 5, 640x360 
0x1382CA98, 37353945761179648, 89617301, 89617304, 3, 640x360 
0x1382CA98, 37353945761500024, 89617335, 89617338, 3, 640x360 
0x1382CA98, 37353945761975968, 89617384, 89617392, 8, 640x360 
0x1382CA98, 37353945762305288, 89617444, 89617453, 9, 640x360 
0x1382CA98, 37353945762647776, 89617463, 89617466, 3, 640x360 
0x1382CA98, 37353945762947304, 89617486, 89617489, 3, 640x360 
0x1382CA98, 37353945763270696, 89617520, 89617522, 2, 640x360 
0x1382CA98, 37353945763613040, 89617553, 89617557, 4, 640x360 
0x1382CA98, 37353945763898296, 89617585, 89617589, 4, 640x360 
0x1382CA98, 37353945764215864, 89617617, 89617620, 3, 640x360 
0x1382CA98, 37353945764541552, 89617670, 89617678, 8, 640x360 
0x1382CA98, 37353945764859272, 89617678, 89617689, 11, 640x360 
0x1382CA98, 37353945765180968, 89617724, 89617737, 13, 640x360 
0x1382CA98, 37353945765509112, 89617761, 89617772, 11, 640x360 
0x1382CA98, 37353945766040560, 89617821, 89617824, 3, 640x360 
0x1382CA98, 37353945766305424, 89617842, 89617846, 4, 640x360 
0x1382CA98, 37353945766655408, 89617864, 89617870, 6, 640x360 
0x1382CA98, 37353945766966144, 89617890, 89617895, 5, 640x360 
0x1382CA98, 37353945767274496, 89617917, 89617924, 7, 640x360 
0x1382CA98, 37353945767613728, 89617956, 89617962, 6, 640x360 
0x1382CA98, 37353945767897864, 89617987, 89617991, 4, 640x360 
0x1382CA98, 37353945768219664, 89618031, 89618036, 5, 640x360 
0x1382CA98, 37353945768551256, 89618049, 89618053, 4, 640x360 
0x1382CA98, 37353945768864408, 89618077, 89618098, 21, 640x360 
0x1382CA98, 37353945769181288, 89618118, 89618120, 2, 640x360 
0x1382CA98, 37353945769496008, 89618144, 89618149, 5, 640x360 
0x1382CA98, 37353945769981344, 89618186, 89618189, 3, 640x360 
0x1382CA98, 37353945770295320, 89618210, 89618216, 6, 640x360 
0x1382CA98, 37353945770615136, 89618242, 89618244, 2, 640x360 
0x1382CA98, 37353945770937608, 89618284, 89618291, 7, 640x360 
0x1382CA98, 37353945771262928, 89618308, 89618313, 5, 640x360 
0x1382CA98, 37353945771582960, 89618346, 89618353, 7, 640x360 
0x1382CA98, 37353945771900296, 89618377, 89618389, 12, 640x360 
0x1382CA98, 37353945772216064, 89618404, 89618406, 2, 640x360 
0x1382CA98, 37353945772535608, 89618437, 89618439, 2, 640x360 
0x1382CA98, 37353945772855640, 89618475, 89618478, 3, 640x360 
0x1382CA98, 37353945773180552, 89618502, 89618505, 3, 640x360 
0x1382CA98, 37353945773502192, 89618536, 89618542, 6, 640x360 
0x1382CA98, 37353945773976000, 89618582, 89618589, 7, 640x360 
0x1382CA98, 37353945774296120, 89618625, 89618628, 3, 640x360 
0x1382CA98, 37353945774616496, 89618653, 89618655, 2, 640x360 
0x1382CA98, 37353945774935800, 89618681, 89618685, 4, 640x360 
0x1382CA98, 37353945775256232, 89618708, 89618716, 8, 640x360 
0x1382CA98, 37353945775576400, 89618750, 89618757, 7, 640x360 
0x1382CA98, 37353945775898960, 89618787, 89618796, 9, 640x360 
0x1382CA98, 37353945776219064, 89618808, 89618811, 3, 640x360 
0x1382CA98, 37353945776536120, 89618848, 89618851, 3, 640x360 
0x1382CA98, 37353945776858936, 89618869, 89618877, 8, 640x360 
0x1382CA98, 37353945777184784, 89618904, 89618907, 3, 640x360 
0x1382CA98, 37353945777501296, 89618935, 89618938, 3, 640x360 
0x1382CA98, 37353945777981488, 89618984, 89618987, 3, 640x360 
0x1382CA98, 37353945778302896, 89619019, 89619022, 3, 640x360 
0x1382CA98, 37353945778658864, 89619058, 89619061, 3, 640x360 
0x1382CA98, 37353945778963584, 89619086, 89619088, 2, 640x360 
0x1382CA98, 37353945779271872, 89619120, 89619122, 2, 640x360 
0x1382CA98, 37353945779588904, 89619154, 89619156, 2, 640x360 
0x1382CA98, 37353945779896136, 89619181, 89619190, 9, 640x360 
0x1382CA98, 37353945780216200, 89619216, 89619220, 4, 640x360 
0x1382CA98, 37353945780542944, 89619242, 89619244, 2, 640x360 
0x1382CA98, 37353945780859240, 89619270, 89619273, 3, 640x360 
0x1382CA98, 37353945781175928, 89619313, 89619324, 11, 640x360 
0x1382CA98, 37353945781503056, 89619345, 89619356, 11, 640x360 
0x1382CA98, 37353945781825176, 89619379, 89619391, 12, 640x360 
0x1382CA98, 37353945782295440, 89619414, 89619422, 8, 640x360 
0x1382CA98, 37353945782615400, 89619449, 89619455, 6, 640x360 
0x1382CA98, 37353945782939104, 89619484, 89619492, 8, 640x360 
0x1382CA98, 37353945783259120, 89619516, 89619525, 9, 640x360 
0x1382CA98, 37353945783606016, 89619542, 89619544, 2, 640x360 
0x1382CA98, 37353945783895968, 89619575, 89619577, 2, 640x360 
0x1382CA98, 37353945784219776, 89619609, 89619612, 3, 640x360 
0x1382CA98, 37353945784535280, 89619641, 89619643, 2, 640x360 
0x1382CA98, 37353945784855104, 89619669, 89619671, 2, 640x360 
0x1382CA98, 37353945785176144, 89619704, 89619706, 2, 640x360 
0x1382CA98, 37353945785496024, 89619738, 89619740, 2, 640x360 
0x1382CA98, 37353945785816272, 89619762, 89619767, 5, 640x360 
0x1382CA98, 37353945786295688, 89619820, 89619823, 3, 640x360 
0x1382CA98, 37353945786615616, 89619848, 89619853, 5, 640x360 
0x1382CA98, 37353945786981024, 89619887, 89619901, 14, 640x360 
0x1382CA98, 37353945787273184, 89619908, 89619912, 4, 640x360 
0x1382CA98, 37353945787578408, 89619942, 89619945, 3, 640x360 
0x1382CA98, 37353945787899968, 89619984, 89619986, 2, 640x360 
0x1382CA98, 37353945788218576, 89620022, 89620023, 1, 640x360 
0x1382CA98, 37353945788538768, 89620038, 89620041, 3, 640x360 
0x1382CA98, 37353945788855656, 89620078, 89620083, 5, 640x360 
0x1382CA98, 37353945789187768, 89620105, 89620107, 2, 640x360 
0x1382CA98, 37353945789504080, 89620137, 89620140, 3, 640x360 
0x1382CA98, 37353945789832888, 89620173, 89620175, 2, 640x360 
0x1382CA98, 37353945790299024, 89620212, 89620222, 10, 640x360 
0x1382CA98, 37353945790616048, 89620245, 89620254, 9, 640x360 
0x1382CA98, 37353945790938680, 89620277, 89620281, 4, 640x360 
0x1382CA98, 37353945791261152, 89620308, 89620320, 12, 640x360 
0x1382CA98, 37353945791579880, 89620347, 89620355, 8, 640x360 
0x1382CA98, 37353945791895968, 89620383, 89620390, 7, 640x360 
0x1382CA98, 37353945792216592, 89620418, 89620425, 7, 640x360 
0x1382CA98, 37353945792536152, 89620442, 89620452, 10, 640x360 
0x1382CA98, 37353945792855072, 89620471, 89620479, 8, 640x360 
0x1382CA98, 37353945793185264, 89620503, 89620505, 2, 640x360 
0x1382CA98, 37353945793496376, 89620536, 89620546, 10, 640x360 
0x1382CA98, 37353945793822792, 89620575, 89620581, 6, 640x360 
0x1382CA98, 37353945794298872, 89620623, 89620625, 2, 640x360 
0x1382CA98, 37353945794623072, 89620650, 89620653, 3, 640x360 
0x1382CA98, 37353945794935872, 89620677, 89620680, 3, 640x360 
0x1382CA98, 37353945795261368, 89620709, 89620712, 3, 640x360 
0x1382CA98, 37353945795589696, 89620741, 89620744, 3, 640x360 
0x1382CA98, 37353945795896032, 89620774, 89620777, 3, 640x360 
0x1382CA98, 37353945796218936, 89620808, 89620810, 2, 640x360 
0x1382CA98, 37353945796535368, 89620845, 89620849, 4, 640x360 
0x1382CA98, 37353945796855136, 89620870, 89620876, 6, 640x360 
0x1382CA98, 37353945797181704, 89620909, 89620911, 2, 640x360 
0x1382CA98, 37353945797494952, 89620937, 89620943, 6, 640x360 
0x1382CA98, 37353945797820040, 89620964, 89620967, 3, 640x360 
0x1382CA98, 37353945798306488, 89621022, 89621030, 8, 640x360 
0x1382CA98, 37353945798635288, 89621051, 89621053, 2, 640x360 
0x1382CA98, 37353945798935608, 89621085, 89621087, 2, 640x360 
0x1382CA98, 37353945799262608, 89621133, 89621137, 4, 640x360 
0x1382CA98, 37353945799594896, 89621168, 89621172, 4, 640x360 
0x1382CA98, 37353945799925936, 89621201, 89621209, 8, 640x360 
0x1382CA98, 37353945800239544, 89621224, 89621240, 16, 640x360 
0x1382CA98, 37353945800537352, 89621249, 89621258, 9, 640x360 
0x1382CA98, 37353945800855184, 89621282, 89621284, 2, 640x360 
0x1382CA98, 37353945801178920, 89621321, 89621324, 3, 640x360 
0x1382CA98, 37353945801534200, 89621366, 89621369, 3, 640x360 
0x1382CA98, 37353945801837072, 89621372, 89621375, 3, 640x360 
0x1382CA98, 37353945802294408, 89621427, 89621433, 6, 640x360 
0x1382CA98, 37353945802628456, 89621459, 89621462, 3, 640x360 
0x1382CA98, 37353945802939384, 89621486, 89621496, 10, 640x360 
0x1382CA98, 37353945803273024, 89621523, 89621525, 2, 640x360 
0x1382CA98, 37353945803642000, 89621556, 89621559, 3, 640x360 
0x1382CA98, 37353945803896504, 89621600, 89621604, 4, 640x360 
0x1382CA98, 37353945804215280, 89621617, 89621622, 5, 640x360 
0x1382CA98, 37353945804536688, 89621647, 89621658, 11, 640x360 
0x1382CA98, 37353945804863912, 89621670, 89621674, 4, 640x360 
0x1382CA98, 37353945805174576, 89621709, 89621712, 3, 640x360 
0x1382CA98, 37353945805516424, 89621738, 89621741, 3, 640x360 
0x1382CA98, 37353945805841208, 89621770, 89621772, 2, 640x360 
0x1382CA98, 37353945806294296, 89621814, 89621824, 10, 640x360 
0x1382CA98, 37353945806614536, 89621843, 89621846, 3, 640x360 
0x1382CA98, 37353945806937944, 89621876, 89621881, 5, 640x360 
0x1382CA98, 37353945807260824, 89621908, 89621914, 6, 640x360 
0x1382CA98, 37353945807580432, 89621948, 89621956, 8, 640x360 
0x1382CA98, 37353945807895704, 89621982, 89621990, 8, 640x360 
0x1382CA98, 37353945808214536, 89622016, 89622018, 2, 640x360 
0x1382CA98, 37353945808545248, 89622049, 89622051, 2, 640x360 
0x1382CA98, 37353945808854984, 89622073, 89622075, 2, 640x360 
0x1382CA98, 37353945809175392, 89622108, 89622110, 2, 640x360 
0x1382CA98, 37353945809494936, 89622138, 89622141, 3, 640x360 
0x1382CA98, 37353945809818440, 89622175, 89622177, 2, 640x360 
0x1382CA98, 37353945810145952, 89622205, 89622206, 1, 640x360 
0x1382CA98, 37353945810614168, 89622251, 89622258, 7, 640x360 
0x1382CA98, 37353945810940112, 89622276, 89622279, 3, 640x360 
0x1382CA98, 37353945811266800, 89622307, 89622309, 2, 640x360 
0x1382CA98, 37353945811617016, 89622349, 89622351, 2, 640x360 
0x1382CA98, 37353945811895224, 89622381, 89622384, 3, 640x360 
0x1382CA98, 37353945812214808, 89622417, 89622423, 6, 640x360 
0x1382CA98, 37353945812539000, 89622439, 89622444, 5, 640x360 
0x1382CA98, 37353945812855056, 89622469, 89622471, 2, 640x360 
0x1382CA98, 37353945813180344, 89622517, 89622519, 2, 640x360 
0x1382CA98, 37353945813494864, 89622549, 89622552, 3, 640x360 
0x1382CA98, 37353945813820192, 89622570, 89622573, 3, 640x360 
0x1382CA98, 37353945814138632, 89622604, 89622612, 8, 640x360 
0x1382CA98, 37353945814616224, 89622648, 89622653, 5, 640x360 
0x1382CA98, 37353945814943120, 89622682, 89622689, 7, 640x360 
0x1382CA98, 37353945815261232, 89622715, 89622717, 2, 640x360 
0x1382CA98, 37353945815585752, 89622744, 89622747, 3, 640x360 
0x1382CA98, 37353945815899912, 89622781, 89622784, 3, 640x360 
0x1382CA98, 37353945816214856, 89622807, 89622813, 6, 640x360 
0x1382CA98, 37353945816542368, 89622838, 89622841, 3, 640x360 
0x1382CA98, 37353945816854960, 89622871, 89622875, 4, 640x360 
0x1382CA98, 37353945817181752, 89622918, 89622921, 3, 640x360 
0x1382CA98, 37353945817495848, 89622940, 89622942, 2, 640x360 
0x1382CA98, 37353945817818520, 89622976, 89622980, 4, 640x360 
0x1382CA98, 37353945818143024, 89623001, 89623008, 7, 640x360 
0x1382CA98, 37353945818615976, 89623043, 89623046, 3, 640x360 
0x1382CA98, 37353945818940640, 89623082, 89623089, 7, 640x360 
0x1382CA98, 37353945819265592, 89623116, 89623119, 3, 640x360 
0x1382CA98, 37353945819596512, 89623153, 89623155, 2, 640x360 
0x1382CA98, 37353945819894472, 89623173, 89623176, 3, 640x360 
0x1382CA98, 37353945820214088, 89623207, 89623210, 3, 640x360 
0x1382CA98, 37353945820537568, 89623244, 89623249, 5, 640x360 
0x1382CA98, 37353945820863928, 89623274, 89623277, 3, 640x360 
0x1382CA98, 37353945821176520, 89623302, 89623309, 7, 640x360 
0x1382CA98, 37353945821504552, 89623340, 89623342, 2, 640x360 
0x1382CA98, 37353945821841544, 89623368, 89623376, 8, 640x360 
0x1382CA98, 37353945822135920, 89623407, 89623409, 2, 640x360 
0x1382CA98, 37353945822619160, 89623458, 89623460, 2, 640x360 
0x1382CA98, 37353945822939072, 89623480, 89623484, 4, 640x360 
0x1382CA98, 37353945823266664, 89623515, 89623518, 3, 640x360 
0x1382CA98, 37353945823575560, 89623541, 89623543, 2, 640x360 
0x1382CA98, 37353945823898760, 89623582, 89623585, 3, 640x360 
0x1382CA98, 37353945824222096, 89623609, 89623611, 2, 640x360 
0x1382CA98, 37353945824534296, 89623636, 89623638, 2, 640x360 
0x1382CA98, 37353945824854296, 89623675, 89623677, 2, 640x360 
0x1382CA98, 37353945825186400, 89623708, 89623712, 4, 640x360 
0x1382CA98, 37353945825495568, 89623734, 89623745, 11, 640x360 
0x1382CA98, 37353945825819176, 89623771, 89623773, 2, 640x360 
0x1382CA98, 37353945826135232, 89623804, 89623806, 2, 640x360 
0x1382CA98, 37353945826615992, 89623844, 89623851, 7, 640x360 
0x1382CA98, 37353945826934456, 89623875, 89623878, 3, 640x360 
0x1382CA98, 37353945827259576, 89623917, 89623921, 4, 640x360 
0x1382CA98, 37353945827575152, 89623940, 89623942, 2, 640x360 
0x1382CA98, 37353945827894832, 89623978, 89623982, 4, 640x360 
0x1382CA98, 37353945828222256, 89624005, 89624008, 3, 640x360 
0x1382CA98, 37353945828536800, 89624036, 89624039, 3, 640x360 
0x1382CA98, 37353945828855208, 89624068, 89624074, 6, 640x360 
0x1382CA98, 37353945829175032, 89624102, 89624108, 6, 640x360 
0x1382CA98, 37353945829495032, 89624133, 89624137, 4, 640x360 
0x1382CA98, 37353945829816120, 89624164, 89624167, 3, 640x360 
0x1382CA98, 37353945830139024, 89624195, 89624212, 17, 640x360 
0x1382CA98, 37353945830613720, 89624252, 89624254, 2, 640x360 
0x1382CA98, 37353945830934240, 89624281, 89624286, 5, 640x360 
0x1382CA98, 37353945831254776, 89624306, 89624309, 3, 640x360 
0x1382CA98, 37353945831574424, 89624339, 89624343, 4, 640x360 
0x1382CA98, 37353945831895336, 89624375, 89624377, 2, 640x360 
0x1382CA98, 37353945832218392, 89624407, 89624410, 3, 640x360 
0x1382CA98, 37353945832538120, 89624438, 89624440, 2, 640x360 
0x1382CA98, 37353945832859992, 89624484, 89624486, 2, 640x360 
0x1382CA98, 37353945833174888, 89624502, 89624504, 2, 640x360 
0x1382CA98, 37353945833495136, 89624538, 89624540, 2, 640x360 
0x1382CA98, 37353945833814480, 89624570, 89624572, 2, 640x360 
0x1382CA98, 37353945834134360, 89624602, 89624604, 2, 640x360 
0x1382CA98, 37353945834618848, 89624641, 89624643, 2, 640x360 
0x1382CA98, 37353945834934520, 89624675, 89624678, 3, 640x360 
0x1382CA98, 37353945835261688, 89624708, 89624712, 4, 640x360 
0x1382CA98, 37353945835578520, 89624739, 89624742, 3, 640x360 
0x1382CA98, 37353945835894600, 89624775, 89624777, 2, 640x360 
0x1382CA98, 37353945836214352, 89624806, 89624809, 3, 640x360 
0x1382CA98, 37353945836534472, 89624839, 89624841, 2, 640x360 
0x1382CA98, 37353945836854376, 89624866, 89624874, 8, 640x360 
0x1382CA98, 37353945837174784, 89624901, 89624908, 7, 640x360 
0x1382CA98, 37353945837496112, 89624936, 89624939, 3, 640x360 
0x1382CA98, 37353945837814792, 89624969, 89624975, 6, 640x360 
0x1382CA98, 37353945838135760, 89625001, 89625003, 2, 640x360 
0x1382CA98, 37353945838933832, 89625078, 89625083, 5, 640x360 
0x1382CA98, 37353945839253752, 89625111, 89625116, 5, 640x360 
0x1382CA98, 37353945839576736, 89625143, 89625145, 2, 640x360 
0x1382CA98, 37353945839894792, 89625174, 89625177, 3, 640x360 
0x1382CA98, 37353945840219416, 89625205, 89625208, 3, 640x360 
0x1382CA98, 37353945840539744, 89625238, 89625240, 2, 640x360 
0x1382CA98, 37353945840854680, 89625269, 89625273, 4, 640x360 
0x1382CA98, 37353945841177928, 89625303, 89625306, 3, 640x360 
0x1382CA98, 37353945841497056, 89625339, 89625341, 2, 640x360 
0x1382CA98, 37353945841814752, 89625365, 89625368, 3, 640x360 
0x1382CA98, 37353945842135152, 89625397, 89625402, 5, 640x360 
0x1382CA98, 37353945842454976, 89625428, 89625433, 5, 640x360 
0x1382CA98, 37353945842938840, 89625484, 89625487, 3, 640x360 
0x1382CA98, 37353945843254296, 89625514, 89625516, 2, 640x360 
0x1382CA98, 37353945843573608, 89625541, 89625544, 3, 640x360 
0x1382CA98, 37353945843897880, 89625573, 89625575, 2, 640x360 
0x1382CA98, 37353945844215072, 89625609, 89625612, 3, 640x360 
0x1382CA98, 37353945844544072, 89625641, 89625642, 1, 640x360 
0x1382CA98, 37353945844881064, 89625670, 89625674, 4, 640x360 
0x1382CA98, 37353945845178032, 89625712, 89625723, 11, 640x360 
0x1382CA98, 37353945845497448, 89625737, 89625743, 6, 640x360 
0x1382CA98, 37353945845819656, 89625768, 89625777, 9, 640x360 
0x1382CA98, 37353945846133640, 89625796, 89625799, 3, 640x360 
0x1382CA98, 37353945846453808, 89625825, 89625828, 3, 640x360 
0x1382CA98, 37353945846933640, 89625877, 89625885, 8, 640x360 
0x1382CA98, 37353945847254224, 89625906, 89625908, 2, 640x360 
0x1382CA98, 37353945847594056, 89625945, 89625956, 11, 640x360 
0x1382CA98, 37353945847937544, 89625986, 89625988, 2, 640x360 
0x1382CA98, 37353945848225208, 89626009, 89626013, 4, 640x360 
0x1382CA98, 37353945848536088, 89626041, 89626042, 1, 640x360 
0x1382CA98, 37353945848855552, 89626070, 89626082, 12, 640x360 
0x1382CA98, 37353945849177096, 89626106, 89626108, 2, 640x360 
0x1382CA98, 37353945849498864, 89626149, 89626152, 3, 640x360 
0x1382CA98, 37353945849814456, 89626177, 89626183, 6, 640x360 
0x1382CA98, 37353945850133808, 89626201, 89626203, 2, 640x360 
0x1382CA98, 37353945850456736, 89626228, 89626239, 11, 640x360 
0x1382CA98, 37353945850935128, 89626284, 89626291, 7, 640x360 
0x1382CA98, 37353945851258152, 89626308, 89626316, 8, 640x360 
0x1382CA98, 37353945851577912, 89626341, 89626345, 4, 640x360 
0x1382CA98, 37353945851894576, 89626375, 89626377, 2, 640x360 
0x1382CA98, 37353945852213368, 89626410, 89626418, 8, 640x360 
0x1382CA98, 37353945852548944, 89626452, 89626454, 2, 640x360 
0x1382CA98, 37353945852854736, 89626470, 89626473, 3, 640x360 
0x1382CA98, 37353945853174064, 89626504, 89626506, 2, 640x360 
0x1382CA98, 37353945853494160, 89626539, 89626540, 1, 640x360 
0x1382CA98, 37353945853830992, 89626573, 89626575, 2, 640x360 
0x1382CA98, 37353945854137104, 89626607, 89626609, 2, 640x360 
0x1382CA98, 37353945854455616, 89626642, 89626645, 3, 640x360 
0x1382CA98, 37353945854933160, 89626685, 89626688, 3, 640x360 
0x1382CA98, 37353945855253512, 89626717, 89626719, 2, 640x360 
0x1382CA98, 37353945855586808, 89626743, 89626745, 2, 640x360 
0x1382CA98, 37353945855894120, 89626771, 89626773, 2, 640x360 
0x1382CA98, 37353945856213464, 89626804, 89626806, 2, 640x360 
0x1382CA98, 37353945856533552, 89626841, 89626843, 2, 640x360 
0x1382CA98, 37353945856853696, 89626870, 89626876, 6, 640x360 
0x1382CA98, 37353945857177144, 89626905, 89626906, 1, 640x360 
0x1382CA98, 37353945857494736, 89626937, 89626939, 2, 640x360 
0x1382CA98, 37353945857821984, 89626979, 89626992, 13, 640x360 
0x1382CA98, 37353945858134112, 89627010, 89627013, 3, 640x360 
0x1382CA98, 37353945858459000, 89627045, 89627049, 4, 640x360 
0x1382CA98, 37353945858933464, 89627077, 89627084, 7, 640x360 
0x1382CA98, 37353945859258864, 89627118, 89627120, 2, 640x360 
0x1382CA98, 37353945859586336, 89627158, 89627165, 7, 640x360 
0x1382CA98, 37353945859901224, 89627176, 89627182, 6, 640x360 
0x1382CA98, 37353945860213680, 89627216, 89627225, 9, 640x360 
0x1382CA98, 37353945860539752, 89627252, 89627255, 3, 640x360 
0x1382CA98, 37353945860853424, 89627280, 89627283, 3, 640x360 
0x1382CA98, 37353945861173432, 89627314, 89627317, 3, 640x360 
0x1382CA98, 37353945861496992, 89627338, 89627340, 2, 640x360 
0x1382CA98, 37353945861816272, 89627381, 89627390, 9, 640x360 
0x1382CA98, 37353945862134048, 89627405, 89627407, 2, 640x360 
0x1382CA98, 37353945862455520, 89627432, 89627442, 10, 640x360 
0x1382CA98, 37353945862932728, 89627485, 89627488, 3, 640x360 
0x1382CA98, 37353945863252824, 89627508, 89627510, 2, 640x360 
0x1382CA98, 37353945863587160, 89627541, 89627543, 2, 640x360 
0x1382CA98, 37353945863893240, 89627572, 89627575, 3, 640x360 
0x1382CA98, 37353945864213544, 89627603, 89627606, 3, 640x360 
0x1382CA98, 37353945864533688, 89627638, 89627647, 9, 640x360 
0x1382CA98, 37353945864854408, 89627669, 89627675, 6, 640x360 
0x1382CA98, 37353945865180040, 89627717, 89627720, 3, 640x360 
0x1382CA98, 37353945865495872, 89627740, 89627742, 2, 640x360 
0x1382CA98, 37353945865813624, 89627771, 89627780, 9, 640x360 
0x1382CA98, 37353945866134248, 89627805, 89627807, 2, 640x360 
0x1382CA98, 37353945866458112, 89627839, 89627842, 3, 640x360 
0x1382CA98, 37353945866779136, 89627876, 89627879, 3, 640x360 
0x1382CA98, 37353945867267592, 89627913, 89627917, 4, 640x360 
0x1382CA98, 37353945867578112, 89627942, 89627945, 3, 640x360 
0x1382CA98, 37353945867904416, 89627971, 89627973, 2, 640x360 
0x1382CA98, 37353945868216912, 89628007, 89628009, 2, 640x360 
0x1382CA98, 37353945868533080, 89628047, 89628058, 11, 640x360 
0x1382CA98, 37353945868865968, 89628074, 89628077, 3, 640x360 
0x1382CA98, 37353945869182744, 89628106, 89628107, 1, 640x360 
0x1382CA98, 37353945869498608, 89628138, 89628141, 3, 640x360 
0x1382CA98, 37353945869813176, 89628176, 89628179, 3, 640x360 
0x1382CA98, 37353945870133272, 89628209, 89628213, 4, 640x360 
0x1382CA98, 37353945870454200, 89628242, 89628244, 2, 640x360 
0x1382CA98, 37353945870778096, 89628272, 89628274, 2, 640x360 
0x1382CA98, 37353945871266664, 89628308, 89628311, 3, 640x360 
0x1382CA98, 37353945871576176, 89628347, 89628355, 8, 640x360 
0x1382CA98, 37353945871896568, 89628385, 89628387, 2, 640x360 
0x1382CA98, 37353945872217504, 89628411, 89628416, 5, 640x360 
0x1382CA98, 37353945872532648, 89628445, 89628455, 10, 640x360 
0x1382CA98, 37353945872858992, 89628477, 89628482, 5, 640x360 
0x1382CA98, 37353945873206648, 89628505, 89628507, 2, 640x360 
0x1382CA98, 37353945873500320, 89628538, 89628541, 3, 640x360 
0x1382CA98, 37353945873825936, 89628571, 89628578, 7, 640x360 
0x1382CA98, 37353945874133296, 89628604, 89628610, 6, 640x360 
0x1382CA98, 37353945874455288, 89628636, 89628637, 1, 640x360 
0x1382CA98, 37353945874778528, 89628668, 89628672, 4, 640x360 
0x1382CA98, 37353945875265600, 89628716, 89628719, 3, 640x360 
0x1382CA98, 37353945875578152, 89628741, 89628743, 2, 640x360 
0x1382CA98, 37353945875893248, 89628783, 89628792, 9, 640x360 
0x1382CA98, 37353945876213496, 89628819, 89628829, 10, 640x360 
0x1382CA98, 37353945876547256, 89628843, 89628845, 2, 640x360 
0x1382CA98, 37353945876853608, 89628871, 89628873, 2, 640x360 
0x1382CA98, 37353945877173144, 89628910, 89628915, 5, 640x360 
0x1382CA98, 37353945877496400, 89628940, 89628943, 3, 640x360 
0x1382CA98, 37353945877854504, 89628971, 89628974, 3, 640x360 
0x1382CA98, 37353945878153056, 89629003, 89629006, 3, 640x360 
0x1382CA98, 37353945878495824, 89629037, 89629039, 2, 640x360 
0x1382CA98, 37353945878779656, 89629071, 89629074, 3, 640x360 
0x1382CA98, 37353945879266576, 89629116, 89629118, 2, 640x360 
0x1382CA98, 37353945879576312, 89629152, 89629155, 3, 640x360 
0x1382CA98, 37353945879892856, 89629181, 89629184, 3, 640x360 
0x1382CA98, 37353945880217648, 89629213, 89629217, 4, 640x360 
0x1382CA98, 37353945880536592, 89629241, 89629243, 2, 640x360 
0x1382CA98, 37353945880854304, 89629269, 89629277, 8, 640x360 
0x1382CA98, 37353945881175936, 89629306, 89629308, 2, 640x360 
0x1382CA98, 37353945881503632, 89629336, 89629339, 3, 640x360 
0x1382CA98, 37353945881821280, 89629371, 89629378, 7, 640x360 
0x1382CA98, 37353945882137336, 89629400, 89629409, 9, 640x360 
0x1382CA98, 37353945882454048, 89629435, 89629437, 2, 640x360 
0x1382CA98, 37353945882773952, 89629461, 89629474, 13, 640x360 
0x1382CA98, 37353945883252512, 89629510, 89629516, 6, 640x360 
0x1382CA98, 37353945883572608, 89629546, 89629550, 4, 640x360 
0x1382CA98, 37353945883903552, 89629574, 89629577, 3, 640x360 
0x1382CA98, 37353945884215688, 89629612, 89629616, 4, 640x360 
0x1382CA98, 37353945884542632, 89629649, 89629655, 6, 640x360 
0x1382CA98, 37353945884852736, 89629680, 89629684, 4, 640x360 
0x1382CA98, 37353945885173016, 89629707, 89629711, 4, 640x360 
0x1382CA98, 37353945885498376, 89629740, 89629742, 2, 640x360 
0x1382CA98, 37353945885820584, 89629769, 89629772, 3, 640x360 
0x1382CA98, 37353945886134248, 89629804, 89629807, 3, 640x360 
0x1382CA98, 37353945886457136, 89629840, 89629842, 2, 640x360 
0x1382CA98, 37353945886772928, 89629870, 89629873, 3, 640x360 
0x1382CA98, 37353945887273896, 89629917, 89629924, 7, 640x360 
0x1382CA98, 37353945887597768, 89629950, 89629957, 7, 640x360 
0x1382CA98, 37353945887892336, 89629983, 89629986, 3, 640x360 
0x1382CA98, 37353945888228712, 89630016, 89630018, 2, 640x360 
0x1382CA98, 37353945888532392, 89630040, 89630042, 2, 640x360 
0x1382CA98, 37353945888852344, 89630069, 89630071, 2, 640x360 
0x1382CA98, 37353945889172360, 89630101, 89630110, 9, 640x360 
0x1382CA98, 37353945889496832, 89630136, 89630139, 3, 640x360 
0x1382CA98, 37353945889820112, 89630174, 89630177, 3, 640x360 
0x1382CA98, 37353945890132928, 89630205, 89630207, 2, 640x360 
0x1382CA98, 37353945890456408, 89630230, 89630240, 10, 640x360 
0x1382CA98, 37353945890773752, 89630269, 89630276, 7, 640x360 
0x1382CA98, 37353945891256032, 89630315, 89630317, 2, 640x360 
0x1382CA98, 37353945891577984, 89630341, 89630343, 2, 640x360 
0x1382CA98, 37353945891911496, 89630375, 89630376, 1, 640x360 
0x1382CA98, 37353945892212688, 89630414, 89630427, 13, 640x360 
0x1382CA98, 37353945892534208, 89630446, 89630455, 9, 640x360 
0x1382CA98, 37353945892852912, 89630477, 89630479, 2, 640x360 
0x1382CA98, 37353945893174832, 89630504, 89630506, 2, 640x360 
0x1382CA98, 37353945893498608, 89630537, 89630540, 3, 640x360 
0x1382CA98, 37353945893817496, 89630569, 89630571, 2, 640x360 
0x1382CA98, 37353945894132976, 89630601, 89630603, 2, 640x360 
0x1382CA98, 37353945894453584, 89630630, 89630635, 5, 640x360 
0x1382CA98, 37353945894777200, 89630664, 89630672, 8, 640x360 
0x1382CA98, 37353945895102616, 89630699, 89630706, 7, 640x360 
0x1382CA98, 37353945895573664, 89630745, 89630751, 6, 640x360 
0x1382CA98, 37353945895898072, 89630774, 89630776, 2, 640x360 
0x1382CA98, 37353945896240832, 89630809, 89630811, 2, 640x360 
0x1382CA98, 37353945896541176, 89630845, 89630849, 4, 640x360 
0x1382CA98, 37353945896853912, 89630874, 89630876, 2, 640x360 
0x1382CA98, 37353945897172768, 89630901, 89630905, 4, 640x360 
0x1382CA98, 37353945897495920, 89630937, 89630941, 4, 640x360 
0x1382CA98, 37353945897823096, 89630970, 89630972, 2, 640x360 
0x1382CA98, 37353945898137504, 89631005, 89631007, 2, 640x360 
0x1382CA98, 37353945898454768, 89631028, 89631042, 14, 640x360 
0x1382CA98, 37353945898772968, 89631063, 89631074, 11, 640x360 
0x1382CA98, 37353945899100104, 89631091, 89631095, 4, 640x360 
0x1382CA98, 37353945899581984, 89631145, 89631149, 4, 640x360 
0x1382CA98, 37353945899937488, 89631184, 89631186, 2, 640x360 
0x1382CA98, 37353945900216792, 89631215, 89631218, 3, 640x360 
0x1382CA98, 37353945900541888, 89631241, 89631246, 5, 640x360 
0x1382CA98, 37353945900852024, 89631268, 89631271, 3, 640x360 
0x1382CA98, 37353945901172000, 89631310, 89631313, 3, 640x360 
0x1382CA98, 37353945901502112, 89631345, 89631356, 11, 640x360 
0x1382CA98, 37353945901817256, 89631370, 89631372, 2, 640x360 
0x1382CA98, 37353945902135400, 89631395, 89631402, 7, 640x360 
0x1382CA98, 37353945902456192, 89631427, 89631433, 6, 640x360 
0x1382CA98, 37353945902773824, 89631465, 89631472, 7, 640x360 
0x1382CA98, 37353945903104512, 89631495, 89631506, 11, 640x360 
0x1382CA98, 37353945903577216, 89631545, 89631553, 8, 640x360 
0x1382CA98, 37353945903898904, 89631579, 89631582, 3, 640x360 
0x1382CA98, 37353945904232888, 89631614, 89631622, 8, 640x360 
0x1382CA98, 37353945904541688, 89631651, 89631659, 8, 640x360 
0x1382CA98, 37353945904855184, 89631681, 89631699, 18, 640x360 
0x1382CA98, 37353945905186496, 89631710, 89631723, 13, 640x360 
0x1382CA98, 37353945905504048, 89631759, 89631766, 7, 640x360 
0x1382CA98, 37353945905821304, 89631775, 89631779, 4, 640x360 
0x1382CA98, 37353945906133680, 89631802, 89631805, 3, 640x360 
0x1382CA98, 37353945906454328, 89631835, 89631843, 8, 640x360 
0x1382CA98, 37353945906777296, 89631877, 89631892, 15, 640x360 
0x1382CA98, 37353945907112896, 89631909, 89631912, 3, 640x360 
0x1382CA98, 37353945907571792, 89631948, 89631957, 9, 640x360 
0x1382CA98, 37353945907896176, 89631986, 89631988, 2, 640x360 
0x1382CA98, 37353945908215216, 89632014, 89632022, 8, 640x360 
0x1382CA98, 37353945908532712, 89632064, 89632077, 13, 640x360 
0x1382CA98, 37353945908855984, 89632099, 89632102, 3, 640x360 
0x1382CA98, 37353945909179480, 89632133, 89632138, 5, 640x360 
0x1382CA98, 37353945909498064, 89632159, 89632166, 7, 640x360 
0x1382CA98, 37353945909859816, 89632194, 89632208, 14, 640x360 
0x1382CA98, 37353945910146624, 89632226, 89632233, 7, 640x360 
0x1382CA98, 37353945910474776, 89632246, 89632252, 6, 640x360 
0x1382CA98, 37353945910803224, 89632272, 89632276, 4, 640x360 
0x1382CA98, 37353945911117944, 89632303, 89632307, 4, 640x360 
0x1382CA98, 37353945911588696, 89632344, 89632352, 8, 640x360 
0x1382CA98, 37353945911910328, 89632381, 89632383, 2, 640x360 
0x1382CA98, 37353945912216504, 89632407, 89632410, 3, 640x360 
0x1382CA98, 37353945912533112, 89632438, 89632440, 2, 640x360 
0x1382CA98, 37353945912851792, 89632469, 89632471, 2, 640x360 
0x1382CA98, 37353945913172496, 89632503, 89632506, 3, 640x360 
0x1382CA98, 37353945913511312, 89632538, 89632541, 3, 640x360 
0x1382CA98, 37353945913825584, 89632576, 89632579, 3, 640x360 
0x1382CA98, 37353945914136560, 89632604, 89632609, 5, 640x360 
0x1382CA98, 37353945914464656, 89632643, 89632648, 5, 640x360 
0x1382CA98, 37353945914779400, 89632680, 89632700, 20, 640x360 
0x1382CA98, 37353945915163784, 89632721, 89632725, 4, 640x360 
0x1382CA98, 37353945915817296, 89632790, 89632840, 50, 640x360 
0x1382CA98, 37353945916179160, 89632842, 89632857, 15, 640x360 
0x1382CA98, 37353945916649120, 89632872, 89632874, 2, 640x360 
0x1382CA98, 37353945916876632, 89632889, 89632897, 8, 640x360 
0x1382CA98, 37353945917505808, 89632960, 89632965, 5, 640x360 
0x1382CA98, 37353945917817592, 89632986, 89632990, 4, 640x360 
0x1382CA98, 37353945918156640, 89633015, 89633024, 9, 640x360 
0x1382CA98, 37353945918510544, 89633049, 89633054, 5, 640x360 
0x1382CA98, 37353945918798288, 89633073, 89633082, 9, 640x360 
0x1382CA98, 37353945919104416, 89633099, 89633110, 11, 640x360 
0x1382CA98, 37353945919422976, 89633138, 89633141, 3, 640x360 
0x1382CA98, 37353945919891048, 89633201, 89633213, 12, 640x360 
0x1382CA98, 37353945920221064, 89633228, 89633238, 10, 640x360 
0x1382CA98, 37353945920547792, 89633250, 89633254, 4, 640x360 
0x1382CA98, 37353945920852256, 89633284, 89633289, 5, 640x360 
0x1382CA98, 37353945921177632, 89633311, 89633314, 3, 640x360 
0x1382CA98, 37353945921497704, 89633342, 89633346, 4, 640x360 
0x1382CA98, 37353945921820824, 89633378, 89633390, 12, 640x360 
0x1382CA98, 37353945922132432, 89633404, 89633407, 3, 640x360 
0x1382CA98, 37353945922451792, 89633425, 89633427, 2, 640x360 
0x1382CA98, 37353945922771800, 89633461, 89633463, 2, 640x360 
0x1382CA98, 37353945923092320, 89633493, 89633495, 2, 640x360 
0x1382CA98, 37353945923412488, 89633523, 89633526, 3, 640x360 
0x1382CA98, 37353945923892336, 89633585, 89633587, 2, 640x360 
0x1382CA98, 37353945924212408, 89633616, 89633619, 3, 640x360 
0x1382CA98, 37353945924532368, 89633638, 89633642, 4, 640x360 
0x1382CA98, 37353945924854704, 89633670, 89633673, 3, 640x360 
0x1382CA98, 37353945925175560, 89633701, 89633703, 2, 640x360 
0x1382CA98, 37353945925495280, 89633736, 89633738, 2, 640x360 
0x1382CA98, 37353945925811600, 89633768, 89633770, 2, 640x360 
0x1382CA98, 37353945926135824, 89633803, 89633805, 2, 640x360 
0x1382CA98, 37353945926451776, 89633828, 89633833, 5, 640x360 
0x1382CA98, 37353945926772128, 89633867, 89633870, 3, 640x360 
0x1382CA98, 37353945927091816, 89633900, 89633903, 3, 640x360 
0x1382CA98, 37353945927413368, 89633932, 89633934, 2, 640x360 
0x1382CA98, 37353945927891792, 89633981, 89633983, 2, 640x360 
0x1382CA98, 37353945928211640, 89634018, 89634020, 2, 640x360 
0x1382CA98, 37353945928535408, 89634048, 89634051, 3, 640x360 
0x1382CA98, 37353945928855088, 89634078, 89634083, 5, 640x360 
0x1382CA98, 37353945929173040, 89634115, 89634117, 2, 640x360 
0x1382CA98, 37353945929495672, 89634143, 89634153, 10, 640x360 
0x1382CA98, 37353945929816776, 89634177, 89634182, 5, 640x360 
0x1382CA98, 37353945930134688, 89634199, 89634202, 3, 640x360 
0x1382CA98, 37353945930451328, 89634227, 89634230, 3, 640x360 
0x1382CA98, 37353945930771392, 89634265, 89634268, 3, 640x360 
0x1382CA98, 37353945931091976, 89634295, 89634300, 5, 640x360 
0x1382CA98, 37353945931416736, 89634327, 89634331, 4, 640x360 
0x1382CA98, 37353945931892016, 89634374, 89634378, 4, 640x360 
0x1382CA98, 37353945932211784, 89634405, 89634408, 3, 640x360 
0x1382CA98, 37353945932536104, 89634441, 89634443, 2, 640x360 
0x1382CA98, 37353945932856008, 89634467, 89634473, 6, 640x360 
0x1382CA98, 37353945933175904, 89634500, 89634506, 6, 640x360 
0x1382CA98, 37353945933492008, 89634531, 89634533, 2, 640x360 
0x1382CA98, 37353945933811936, 89634568, 89634571, 3, 640x360 
0x1382CA98, 37353945934132480, 89634617, 89634622, 5, 640x360 
0x1382CA98, 37353945934456416, 89634637, 89634639, 2, 640x360 
0x1382CA98, 37353945934771368, 89634668, 89634671, 3, 640x360 
0x1382CA98, 37353945935096464, 89634693, 89634698, 5, 640x360 
0x1382CA98, 37353945935418120, 89634725, 89634729, 4, 640x360 
0x1382CA98, 37353945935890864, 89634777, 89634783, 6, 640x360 
0x1382CA98, 37353945936228720, 89634822, 89634833, 11, 640x360 
0x1382CA98, 37353945936533264, 89634861, 89634865, 4, 640x360 
0x1382CA98, 37353945936855272, 89634885, 89634887, 2, 640x360 
0x1382CA98, 37353945937170720, 89634904, 89634906, 2, 640x360 
0x1382CA98, 37353945937494384, 89634937, 89634940, 3, 640x360 
0x1382CA98, 37353945937811096, 89634962, 89634972, 10, 640x360 
0x1382CA98, 37353945938133768, 89635001, 89635003, 2, 640x360 
0x1382CA98, 37353945938460224, 89635030, 89635041, 11, 640x360 
0x1382CA98, 37353945938775152, 89635069, 89635076, 7, 640x360 
0x1382CA98, 37353945939115320, 89635105, 89635107, 2, 640x360 
0x1382CA98, 37353945939441248, 89635137, 89635143, 6, 640x360 
0x1382CA98, 37353945939890936, 89635182, 89635197, 15, 640x360 
0x1382CA98, 37353945940263288, 89635222, 89635230, 8, 640x360 
0x1382CA98, 37353945940540560, 89635245, 89635254, 9, 640x360 
0x1382CA98, 37353945940851976, 89635282, 89635285, 3, 640x360 
0x1382CA98, 37353945941193256, 89635320, 89635331, 11, 640x360 
0x1382CA98, 37353945941511088, 89635348, 89635352, 4, 640x360 
0x1382CA98, 37353945941813136, 89635378, 89635383, 5, 640x360 
0x1382CA98, 37353945942131728, 89635403, 89635413, 10, 640x360 
0x1382CA98, 37353945942453880, 89635438, 89635452, 14, 640x360 
0x1382CA98, 37353945942811536, 89635475, 89635479, 4, 640x360 
0x1382CA98, 37353945943096584, 89635500, 89635506, 6, 640x360 
0x1382CA98, 37353945943432384, 89635537, 89635547, 10, 640x360 
0x1382CA98, 37353945943896792, 89635574, 89635577, 3, 640x360 
0x1382CA98, 37353945944214472, 89635605, 89635608, 3, 640x360 
0x1382CA98, 37353945944534352, 89635636, 89635638, 2, 640x360 
0x1382CA98, 37353945944854624, 89635667, 89635669, 2, 640x360 
0x1382CA98, 37353945945174024, 89635703, 89635706, 3, 640x360 
0x1382CA98, 37353945945491360, 89635736, 89635742, 6, 640x360 
0x1382CA98, 37353945945812544, 89635769, 89635775, 6, 640x360 
0x1382CA98, 37353945946133152, 89635797, 89635801, 4, 640x360 
0x1382CA98, 37353945946451728, 89635833, 89635840, 7, 640x360 
0x1382CA98, 37353945946787912, 89635881, 89635884, 3, 640x360 
0x1382CA98, 37353945947107608, 89635902, 89635905, 3, 640x360 
0x1382CA98, 37353945947431688, 89635935, 89635937, 2, 640x360 
0x1382CA98, 37353945947735504, 89635971, 89635973, 2, 640x360 
0x1382CA98, 37353945948210664, 89636011, 89636016, 5, 640x360 
0x1382CA98, 37353945948530688, 89636039, 89636042, 3, 640x360 
0x1382CA98, 37353945948850536, 89636075, 89636077, 2, 640x360 
0x1382CA98, 37353945949175792, 89636111, 89636116, 5, 640x360 
0x1382CA98, 37353945949490696, 89636133, 89636143, 10, 640x360 
0x1382CA98, 37353945949814512, 89636169, 89636178, 9, 640x360 
0x1382CA98, 37353945950131480, 89636197, 89636200, 3, 640x360 
0x1382CA98, 37353945950450744, 89636231, 89636237, 6, 640x360 
0x1382CA98, 37353945950775088, 89636264, 89636267, 3, 640x360 
0x1382CA98, 37353945951091248, 89636293, 89636304, 11, 640x360 
0x1382CA98, 37353945951415760, 89636324, 89636326, 2, 640x360 
0x1382CA98, 37353945951732016, 89636356, 89636362, 6, 640x360 
0x1382CA98, 37353945952211256, 89636425, 89636428, 3, 640x360 
0x1382CA98, 37353945952531576, 89636439, 89636445, 6, 640x360 
0x1382CA98, 37353945952851408, 89636468, 89636471, 3, 640x360 
0x1382CA98, 37353945953177656, 89636501, 89636507, 6, 640x360 
0x1382CA98, 37353945953500232, 89636536, 89636538, 2, 640x360 
0x1382CA98, 37353945953814080, 89636565, 89636568, 3, 640x360 
0x1382CA98, 37353945954134400, 89636594, 89636597, 3, 640x360 
0x1382CA98, 37353945954453992, 89636627, 89636633, 6, 640x360 
0x1382CA98, 37353945954782008, 89636666, 89636670, 4, 640x360 
0x1382CA98, 37353945955092640, 89636702, 89636705, 3, 640x360 
0x1382CA98, 37353945955415616, 89636737, 89636739, 2, 640x360 
0x1382CA98, 37353945955731696, 89636768, 89636771, 3, 640x360 
0x1382CA98, 37353945956211144, 89636807, 89636810, 3, 640x360 
0x1382CA98, 37353945956535792, 89636849, 89636851, 2, 640x360 
0x1382CA98, 37353945956850680, 89636870, 89636876, 6, 640x360 
0x1382CA98, 37353945957170648, 89636906, 89636913, 7, 640x360 
0x1382CA98, 37353945957494752, 89636938, 89636940, 2, 640x360 
0x1382CA98, 37353945957811040, 89636971, 89636972, 1, 640x360 
0x1382CA98, 37353945958135016, 89637005, 89637007, 2, 640x360 
0x1382CA98, 37353945958451368, 89637032, 89637036, 4, 640x360 
0x1382CA98, 37353945958776104, 89637064, 89637072, 8, 640x360 
0x1382CA98, 37353945959101456, 89637095, 89637102, 7, 640x360 
0x1382CA98, 37353945959414216, 89637127, 89637130, 3, 640x360 
0x1382CA98, 37353945959740400, 89637160, 89637164, 4, 640x360 
0x1382CA98, 37353945960214408, 89637208, 89637212, 4, 640x360 
0x1382CA98, 37353945960530688, 89637250, 89637253, 3, 640x360 
0x1382CA98, 37353945960851616, 89637278, 89637283, 5, 640x360 
0x1382CA98, 37353945961170384, 89637305, 89637314, 9, 640x360 
0x1382CA98, 37353945961490968, 89637335, 89637337, 2, 640x360 
0x1382CA98, 37353945961819800, 89637376, 89637379, 3, 640x360 
0x1382CA98, 37353945962131568, 89637405, 89637407, 2, 640x360 
0x1382CA98, 37353945962451968, 89637429, 89637441, 12, 640x360 
0x1382CA98, 37353945962780168, 89637465, 89637473, 8, 640x360 
0x1382CA98, 37353945963097144, 89637500, 89637508, 8, 640x360 
0x1382CA98, 37353945963433608, 89637526, 89637528, 2, 640x360 
0x1382CA98, 37353945963730768, 89637556, 89637558, 2, 640x360 
0x1382CA98, 37353945964210024, 89637615, 89637623, 8, 640x360 
0x1382CA98, 37353945964530024, 89637650, 89637653, 3, 640x360 
0x1382CA98, 37353945964855352, 89637683, 89637686, 3, 640x360 
0x1382CA98, 37353945965174192, 89637711, 89637717, 6, 640x360 
0x1382CA98, 37353945965492472, 89637743, 89637748, 5, 640x360 
0x1382CA98, 37353945965822976, 89637773, 89637776, 3, 640x360 
0x1382CA98, 37353945966147600, 89637807, 89637810, 3, 640x360 
0x1382CA98, 37353945966451432, 89637837, 89637840, 3, 640x360 
0x1382CA98, 37353945966848016, 89637876, 89637893, 17, 640x360 
0x1382CA98, 37353945967120104, 89637909, 89637917, 8, 640x360 
0x1382CA98, 37353945967437944, 89637956, 89637980, 24, 640x360 
0x1382CA98, 37353945967753632, 89637988, 89637999, 11, 640x360 
0x1382CA98, 37353945968224328, 89638041, 89638052, 11, 640x360 
0x1382CA98, 37353945968538928, 89638078, 89638084, 6, 640x360 
0x1382CA98, 37353945968866256, 89638092, 89638100, 8, 640x360 
0x1382CA98, 37353945969176256, 89638118, 89638144, 26, 640x360 
0x1382CA98, 37353945969694880, 89638174, 89638188, 14, 640x360 
0x1382CA98, 37353945969936712, 89638206, 89638209, 3, 640x360 
0x1382CA98, 37353945970172784, 89638242, 89638251, 9, 640x360 
0x1382CA98, 37353945970529240, 89638260, 89638265, 5, 640x360 
0x1382CA98, 37353945970788072, 89638276, 89638286, 10, 640x360 
0x1382CA98, 37353945971106800, 89638317, 89638321, 4, 640x360 
0x1382CA98, 37353945971435184, 89638337, 89638353, 16, 640x360 
0x1382CA98, 37353945971737056, 89638367, 89638383, 16, 640x360 
0x1382CA98, 37353945972067024, 89638400, 89638403, 3, 640x360 
0x1382CA98, 37353945972529904, 89638444, 89638450, 6, 640x360 
0x1382CA98, 37353945972880640, 89638476, 89638481, 5, 640x360 
0x1382CA98, 37353945973192440, 89638504, 89638507, 3, 640x360 
0x1382CA98, 37353945973490200, 89638538, 89638540, 2, 640x360 
0x1382CA98, 37353945973818424, 89638570, 89638573, 3, 640x360 
0x1382CA98, 37353945974134480, 89638603, 89638605, 2, 640x360 
0x1382CA98, 37353945974451760, 89638631, 89638641, 10, 640x360 
0x1382CA98, 37353945974770928, 89638659, 89638667, 8, 640x360 
0x1382CA98, 37353945975099656, 89638696, 89638705, 9, 640x360 
0x1382CA98, 37353945975420368, 89638727, 89638732, 5, 640x360 
0x1382CA98, 37353945975736224, 89638760, 89638763, 3, 640x360 
0x1382CA98, 37353945976051208, 89638794, 89638801, 7, 640x360 
0x1382CA98, 37353945976529912, 89638851, 89638854, 3, 640x360 
0x1382CA98, 37353945976853256, 89638873, 89638879, 6, 640x360 
0x1382CA98, 37353945977169920, 89638906, 89638911, 5, 640x360 
0x1382CA98, 37353945977489792, 89638938, 89638945, 7, 640x360 
0x1382CA98, 37353945977810096, 89638971, 89638978, 7, 640x360 
0x1382CA98, 37353945978135784, 89639005, 89639007, 2, 640x360 
0x1382CA98, 37353945978450280, 89639032, 89639034, 2, 640x360 
0x1382CA98, 37353945978770344, 89639058, 89639061, 3, 640x360 
0x1382CA98, 37353945979096128, 89639093, 89639098, 5, 640x360 
0x1382CA98, 37353945979416048, 89639127, 89639129, 2, 640x360 
0x1382CA98, 37353945979734024, 89639160, 89639163, 3, 640x360 
0x1382CA98, 37353945980050360, 89639188, 89639190, 2, 640x360 
0x1382CA98, 37353945980531504, 89639244, 89639251, 7, 640x360 
0x1382CA98, 37353945980849728, 89639271, 89639281, 10, 640x360 
0x1382CA98, 37353945981170440, 89639304, 89639306, 2, 640x360 
0x1382CA98, 37353945981499152, 89639344, 89639346, 2, 640x360 
0x1382CA98, 37353945981812464, 89639365, 89639373, 8, 640x360 
0x1382CA98, 37353945982134088, 89639398, 89639406, 8, 640x360 
0x1382CA98, 37353945982449904, 89639442, 89639444, 2, 640x360 
0x1382CA98, 37353945982770400, 89639468, 89639475, 7, 640x360 
0x1382CA98, 37353945983096280, 89639503, 89639510, 7, 640x360 
0x1382CA98, 37353945983428152, 89639526, 89639531, 5, 640x360 
0x1382CA98, 37353945983733200, 89639561, 89639564, 3, 640x360 
0x1382CA98, 37353945984050024, 89639588, 89639590, 2, 640x360 
0x1382CA98, 37353945984530240, 89639643, 89639645, 2, 640x360 
0x1382CA98, 37353945984849384, 89639670, 89639676, 6, 640x360 
0x1382CA98, 37353945985173216, 89639703, 89639705, 2, 640x360 
0x1382CA98, 37353945985504752, 89639739, 89639746, 7, 640x360 
0x1382CA98, 37353945985810232, 89639765, 89639768, 3, 640x360 
0x1382CA98, 37353945986130424, 89639800, 89639803, 3, 640x360 
0x1382CA98, 37353945986450824, 89639833, 89639836, 3, 640x360 
0x1382CA98, 37353945986784768, 89639862, 89639874, 12, 640x360 
0x1382CA98, 37353945987106000, 89639897, 89639905, 8, 640x360 
0x1382CA98, 37353945987433128, 89639931, 89639941, 10, 640x360 
0x1382CA98, 37353945987734848, 89639966, 89639973, 7, 640x360 
0x1382CA98, 37353945988049920, 89640000, 89640006, 6, 640x360 
0x1382CA98, 37353945988534128, 89640044, 89640046, 2, 640x360 
0x1382CA98, 37353945988850064, 89640077, 89640080, 3, 640x360 
0x1382CA98, 37353945989173032, 89640106, 89640108, 2, 640x360 
0x1382CA98, 37353945989493336, 89640137, 89640140, 3, 640x360 
0x1382CA98, 37353945989810520, 89640163, 89640174, 11, 640x360 
0x1382CA98, 37353945990130368, 89640208, 89640210, 2, 640x360 
0x1382CA98, 37353945990450520, 89640229, 89640235, 6, 640x360 
0x1382CA98, 37353945990770304, 89640269, 89640272, 3, 640x360 
0x1382CA98, 37353945991090680, 89640294, 89640296, 2, 640x360 
0x1382CA98, 37353945991440744, 89640326, 89640328, 2, 640x360 
0x1382CA98, 37353945991730304, 89640365, 89640372, 7, 640x360 
0x1382CA98, 37353945992050800, 89640398, 89640402, 4, 640x360 
0x1382CA98, 37353945992542456, 89640448, 89640455, 7, 640x360 
0x1382CA98, 37353945992849576, 89640478, 89640483, 5, 640x360 
0x1382CA98, 37353945993169392, 89640503, 89640505, 2, 640x360 
0x1382CA98, 37353945993495344, 89640541, 89640544, 3, 640x360 
0x1382CA98, 37353945993813672, 89640573, 89640575, 2, 640x360 
0x1382CA98, 37353945994130768, 89640597, 89640607, 10, 640x360 
0x1382CA98, 37353945994449544, 89640625, 89640628, 3, 640x360 
0x1382CA98, 37353945994770984, 89640666, 89640672, 6, 640x360 
0x1382CA98, 37353945995098736, 89640701, 89640709, 8, 640x360 
0x1382CA98, 37353945995420360, 89640736, 89640744, 8, 640x360 
0x1382CA98, 37353945995730792, 89640772, 89640777, 5, 640x360 
0x1382CA98, 37353945996050008, 89640802, 89640804, 2, 640x360 
0x1382CA98, 37353945996533600, 89640837, 89640840, 3, 640x360 
0x1382CA98, 37353945996852952, 89640869, 89640876, 7, 640x360 
0x1382CA98, 37353945997172432, 89640903, 89640912, 9, 640x360 
0x1382CA98, 37353945997489712, 89640937, 89640944, 7, 640x360 
0x1382CA98, 37353945997810000, 89640969, 89640973, 4, 640x360 
0x1382CA98, 37353945998129816, 89640996, 89641008, 12, 640x360 
0x1382CA98, 37353945998451424, 89641031, 89641038, 7, 640x360 
0x1382CA98, 37353945998774880, 89641077, 89641085, 8, 640x360 
0x1382CA98, 37353945999097576, 89641120, 89641129, 9, 640x360 
0x1382CA98, 37353945999470200, 89641143, 89641149, 6, 640x360 
0x1382CA98, 37353945999730936, 89641179, 89641197, 18, 640x360 
0x1382CA98, 37353946000050952, 89641197, 89641215, 18, 640x360 
0x1382CA98, 37353946000379856, 89641225, 89641232, 7, 640x360 
0x1382CA98, 37353946000853320, 89641275, 89641277, 2, 640x360 
0x1382CA98, 37353946001175672, 89641305, 89641307, 2, 640x360 
0x1382CA98, 37353946001490576, 89641346, 89641352, 6, 640x360 
0x1382CA98, 37353946001810928, 89641382, 89641386, 4, 640x360 
0x1382CA98, 37353946002131344, 89641409, 89641412, 3, 640x360 
0x1382CA98, 37353946002450064, 89641451, 89641453, 2, 640x360 
0x1382CA98, 37353946002775272, 89641469, 89641471, 2, 640x360 
0x1382CA98, 37353946003090280, 89641491, 89641495, 4, 640x360 
0x1382CA98, 37353946003415736, 89641526, 89641528, 2, 640x360 
0x1382CA98, 37353946003729696, 89641566, 89641573, 7, 640x360 
0x1382CA98, 37353946004049496, 89641598, 89641606, 8, 640x360 
0x1382CA98, 37353946004369504, 89641643, 89641645, 2, 640x360 
0x1382CA98, 37353946004853600, 89641685, 89641687, 2, 640x360 
0x1382CA98, 37353946005169496, 89641708, 89641712, 4, 640x360 
0x1382CA98, 37353946005495704, 89641737, 89641744, 7, 640x360 
0x1382CA98, 37353946005809232, 89641772, 89641774, 2, 640x360 
0x1382CA98, 37353946006132616, 89641802, 89641805, 3, 640x360 
0x1382CA98, 37353946006457232, 89641838, 89641841, 3, 640x360 
0x1382CA98, 37353946006789984, 89641864, 89641868, 4, 640x360 
0x1382CA98, 37353946007104984, 89641896, 89641902, 6, 640x360 
0x1382CA98, 37353946007423488, 89641937, 89641940, 3, 640x360 
0x1382CA98, 37353946007766648, 89641966, 89641969, 3, 640x360 
0x1382CA98, 37353946008115576, 89642019, 89642024, 5, 640x360 
0x1382CA98, 37353946008371248, 89642029, 89642036, 7, 640x360 
0x1382CA98, 37353946008848752, 89642076, 89642078, 2, 640x360 
0x1382CA98, 37353946009168896, 89642110, 89642113, 3, 640x360 
0x1382CA98, 37353946009495080, 89642136, 89642145, 9, 640x360 
0x1382CA98, 37353946009809464, 89642169, 89642172, 3, 640x360 
0x1382CA98, 37353946010133288, 89642203, 89642204, 1, 640x360 
0x1382CA98, 37353946010451424, 89642227, 89642233, 6, 640x360 
0x1382CA98, 37353946010769792, 89642276, 89642279, 3, 640x360 
0x1382CA98, 37353946011090096, 89642301, 89642303, 2, 640x360 
0x1382CA98, 37353946011422872, 89642325, 89642340, 15, 640x360 
0x1382CA98, 37353946011731728, 89642358, 89642361, 3, 640x360 
0x1382CA98, 37353946012049400, 89642388, 89642392, 4, 640x360 
0x1382CA98, 37353946012369624, 89642426, 89642432, 6, 640x360 
0x1382CA98, 37353946012848904, 89642484, 89642487, 3, 640x360 
0x1382CA98, 37353946013173368, 89642518, 89642522, 4, 640x360 
0x1382CA98, 37353946013492272, 89642544, 89642550, 6, 640x360 
0x1382CA98, 37353946013815360, 89642580, 89642593, 13, 640x360 
0x1382CA98, 37353946014130272, 89642604, 89642607, 3, 640x360 
0x1382CA98, 37353946014453520, 89642648, 89642652, 4, 640x360 
0x1382CA98, 37353946014785240, 89642669, 89642675, 6, 640x360 
0x1382CA98, 37353946015109160, 89642705, 89642715, 10, 640x360 
0x1382CA98, 37353946015418600, 89642728, 89642735, 7, 640x360 
0x1382CA98, 37353946015772376, 89642770, 89642772, 2, 640x360 
0x1382CA98, 37353946016055800, 89642795, 89642801, 6, 640x360 
0x1382CA98, 37353946016374392, 89642827, 89642832, 5, 640x360 
0x1382CA98, 37353946016860128, 89642882, 89642892, 10, 640x360 
0x1382CA98, 37353946017188704, 89642910, 89642914, 4, 640x360 
0x1382CA98, 37353946017517312, 89642942, 89642944, 2, 640x360 
0x1382CA98, 37353946017824248, 89642968, 89642971, 3, 640x360 
0x1382CA98, 37353946018131632, 89643005, 89643014, 9, 640x360 
0x1382CA98, 37353946018457184, 89643031, 89643037, 6, 640x360 
0x1382CA98, 37353946018777208, 89643065, 89643068, 3, 640x360 
0x1382CA98, 37353946019095240, 89643091, 89643093, 2, 640x360 
0x1382CA98, 37353946019429816, 89643135, 89643137, 2, 640x360 
0x1382CA98, 37353946019729992, 89643160, 89643164, 4, 640x360 
0x1382CA98, 37353946020052848, 89643189, 89643192, 3, 640x360 
0x1382CA98, 37353946020373304, 89643220, 89643226, 6, 640x360 
0x1382CA98, 37353946020852904, 89643274, 89643276, 2, 640x360 
0x1382CA98, 37353946021169376, 89643305, 89643307, 2, 640x360 
0x1382CA98, 37353946021489312, 89643340, 89643342, 2, 640x360 
0x1382CA98, 37353946021809904, 89643371, 89643373, 2, 640x360 
0x1382CA98, 37353946022133512, 89643396, 89643402, 6, 640x360 
0x1382CA98, 37353946022449256, 89643435, 89643438, 3, 640x360 
0x1382CA98, 37353946022769640, 89643463, 89643468, 5, 640x360 
0x1382CA98, 37353946023097744, 89643508, 89643510, 2, 640x360 
0x1382CA98, 37353946023420504, 89643534, 89643541, 7, 640x360 
0x1382CA98, 37353946023731200, 89643560, 89643565, 5, 640x360 
0x1382CA98, 37353946024052336, 89643591, 89643593, 2, 640x360 
0x1382CA98, 37353946024368920, 89643619, 89643628, 9, 640x360 
0x1382CA98, 37353946024858600, 89643677, 89643682, 5, 640x360 
0x1382CA98, 37353946025173688, 89643710, 89643718, 8, 640x360 
0x1382CA98, 37353946025500080, 89643743, 89643746, 3, 640x360 
0x1382CA98, 37353946025811536, 89643774, 89643776, 2, 640x360 
0x1382CA98, 37353946026132760, 89643804, 89643806, 2, 640x360 
0x1382CA98, 37353946026460648, 89643829, 89643842, 13, 640x360 
0x1382CA98, 37353946026787232, 89643876, 89643877, 1, 640x360 
0x1382CA98, 37353946027101976, 89643895, 89643906, 11, 640x360 
0x1382CA98, 37353946027414288, 89643926, 89643929, 3, 640x360 
0x1382CA98, 37353946027729984, 89643958, 89643961, 3, 640x360 
0x1382CA98, 37353946028053224, 89643991, 89643995, 4, 640x360 
0x1382CA98, 37353946028369312, 89644030, 89644033, 3, 640x360 
0x1382CA98, 37353946029169448, 89644102, 89644107, 5, 640x360 
0x1382CA98, 37353946029492056, 89644135, 89644142, 7, 640x360 
0x1382CA98, 37353946029810192, 89644173, 89644176, 3, 640x360 
0x1382CA98, 37353946030129328, 89644208, 89644210, 2, 640x360 
0x1382CA98, 37353946030496312, 89644241, 89644243, 2, 640x360 
0x1382CA98, 37353946030771184, 89644279, 89644283, 4, 640x360 
0x1382CA98, 37353946031098088, 89644297, 89644301, 4, 640x360 
0x1382CA98, 37353946031420696, 89644333, 89644339, 6, 640x360 
0x1382CA98, 37353946031734904, 89644365, 89644368, 3, 640x360 
0x1382CA98, 37353946032048984, 89644391, 89644394, 3, 640x360 
0x1382CA98, 37353946032368808, 89644432, 89644443, 11, 640x360 
0x1382CA98, 37353946032695032, 89644466, 89644469, 3, 640x360 
0x1382CA98, 37353946033173976, 89644506, 89644513, 7, 640x360 
0x1382CA98, 37353946033493184, 89644537, 89644539, 2, 640x360 
0x1382CA98, 37353946033811592, 89644571, 89644572, 1, 640x360 
0x1382CA98, 37353946034128160, 89644595, 89644598, 3, 640x360 
0x1382CA98, 37353946034452584, 89644636, 89644639, 3, 640x360 
0x1382CA98, 37353946034769144, 89644671, 89644682, 11, 640x360 
0x1382CA98, 37353946035111336, 89644701, 89644704, 3, 640x360 
0x1382CA98, 37353946035420360, 89644736, 89644739, 3, 640x360 
0x1382CA98, 37353946035733816, 89644755, 89644757, 2, 640x360 
0x1382CA98, 37353946036049600, 89644799, 89644807, 8, 640x360 
0x1382CA98, 37353946036368760, 89644832, 89644841, 9, 640x360 
0x1382CA98, 37353946036694176, 89644861, 89644865, 4, 640x360 
0x1382CA98, 37353946037181576, 89644915, 89644925, 10, 640x360 
0x1382CA98, 37353946037493584, 89644945, 89644955, 10, 640x360 
0x1382CA98, 37353946037817336, 89644969, 89644977, 8, 640x360 
0x1382CA98, 37353946038128968, 89645003, 89645013, 10, 640x360 
0x1382CA98, 37353946038448184, 89645036, 89645039, 3, 640x360 
0x1382CA98, 37353946038768272, 89645065, 89645070, 5, 640x360 
0x1382CA98, 37353946039089272, 89645096, 89645100, 4, 640x360 
0x1382CA98, 37353946039415680, 89645131, 89645135, 4, 640x360 
0x1382CA98, 37353946039729328, 89645165, 89645168, 3, 640x360 
0x1382CA98, 37353946040048656, 89645198, 89645202, 4, 640x360 
0x1382CA98, 37353946040369592, 89645233, 89645236, 3, 640x360 
0x1382CA98, 37353946040689288, 89645253, 89645256, 3, 640x360 
0x1382CA98, 37353946041172536, 89645312, 89645323, 11, 640x360 
0x1382CA98, 37353946041490624, 89645348, 89645357, 9, 640x360 
0x1382CA98, 37353946041819608, 89645381, 89645389, 8, 640x360 
0x1382CA98, 37353946042128640, 89645399, 89645403, 4, 640x360 
0x1382CA98, 37353946042448456, 89645431, 89645441, 10, 640x360 
0x1382CA98, 37353946042786128, 89645473, 89645475, 2, 640x360 
0x1382CA98, 37353946043103680, 89645491, 89645494, 3, 640x360 
0x1382CA98, 37353946043414384, 89645525, 89645527, 2, 640x360 
0x1382CA98, 37353946043728784, 89645558, 89645561, 3, 640x360 
0x1382CA98, 37353946044048280, 89645592, 89645594, 2, 640x360 
0x1382CA98, 37353946044368192, 89645620, 89645628, 8, 640x360 
0x1382CA98, 37353946044692408, 89645665, 89645668, 3, 640x360 
0x1382CA98, 37353946045167864, 89645707, 89645709, 2, 640x360 
0x1382CA98, 37353946045493032, 89645737, 89645741, 4, 640x360 
0x1382CA98, 37353946045811008, 89645771, 89645773, 2, 640x360 
0x1382CA98, 37353946046127880, 89645796, 89645801, 5, 640x360 
0x1382CA98, 37353946046447952, 89645827, 89645834, 7, 640x360 
0x1382CA98, 37353946046774728, 89645865, 89645868, 3, 640x360 
0x1382CA98, 37353946047089848, 89645898, 89645901, 3, 640x360 
0x1382CA98, 37353946047421712, 89645929, 89645935, 6, 640x360 
0x1382CA98, 37353946047763256, 89645967, 89645971, 4, 640x360 
0x1382CA98, 37353946048048416, 89645999, 89646010, 11, 640x360 
0x1382CA98, 37353946048369552, 89646026, 89646028, 2, 640x360 
0x1382CA98, 37353946048689392, 89646058, 89646060, 2, 640x360 
0x1382CA98, 37353946049168432, 89646109, 89646113, 4, 640x360 
0x1382CA98, 37353946049490504, 89646148, 89646151, 3, 640x360 
0x1382CA98, 37353946049808328, 89646176, 89646178, 2, 640x360 
0x1382CA98, 37353946050128424, 89646199, 89646203, 4, 640x360 
0x1382CA98, 37353946050447976, 89646230, 89646239, 9, 640x360 
0x1382CA98, 37353946050779176, 89646268, 89646275, 7, 640x360 
0x1382CA98, 37353946051094952, 89646295, 89646300, 5, 640x360 
0x1382CA98, 37353946051419792, 89646324, 89646327, 3, 640x360 
0x1382CA98, 37353946051733832, 89646370, 89646373, 3, 640x360 
0x1382CA98, 37353946052052896, 89646401, 89646403, 2, 640x360 
0x1382CA98, 37353946052368208, 89646422, 89646426, 4, 640x360 
0x1382CA98, 37353946052688352, 89646459, 89646461, 2, 640x360 
0x1382CA98, 37353946053022128, 89646488, 89646490, 2, 640x360 
0x1382CA98, 37353946053487888, 89646544, 89646546, 2, 640x360 
0x1382CA98, 37353946053807840, 89646571, 89646577, 6, 640x360 
0x1382CA98, 37353946054128192, 89646597, 89646602, 5, 640x360 
0x1382CA98, 37353946054447984, 89646628, 89646635, 7, 640x360 
0x1382CA98, 37353946054768616, 89646659, 89646662, 3, 640x360 
0x1382CA98, 37353946055094456, 89646703, 89646706, 3, 640x360 
0x1382CA98, 37353946055415000, 89646738, 89646743, 5, 640x360 
0x1382CA98, 37353946055729448, 89646759, 89646761, 2, 640x360 
0x1382CA98, 37353946056048760, 89646790, 89646793, 3, 640x360 
0x1382CA98, 37353946056368712, 89646825, 89646827, 2, 640x360 
0x1382CA98, 37353946056696824, 89646853, 89646856, 3, 640x360 
0x1382CA98, 37353946057008880, 89646895, 89646907, 12, 640x360 
0x1382CA98, 37353946057488168, 89646941, 89646943, 2, 640x360 
0x1382CA98, 37353946057807808, 89646967, 89646969, 2, 640x360 
0x1382CA98, 37353946058128152, 89647000, 89647002, 2, 640x360 
0x1382CA98, 37353946058447672, 89647031, 89647034, 3, 640x360 
0x1382CA98, 37353946058768216, 89647063, 89647065, 2, 640x360 
0x1382CA98, 37353946059092584, 89647095, 89647097, 2, 640x360 
0x1382CA98, 37353946059408344, 89647126, 89647131, 5, 640x360 
0x1382CA98, 37353946059729624, 89647156, 89647158, 2, 640x360 
0x1382CA98, 37353946060049160, 89647186, 89647188, 2, 640x360 
0x1382CA98, 37353946060369184, 89647217, 89647220, 3, 640x360 
0x1382CA98, 37353946060689384, 89647254, 89647256, 2, 640x360 
0x1382CA98, 37353946061008832, 89647283, 89647285, 2, 640x360 
0x1382CA98, 37353946061488600, 89647333, 89647336, 3, 640x360 
0x1382CA98, 37353946061808480, 89647364, 89647368, 4, 640x360 
0x1382CA98, 37353946062129024, 89647397, 89647403, 6, 640x360 
0x1382CA98, 37353946062448824, 89647425, 89647428, 3, 640x360 
0x1382CA98, 37353946062769024, 89647462, 89647468, 6, 640x360 
0x1382CA98, 37353946063093600, 89647493, 89647497, 4, 640x360 
0x1382CA98, 37353946063410928, 89647527, 89647532, 5, 640x360 
0x1382CA98, 37353946063732368, 89647562, 89647571, 9, 640x360 
0x1382CA98, 37353946064107320, 89647595, 89647605, 10, 640x360 
0x1382CA98, 37353946064368528, 89647622, 89647625, 3, 640x360 
0x1382CA98, 37353946064688736, 89647662, 89647674, 12, 640x360 
0x1382CA98, 37353946065013456, 89647694, 89647699, 5, 640x360 
0x1382CA98, 37353946065488256, 89647742, 89647744, 2, 640x360 
0x1382CA98, 37353946065820312, 89647768, 89647777, 9, 640x360 
0x1382CA98, 37353946066143040, 89647802, 89647805, 3, 640x360 
0x1382CA98, 37353946066451072, 89647839, 89647843, 4, 640x360 
0x1382CA98, 37353946066772192, 89647860, 89647864, 4, 640x360 
0x1382CA98, 37353946067097408, 89647891, 89647894, 3, 640x360 
0x1382CA98, 37353946067412280, 89647926, 89647931, 5, 640x360 
0x1382CA98, 37353946067727992, 89647959, 89647963, 4, 640x360 
0x1382CA98, 37353946068047544, 89647995, 89648001, 6, 640x360 
0x1382CA98, 37353946068374888, 89648022, 89648025, 3, 640x360 
0x1382CA98, 37353946068699128, 89648053, 89648055, 2, 640x360 
0x1382CA98, 37353946069009440, 89648087, 89648089, 2, 640x360 
0x1382CA98, 37353946069580824, 89648145, 89648149, 4, 640x360 
0x1382CA98, 37353946069813704, 89648176, 89648179, 3, 640x360 
0x1382CA98, 37353946070131648, 89648209, 89648215, 6, 640x360 
0x1382CA98, 37353946070449488, 89648236, 89648238, 2, 640x360 
0x1382CA98, 37353946070768632, 89648261, 89648274, 13, 640x360 
0x1382CA98, 37353946071094944, 89648294, 89648298, 4, 640x360 
0x1382CA98, 37353946071408120, 89648325, 89648327, 2, 640x360 
0x1382CA98, 37353946071728128, 89648367, 89648377, 10, 640x360 
0x1382CA98, 37353946072058464, 89648393, 89648396, 3, 640x360 
0x1382CA98, 37353946072367976, 89648421, 89648423, 2, 640x360 
0x1382CA98, 37353946072688136, 89648454, 89648456, 2, 640x360 
0x1382CA98, 37353946073008184, 89648496, 89648500, 4, 640x360 
0x1382CA98, 37353946073487104, 89648532, 89648536, 4, 640x360 
0x1382CA98, 37353946073812800, 89648564, 89648568, 4, 640x360 
0x1382CA98, 37353946074127792, 89648597, 89648607, 10, 640x360 
0x1382CA98, 37353946074453896, 89648637, 89648641, 4, 640x360 
0x1382CA98, 37353946074784384, 89648672, 89648674, 2, 640x360 
0x1382CA98, 37353946075117544, 89648707, 89648710, 3, 640x360 
0x1382CA98, 37353946075430160, 89648750, 89648755, 5, 640x360 
0x1382CA98, 37353946075730744, 89648776, 89648791, 15, 640x360 
0x1382CA98, 37353946076059328, 89648829, 89648842, 13, 640x360 
0x1382CA98, 37353946076396672, 89648843, 89648860, 17, 640x360 
0x1382CA98, 37353946076695112, 89648895, 89648902, 7, 640x360 
0x1382CA98, 37353946077075328, 89648903, 89648913, 10, 640x360 
0x1382CA98, 37353946077519944, 89648945, 89648955, 10, 640x360 
0x1382CA98, 37353946077817896, 89648970, 89648973, 3, 640x360 
0x1382CA98, 37353946078132632, 89649011, 89649031, 20, 640x360 
0x1382CA98, 37353946078473800, 89649042, 89649044, 2, 640x360 
0x1382CA98, 37353946078793248, 89649070, 89649073, 3, 640x360 
0x1382CA98, 37353946079092928, 89649104, 89649107, 3, 640x360 
0x1382CA98, 37353946079437648, 89649145, 89649150, 5, 640x360 
0x1382CA98, 37353946079730456, 89649169, 89649171, 2, 640x360 
0x1382CA98, 37353946080064352, 89649192, 89649195, 3, 640x360 
0x1382CA98, 37353946080374888, 89649233, 89649242, 9, 640x360 
0x1382CA98, 37353946080698112, 89649263, 89649268, 5, 640x360 
0x1382CA98, 37353946081024240, 89649300, 89649302, 2, 640x360 
0x1382CA98, 37353946081327480, 89649320, 89649330, 10, 640x360 
0x1382CA98, 37353946081818424, 89649369, 89649377, 8, 640x360 
0x1382CA98, 37353946082131592, 89649402, 89649405, 3, 640x360 
0x1382CA98, 37353946082453272, 89649430, 89649435, 5, 640x360 
0x1382CA98, 37353946082767248, 89649463, 89649474, 11, 640x360 
0x1382CA98, 37353946083096296, 89649500, 89649509, 9, 640x360 
0x1382CA98, 37353946083410768, 89649537, 89649543, 6, 640x360 
0x1382CA98, 37353946083727672, 89649559, 89649570, 11, 640x360 
0x1382CA98, 37353946084047280, 89649595, 89649601, 6, 640x360 
0x1382CA98, 37353946084367464, 89649632, 89649634, 2, 640x360 
0x1382CA98, 37353946084687448, 89649653, 89649660, 7, 640x360 
0x1382CA98, 37353946085011384, 89649685, 89649693, 8, 640x360 
0x1382CA98, 37353946085327672, 89649723, 89649734, 11, 640x360 
0x1382CA98, 37353946085809840, 89649780, 89649787, 7, 640x360 
0x1382CA98, 37353946086135384, 89649814, 89649822, 8, 640x360 
0x1382CA98, 37353946086454864, 89649844, 89649850, 6, 640x360 
0x1382CA98, 37353946086770056, 89649870, 89649873, 3, 640x360 
0x1382CA98, 37353946087103208, 89649901, 89649908, 7, 640x360 
0x1382CA98, 37353946087417200, 89649926, 89649931, 5, 640x360 
0x1382CA98, 37353946087727184, 89649963, 89649973, 10, 640x360 
0x1382CA98, 37353946088047088, 89649993, 89649998, 5, 640x360 
0x1382CA98, 37353946088367328, 89650025, 89650026, 1, 640x360 
0x1382CA98, 37353946088691864, 89650059, 89650061, 2, 640x360 
0x1382CA98, 37353946089012360, 89650088, 89650090, 2, 640x360 
0x1382CA98, 37353946089328552, 89650119, 89650123, 4, 640x360 
0x1382CA98, 37353946089812816, 89650177, 89650180, 3, 640x360 
0x1382CA98, 37353946090131488, 89650204, 89650209, 5, 640x360 
0x1382CA98, 37353946090447536, 89650225, 89650227, 2, 640x360 
0x1382CA98, 37353946090766872, 89650259, 89650262, 3, 640x360 
0x1382CA98, 37353946091094600, 89650292, 89650297, 5, 640x360 
0x1382CA98, 37353946091410288, 89650325, 89650327, 2, 640x360 
0x1382CA98, 37353946091727872, 89650367, 89650370, 3, 640x360 
0x1382CA98, 37353946092048888, 89650402, 89650404, 2, 640x360 
0x1382CA98, 37353946092368272, 89650422, 89650425, 3, 640x360 
0x1382CA98, 37353946092687888, 89650453, 89650460, 7, 640x360 
0x1382CA98, 37353946093011104, 89650490, 89650500, 10, 640x360 
0x1382CA98, 37353946093327128, 89650522, 89650525, 3, 640x360 
0x1382CA98, 37353946093823168, 89650574, 89650580, 6, 640x360 
0x1382CA98, 37353946094126584, 89650602, 89650608, 6, 640x360 
0x1382CA98, 37353946094447264, 89650632, 89650638, 6, 640x360 
0x1382CA98, 37353946094813192, 89650671, 89650677, 6, 640x360 
0x1382CA98, 37353946095098432, 89650702, 89650704, 2, 640x360 
0x1382CA98, 37353946095451344, 89650738, 89650740, 2, 640x360 
0x1382CA98, 37353946095727712, 89650759, 89650762, 3, 640x360 
0x1382CA98, 37353946096048120, 89650796, 89650801, 5, 640x360 
0x1382CA98, 37353946096368272, 89650821, 89650834, 13, 640x360 
0x1382CA98, 37353946096690816, 89650854, 89650860, 6, 640x360 
0x1382CA98, 37353946097007160, 89650887, 89650894, 7, 640x360 
0x1382CA98, 37353946097327184, 89650915, 89650918, 3, 640x360 
0x1382CA98, 37353946097809112, 89650970, 89650978, 8, 640x360 
0x1382CA98, 37353946098133808, 89651001, 89651003, 2, 640x360 
0x1382CA98, 37353946098451024, 89651027, 89651034, 7, 640x360 
0x1382CA98, 37353946098776152, 89651067, 89651075, 8, 640x360 
0x1382CA98, 37353946099110168, 89651104, 89651126, 22, 640x360 
0x1382CA98, 37353946099454152, 89651158, 89651163, 5, 640x360 
0x1382CA98, 37353946099729712, 89651173, 89651175, 2, 640x360 
0x1382CA98, 37353946100046696, 89651195, 89651202, 7, 640x360 
0x1382CA98, 37353946100366720, 89651227, 89651233, 6, 640x360 
0x1382CA98, 37353946100687952, 89651271, 89651278, 7, 640x360 
0x1382CA98, 37353946101024040, 89651308, 89651316, 8, 640x360 
0x1382CA98, 37353946101342096, 89651334, 89651338, 4, 640x360 
0x1382CA98, 37353946101806360, 89651371, 89651375, 4, 640x360 
0x1382CA98, 37353946102129624, 89651397, 89651406, 9, 640x360 
0x1382CA98, 37353946102451192, 89651430, 89651439, 9, 640x360 
0x1382CA98, 37353946102786152, 89651465, 89651468, 3, 640x360 
0x1382CA98, 37353946103089632, 89651493, 89651499, 6, 640x360 
0x1382CA98, 37353946103410896, 89651524, 89651528, 4, 640x360 
0x1382CA98, 37353946103728840, 89651565, 89651568, 3, 640x360 
0x1382CA98, 37353946104048416, 89651590, 89651592, 2, 640x360 
0x1382CA98, 37353946104366632, 89651619, 89651629, 10, 640x360 
0x1382CA98, 37353946104698736, 89651666, 89651669, 3, 640x360 
0x1382CA98, 37353946105006728, 89651686, 89651695, 9, 640x360 
0x1382CA98, 37353946105331984, 89651722, 89651730, 8, 640x360 
0x1382CA98, 37353946105806200, 89651770, 89651773, 3, 640x360 
0x1382CA98, 37353946106132576, 89651804, 89651806, 2, 640x360 
0x1382CA98, 37353946106450328, 89651831, 89651834, 3, 640x360 
0x1382CA98, 37353946106769184, 89651863, 89651866, 3, 640x360 
0x1382CA98, 37353946107094512, 89651891, 89651894, 3, 640x360 
0x1382CA98, 37353946107408056, 89651932, 89651934, 2, 640x360 
0x1382CA98, 37353946107759200, 89651957, 89651960, 3, 640x360 
0x1382CA98, 37353946108049528, 89651994, 89652000, 6, 640x360 
0x1382CA98, 37353946108366800, 89652024, 89652027, 3, 640x360 
0x1382CA98, 37353946108687320, 89652058, 89652059, 1, 640x360 
0x1382CA98, 37353946109006936, 89652101, 89652114, 13, 640x360 
0x1382CA98, 37353946109329616, 89652142, 89652145, 3, 640x360 
0x1382CA98, 37353946109673376, 89652163, 89652170, 7, 640x360 
0x1382CA98, 37353946110126120, 89652205, 89652206, 1, 640x360 
0x1382CA98, 37353946110446384, 89652234, 89652238, 4, 640x360 
0x1382CA98, 37353946110766496, 89652270, 89652274, 4, 640x360 
0x1382CA98, 37353946111086496, 89652306, 89652308, 2, 640x360 
0x1382CA98, 37353946111407176, 89652323, 89652326, 3, 640x360 
0x1382CA98, 37353946111726448, 89652364, 89652373, 9, 640x360 
0x1382CA98, 37353946112046488, 89652399, 89652401, 2, 640x360 
0x1382CA98, 37353946112366648, 89652434, 89652436, 2, 640x360 
0x1382CA98, 37353946112686744, 89652460, 89652464, 4, 640x360 
0x1382CA98, 37353946113008168, 89652491, 89652492, 1, 640x360 
0x1382CA98, 37353946113326816, 89652521, 89652524, 3, 640x360 
0x1382CA98, 37353946113650368, 89652545, 89652559, 14, 640x360 
0x1382CA98, 37353946114128224, 89652602, 89652608, 6, 640x360 
0x1382CA98, 37353946114446376, 89652626, 89652638, 12, 640x360 
0x1382CA98, 37353946114770120, 89652658, 89652661, 3, 640x360 
0x1382CA98, 37353946115093336, 89652691, 89652694, 3, 640x360 
0x1382CA98, 37353946115410568, 89652724, 89652726, 2, 640x360 
0x1382CA98, 37353946115726568, 89652765, 89652773, 8, 640x360 
0x1382CA98, 37353946116046872, 89652790, 89652798, 8, 640x360 
0x1382CA98, 37353946116370664, 89652830, 89652840, 10, 640x360 
0x1382CA98, 37353946116688792, 89652857, 89652859, 2, 640x360 
0x1382CA98, 37353946117006968, 89652893, 89652895, 2, 640x360 
0x1382CA98, 37353946117334816, 89652921, 89652923, 2, 640x360 
0x1382CA98, 37353946117654568, 89652954, 89652963, 9, 640x360 
0x1382CA98, 37353946118126256, 89653006, 89653009, 3, 640x360 
0x1382CA98, 37353946118451176, 89653040, 89653061, 21, 640x360 
0x1382CA98, 37353946118815256, 89653078, 89653106, 28, 640x360 
0x1382CA98, 37353946119138208, 89653122, 89653134, 12, 640x360 
0x1382CA98, 37353946119418016, 89653158, 89653171, 13, 640x360 
0x1382CA98, 37353946119785136, 89653171, 89653175, 4, 640x360 
0x1382CA98, 37353946120056632, 89653218, 89653224, 6, 640x360 
0x1382CA98, 37353946120375080, 89653240, 89653243, 3, 640x360 
0x1382CA98, 37353946120691176, 89653265, 89653274, 9, 640x360 
0x1382CA98, 37353946121015192, 89653288, 89653295, 7, 640x360 
0x1382CA98, 37353946121334960, 89653320, 89653324, 4, 640x360 
0x1382CA98, 37353946121651840, 89653353, 89653362, 9, 640x360 
0x1382CA98, 37353946122127408, 89653409, 89653413, 4, 640x360 
0x1382CA98, 37353946122446576, 89653433, 89653436, 3, 640x360 
0x1382CA98, 37353946122771400, 89653465, 89653472, 7, 640x360 
0x1382CA98, 37353946123096688, 89653498, 89653506, 8, 640x360 
0x1382CA98, 37353946123415384, 89653526, 89653532, 6, 640x360 
0x1382CA98, 37353946123729984, 89653567, 89653580, 13, 640x360 
0x1382CA98, 37353946124055184, 89653602, 89653614, 12, 640x360 
0x1382CA98, 37353946124376200, 89653632, 89653640, 8, 640x360 
0x1382CA98, 37353946124687776, 89653661, 89653665, 4, 640x360 
0x1382CA98, 37353946125013432, 89653687, 89653691, 4, 640x360 
0x1382CA98, 37353946125330384, 89653724, 89653725, 1, 640x360 
0x1382CA98, 37353946125665552, 89653753, 89653755, 2, 640x360 
0x1382CA98, 37353946126126344, 89653794, 89653806, 12, 640x360 
0x1382CA98, 37353946126446328, 89653827, 89653833, 6, 640x360 
0x1382CA98, 37353946126781664, 89653866, 89653873, 7, 640x360 
0x1382CA98, 37353946127100520, 89653899, 89653908, 9, 640x360 
0x1382CA98, 37353946127406312, 89653925, 89653927, 2, 640x360 
0x1382CA98, 37353946127757160, 89653975, 89653980, 5, 640x360 
0x1382CA98, 37353946128087368, 89654007, 89654015, 8, 640x360 
0x1382CA98, 37353946128371624, 89654022, 89654025, 3, 640x360 
0x1382CA98, 37353946128686264, 89654059, 89654061, 2, 640x360 
0x1382CA98, 37353946129011432, 89654086, 89654093, 7, 640x360 
0x1382CA98, 37353946129329768, 89654119, 89654122, 3, 640x360 
0x1382CA98, 37353946129677600, 89654166, 89654174, 8, 640x360 
0x1382CA98, 37353946130129408, 89654197, 89654201, 4, 640x360 
0x1382CA98, 37353946130445648, 89654229, 89654235, 6, 640x360 
0x1382CA98, 37353946130774752, 89654262, 89654273, 11, 640x360 
0x1382CA98, 37353946131091856, 89654299, 89654307, 8, 640x360 
0x1382CA98, 37353946131405944, 89654336, 89654338, 2, 640x360 
0x1382CA98, 37353946131735280, 89654369, 89654372, 3, 640x360 
0x1382CA98, 37353946132051712, 89654389, 89654391, 2, 640x360 
0x1382CA98, 37353946132387960, 89654426, 89654428, 2, 640x360 
0x1382CA98, 37353946132687640, 89654452, 89654454, 2, 640x360 
0x1382CA98, 37353946133015272, 89654489, 89654492, 3, 640x360 
0x1382CA98, 37353946133326568, 89654521, 89654528, 7, 640x360 
0x1382CA98, 37353946133686664, 89654555, 89654558, 3, 640x360 
0x1382CA98, 37353946134125696, 89654596, 89654602, 6, 640x360 
0x1382CA98, 37353946134446864, 89654627, 89654635, 8, 640x360 
0x1382CA98, 37353946134772112, 89654660, 89654663, 3, 640x360 
0x1382CA98, 37353946135092224, 89654702, 89654711, 9, 640x360 
0x1382CA98, 37353946135425440, 89654728, 89654732, 4, 640x360 
0x1382CA98, 37353946135736576, 89654757, 89654760, 3, 640x360 
0x1382CA98, 37353946136048088, 89654798, 89654802, 4, 640x360 
0x1382CA98, 37353946136369792, 89654823, 89654826, 3, 640x360 
0x1382CA98, 37353946136689648, 89654862, 89654868, 6, 640x360 
0x1382CA98, 37353946137024080, 89654890, 89654893, 3, 640x360 
0x1382CA98, 37353946137327480, 89654923, 89654924, 1, 640x360 
0x1382CA98, 37353946137675664, 89654956, 89654958, 2, 640x360 
0x1382CA98, 37353946137975080, 89654988, 89654990, 2, 640x360 
0x1382CA98, 37353946138445488, 89655037, 89655040, 3, 640x360 
0x1382CA98, 37353946138785728, 89655066, 89655075, 9, 640x360 
0x1382CA98, 37353946139107024, 89655111, 89655117, 6, 640x360 
0x1382CA98, 37353946139414464, 89655150, 89655155, 5, 640x360 
0x1382CA98, 37353946139727752, 89655168, 89655174, 6, 640x360 
0x1382CA98, 37353946140045640, 89655202, 89655204, 2, 640x360 
0x1382CA98, 37353946140369072, 89655223, 89655231, 8, 640x360 
0x1382CA98, 37353946140689184, 89655254, 89655257, 3, 640x360 
0x1382CA98, 37353946141006128, 89655294, 89655296, 2, 640x360 
0x1382CA98, 37353946141329712, 89655321, 89655323, 2, 640x360 
0x1382CA98, 37353946141646256, 89655348, 89655352, 4, 640x360 
0x1382CA98, 37353946141969688, 89655379, 89655384, 5, 640x360 
0x1382CA98, 37353946142450624, 89655433, 89655440, 7, 640x360 
0x1382CA98, 37353946142770312, 89655464, 89655475, 11, 640x360 
0x1382CA98, 37353946143114912, 89655510, 89655515, 5, 640x360 
0x1382CA98, 37353946143418888, 89655529, 89655543, 14, 640x360 
0x1382CA98, 37353946143725528, 89655561, 89655565, 4, 640x360 
0x1382CA98, 37353946144050016, 89655598, 89655607, 9, 640x360 
0x1382CA98, 37353946144365648, 89655630, 89655642, 12, 640x360 
0x1382CA98, 37353946144687552, 89655661, 89655663, 2, 640x360 
0x1382CA98, 37353946145011856, 89655687, 89655693, 6, 640x360 
0x1382CA98, 37353946145325912, 89655720, 89655727, 7, 640x360 
0x1382CA98, 37353946145648424, 89655756, 89655763, 7, 640x360 
0x1382CA98, 37353946145967360, 89655788, 89655795, 7, 640x360 
0x1382CA98, 37353946146451112, 89655838, 89655841, 3, 640x360 
0x1382CA98, 37353946146770000, 89655878, 89655884, 6, 640x360 
0x1382CA98, 37353946147099328, 89655918, 89655927, 9, 640x360 
0x1382CA98, 37353946147445856, 89655945, 89655948, 3, 640x360 
0x1382CA98, 37353946147726296, 89655973, 89655977, 4, 640x360 
0x1382CA98, 37353946148049392, 89655994, 89655998, 4, 640x360 
0x1382CA98, 37353946148365472, 89656029, 89656035, 6, 640x360 
0x1382CA98, 37353946148706032, 89656064, 89656075, 11, 640x360 
0x1382CA98, 37353946149024808, 89656087, 89656090, 3, 640x360 
0x1382CA98, 37353946149325672, 89656122, 89656124, 2, 640x360 
0x1382CA98, 37353946149651552, 89656157, 89656159, 2, 640x360 
0x1382CA98, 37353946149966344, 89656191, 89656193, 2, 640x360 
0x1382CA98, 37353946150448008, 89656230, 89656242, 12, 640x360 
0x1382CA98, 37353946150782824, 89656265, 89656272, 7, 640x360 
0x1382CA98, 37353946151097392, 89656293, 89656298, 5, 640x360 
0x1382CA98, 37353946151430088, 89656326, 89656328, 2, 640x360 
0x1382CA98, 37353946151731192, 89656358, 89656361, 3, 640x360 
0x1382CA98, 37353946152048032, 89656404, 89656407, 3, 640x360 
0x1382CA98, 37353946152369104, 89656435, 89656437, 2, 640x360 
0x1382CA98, 37353946152690144, 89656465, 89656467, 2, 640x360 
0x1382CA98, 37353946153005288, 89656486, 89656493, 7, 640x360 
0x1382CA98, 37353946153329136, 89656517, 89656520, 3, 640x360 
0x1382CA98, 37353946153649360, 89656548, 89656551, 3, 640x360 
0x1382CA98, 37353946153969480, 89656586, 89656588, 2, 640x360 
0x1382CA98, 37353946154446128, 89656629, 89656633, 4, 640x360 
0x1382CA98, 37353946154766160, 89656662, 89656673, 11, 640x360 
0x1382CA98, 37353946155086552, 89656693, 89656704, 11, 640x360 
0x1382CA98, 37353946155408176, 89656729, 89656735, 6, 640x360 
0x1382CA98, 37353946155725464, 89656760, 89656765, 5, 640x360 
0x1382CA98, 37353946156045496, 89656789, 89656798, 9, 640x360 
0x1382CA98, 37353946156365072, 89656820, 89656826, 6, 640x360 
0x1382CA98, 37353946156689272, 89656853, 89656865, 12, 640x360 
0x1382CA98, 37353946157005520, 89656889, 89656891, 2, 640x360 
0x1382CA98, 37353946157325392, 89656915, 89656918, 3, 640x360 
0x1382CA98, 37353946157655448, 89656949, 89656953, 4, 640x360 
0x1382CA98, 37353946157965936, 89656986, 89656989, 3, 640x360 
0x1382CA98, 37353946158445760, 89657039, 89657040, 1, 640x360 
0x1382CA98, 37353946158765104, 89657060, 89657068, 8, 640x360 
0x1382CA98, 37353946159085392, 89657098, 89657102, 4, 640x360 
0x1382CA98, 37353946159409064, 89657129, 89657133, 4, 640x360 
0x1382CA98, 37353946159740888, 89657159, 89657162, 3, 640x360 
0x1382CA98, 37353946160045600, 89657200, 89657203, 3, 640x360 
0x1382CA98, 37353946160372744, 89657227, 89657229, 2, 640x360 
0x1382CA98, 37353946160687976, 89657255, 89657257, 2, 640x360 
0x1382CA98, 37353946161018488, 89657291, 89657294, 3, 640x360 
0x1382CA98, 37353946161326872, 89657334, 89657336, 2, 640x360 
0x1382CA98, 37353946161645584, 89657353, 89657357, 4, 640x360 
0x1382CA98, 37353946161965920, 89657402, 89657405, 3, 640x360 
0x1382CA98, 37353946162298224, 89657423, 89657424, 1, 640x360 
0x1382CA98, 37353946162767424, 89657465, 89657467, 2, 640x360 
0x1382CA98, 37353946163089568, 89657491, 89657494, 3, 640x360 
0x1382CA98, 37353946163407888, 89657532, 89657535, 3, 640x360 
0x1382CA98, 37353946163726120, 89657561, 89657570, 9, 640x360 
0x1382CA98, 37353946164045088, 89657603, 89657605, 2, 640x360 
0x1382CA98, 37353946164384104, 89657625, 89657627, 2, 640x360 
0x1382CA98, 37353946164685128, 89657662, 89657667, 5, 640x360 
0x1382CA98, 37353946165033560, 89657699, 89657703, 4, 640x360 
0x1382CA98, 37353946165328688, 89657720, 89657724, 4, 640x360 
0x1382CA98, 37353946165645448, 89657762, 89657767, 5, 640x360 
0x1382CA98, 37353946165965568, 89657794, 89657797, 3, 640x360 
0x1382CA98, 37353946166285504, 89657820, 89657827, 7, 640x360 
0x1382CA98, 37353946166772816, 89657866, 89657869, 3, 640x360 
0x1382CA98, 37353946167088664, 89657895, 89657898, 3, 640x360 
0x1382CA98, 37353946167413400, 89657930, 89657932, 2, 640x360 
0x1382CA98, 37353946167731616, 89657962, 89657967, 5, 640x360 
0x1382CA98, 37353946168045520, 89657996, 89658002, 6, 640x360 
0x1382CA98, 37353946168366120, 89658037, 89658041, 4, 640x360 
0x1382CA98, 37353946168696976, 89658074, 89658090, 16, 640x360 
0x1382CA98, 37353946169010600, 89658122, 89658130, 8, 640x360 
0x1382CA98, 37353946169328384, 89658139, 89658144, 5, 640x360 
0x1382CA98, 37353946169653048, 89658166, 89658181, 15, 640x360 
0x1382CA98, 37353946169982104, 89658202, 89658211, 9, 640x360 
0x1382CA98, 37353946170299312, 89658221, 89658233, 12, 640x360 
0x1382CA98, 37353946170770832, 89658277, 89658279, 2, 640x360 
0x1382CA98, 37353946171093928, 89658295, 89658311, 16, 640x360 
0x1382CA98, 37353946171461056, 89658370, 89658374, 4, 640x360 
0x1382CA98, 37353946171780752, 89658383, 89658423, 40, 640x360 
0x1382CA98, 37353946172049856, 89658423, 89658438, 15, 640x360 
0x1382CA98, 37353946172511192, 89658465, 89658481, 16, 640x360 
0x1382CA98, 37353946172768384, 89658488, 89658501, 13, 640x360 
0x1382CA98, 37353946173077800, 89658537, 89658553, 16, 640x360 
0x1382CA98, 37353946173357488, 89658553, 89658619, 66, 640x360 
0x1382CA98, 37353946173704104, 89658620, 89658622, 2, 640x360 
0x1382CA98, 37353946174334136, 89658640, 89658644, 4, 640x360 
0x1382CA98, 37353946174782648, 89658679, 89658691, 12, 640x360 
0x1382CA98, 37353946175092040, 89658707, 89658709, 2, 640x360 
0x1382CA98, 37353946175412632, 89658745, 89658751, 6, 640x360 
0x1382CA98, 37353946175725184, 89658770, 89658772, 2, 640x360 
0x1382CA98, 37353946176051792, 89658815, 89658843, 28, 640x360 
0x1382CA98, 37353946176370928, 89658849, 89658854, 5, 640x360 
0x1382CA98, 37353946176694008, 89658872, 89658884, 12, 640x360 
0x1382CA98, 37353946177044632, 89658906, 89658919, 13, 640x360 
0x1382CA98, 37353946177332216, 89658943, 89658950, 7, 640x360 
0x1382CA98, 37353946177658952, 89658968, 89658976, 8, 640x360 
0x1382CA98, 37353946177967968, 89659001, 89659004, 3, 640x360 
0x1382CA98, 37353946178296168, 89659022, 89659024, 2, 640x360 
0x1382CA98, 37353946178777512, 89659071, 89659073, 2, 640x360 
0x1382CA98, 37353946179089584, 89659092, 89659095, 3, 640x360 
0x1382CA98, 37353946179413080, 89659126, 89659131, 5, 640x360 
0x1382CA98, 37353946179724248, 89659158, 89659161, 3, 640x360 
0x1382CA98, 37353946180045576, 89659190, 89659201, 11, 640x360 
0x1382CA98, 37353946180366240, 89659221, 89659224, 3, 640x360 
0x1382CA98, 37353946180688568, 89659254, 89659261, 7, 640x360 
0x1382CA98, 37353946181008328, 89659286, 89659299, 13, 640x360 
0x1382CA98, 37353946181324616, 89659320, 89659322, 2, 640x360 
0x1382CA98, 37353946181649248, 89659361, 89659364, 3, 640x360 
0x1382CA98, 37353946181965184, 89659393, 89659396, 3, 640x360 
0x1382CA98, 37353946182285480, 89659410, 89659414, 4, 640x360 
0x1382CA98, 37353946182764568, 89659462, 89659464, 2, 640x360 
0x1382CA98, 37353946183084488, 89659493, 89659500, 7, 640x360 
0x1382CA98, 37353946183405192, 89659524, 89659527, 3, 640x360 
0x1382CA98, 37353946183725344, 89659556, 89659559, 3, 640x360 
0x1382CA98, 37353946184045416, 89659587, 89659590, 3, 640x360 
0x1382CA98, 37353946184365640, 89659618, 89659620, 2, 640x360 
0x1382CA98, 37353946184685120, 89659649, 89659652, 3, 640x360 
0x1382CA98, 37353946185005296, 89659685, 89659687, 2, 640x360 
0x1382CA98, 37353946185325592, 89659716, 89659718, 2, 640x360 
0x1382CA98, 37353946185645888, 89659748, 89659753, 5, 640x360 
0x1382CA98, 37353946185967232, 89659780, 89659784, 4, 640x360 
0x1382CA98, 37353946186285320, 89659811, 89659815, 4, 640x360 
0x1382CA98, 37353946186764264, 89659863, 89659865, 2, 640x360 
0x1382CA98, 37353946187084904, 89659893, 89659896, 3, 640x360 
0x1382CA98, 37353946187407504, 89659924, 89659926, 2, 640x360 
0x1382CA98, 37353946187725472, 89659955, 89659958, 3, 640x360 
0x1382CA98, 37353946188045352, 89659987, 89659990, 3, 640x360 
0x1382CA98, 37353946188365104, 89660018, 89660020, 2, 640x360 
0x1382CA98, 37353946188685280, 89660054, 89660056, 2, 640x360 
0x1382CA98, 37353946189005952, 89660085, 89660088, 3, 640x360 
0x1382CA98, 37353946189324792, 89660116, 89660120, 4, 640x360 
0x1382CA98, 37353946189653424, 89660150, 89660154, 4, 640x360 
0x1382CA98, 37353946189968160, 89660179, 89660186, 7, 640x360 
0x1382CA98, 37353946190295984, 89660215, 89660224, 9, 640x360 
0x1382CA98, 37353946190606944, 89660247, 89660254, 7, 640x360 
0x1382CA98, 37353946191086960, 89660298, 89660306, 8, 640x360 
0x1382CA98, 37353946191409584, 89660329, 89660336, 7, 640x360 
0x1382CA98, 37353946191736960, 89660357, 89660360, 3, 640x360 
0x1382CA98, 37353946192044056, 89660394, 89660401, 7, 640x360 
0x1382CA98, 37353946192369960, 89660425, 89660428, 3, 640x360 
0x1382CA98, 37353946192697312, 89660469, 89660475, 6, 640x360 
0x1382CA98, 37353946193025984, 89660496, 89660502, 6, 640x360 
0x1382CA98, 37353946193328128, 89660535, 89660538, 3, 640x360 
0x1382CA98, 37353946193645008, 89660556, 89660558, 2, 640x360 
0x1382CA98, 37353946193990936, 89660596, 89660607, 11, 640x360 
0x1382CA98, 37353946194286112, 89660619, 89660628, 9, 640x360 
0x1382CA98, 37353946194609248, 89660644, 89660649, 5, 640x360 
0x1382CA98, 37353946195088536, 89660700, 89660706, 6, 640x360 
0x1382CA98, 37353946195436184, 89660736, 89660752, 16, 640x360 
0x1382CA98, 37353946195741616, 89660773, 89660775, 2, 640x360 
0x1382CA98, 37353946196044440, 89660811, 89660816, 5, 640x360 
0x1382CA98, 37353946196367216, 89660825, 89660828, 3, 640x360 
0x1382CA98, 37353946196688816, 89660865, 89660875, 10, 640x360 
0x1382CA98, 37353946197031744, 89660905, 89660921, 16, 640x360 
0x1382CA98, 37353946197327848, 89660934, 89660938, 4, 640x360 
0x1382CA98, 37353946197665368, 89660960, 89660970, 10, 640x360 
0x1382CA98, 37353946197968248, 89660994, 89660998, 4, 640x360 
0x1382CA98, 37353946198291144, 89661020, 89661023, 3, 640x360 
0x1382CA98, 37353946198605368, 89661043, 89661046, 3, 640x360 
0x1382CA98, 37353946199089808, 89661095, 89661103, 8, 640x360 
0x1382CA98, 37353946199427952, 89661141, 89661154, 13, 640x360 
0x1382CA98, 37353946199725480, 89661174, 89661180, 6, 640x360 
0x1382CA98, 37353946200059656, 89661196, 89661209, 13, 640x360 
0x1382CA98, 37353946200369880, 89661223, 89661225, 2, 640x360 
0x1382CA98, 37353946200683896, 89661256, 89661258, 2, 640x360 
0x1382CA98, 37353946201004632, 89661297, 89661308, 11, 640x360 
0x1382CA98, 37353946201332872, 89661321, 89661324, 3, 640x360 
0x1382CA98, 37353946201653952, 89661362, 89661368, 6, 640x360 
0x1382CA98, 37353946201965528, 89661392, 89661394, 2, 640x360 
0x1382CA98, 37353946202289592, 89661420, 89661422, 2, 640x360 
0x1382CA98, 37353946202605704, 89661443, 89661446, 3, 640x360 
0x1382CA98, 37353946203085112, 89661496, 89661501, 5, 640x360 
0x1382CA98, 37353946203420888, 89661531, 89661535, 4, 640x360 
0x1382CA98, 37353946203738648, 89661557, 89661561, 4, 640x360 
0x1382CA98, 37353946204053016, 89661596, 89661602, 6, 640x360 
0x1382CA98, 37353946204367904, 89661627, 89661631, 4, 640x360 
0x1382CA98, 37353946204687648, 89661655, 89661661, 6, 640x360 
0x1382CA98, 37353946205004512, 89661688, 89661694, 6, 640x360 
0x1382CA98, 37353946205325200, 89661719, 89661722, 3, 640x360 
0x1382CA98, 37353946205648056, 89661761, 89661764, 3, 640x360 
0x1382CA98, 37353946205970680, 89661788, 89661790, 2, 640x360 
0x1382CA98, 37353946206289440, 89661812, 89661818, 6, 640x360 
0x1382CA98, 37353946206604688, 89661852, 89661854, 2, 640x360 
0x1382CA98, 37353946207095392, 89661896, 89661902, 6, 640x360 
0x1382CA98, 37353946207413736, 89661928, 89661934, 6, 640x360 
0x1382CA98, 37353946207725056, 89661966, 89661969, 3, 640x360 
0x1382CA98, 37353946208048464, 89662000, 89662002, 2, 640x360 
0x1382CA98, 37353946208364184, 89662028, 89662033, 5, 640x360 
0x1382CA98, 37353946208692056, 89662057, 89662060, 3, 640x360 
0x1382CA98, 37353946209006624, 89662089, 89662097, 8, 640x360 
0x1382CA98, 37353946209332648, 89662134, 89662143, 9, 640x360 
0x1382CA98, 37353946209645600, 89662162, 89662167, 5, 640x360 
0x1382CA98, 37353946209968560, 89662189, 89662193, 4, 640x360 
0x1382CA98, 37353946210293808, 89662222, 89662224, 2, 640x360 
0x1382CA98, 37353946210608112, 89662260, 89662263, 3, 640x360 
0x1382CA98, 37353946211103528, 89662304, 89662307, 3, 640x360 
0x1382CA98, 37353946211413120, 89662333, 89662336, 3, 640x360 
0x1382CA98, 37353946211731776, 89662366, 89662370, 4, 640x360 
0x1382CA98, 37353946212048040, 89662391, 89662394, 3, 640x360 
0x1382CA98, 37353946212364656, 89662428, 89662435, 7, 640x360 
0x1382CA98, 37353946212688888, 89662455, 89662458, 3, 640x360 
0x1382CA98, 37353946213004400, 89662488, 89662490, 2, 640x360 
0x1382CA98, 37353946213325192, 89662531, 89662535, 4, 640x360 
0x1382CA98, 37353946213643808, 89662555, 89662557, 2, 640x360 
0x1382CA98, 37353946213978680, 89662588, 89662590, 2, 640x360 
0x1382CA98, 37353946214288784, 89662615, 89662619, 4, 640x360 
0x1382CA98, 37353946214608264, 89662647, 89662651, 4, 640x360 
0x1382CA98, 37353946215089496, 89662701, 89662707, 6, 640x360 
0x1382CA98, 37353946215409744, 89662727, 89662731, 4, 640x360 
0x1382CA98, 37353946215723360, 89662760, 89662764, 4, 640x360 
0x1382CA98, 37353946216044040, 89662800, 89662806, 6, 640x360 
0x1382CA98, 37353946216366536, 89662831, 89662840, 9, 640x360 
0x1382CA98, 37353946216684552, 89662864, 89662872, 8, 640x360 
0x1382CA98, 37353946217004752, 89662887, 89662892, 5, 640x360 
0x1382CA98, 37353946217338320, 89662921, 89662927, 6, 640x360 
0x1382CA98, 37353946217648216, 89662955, 89662960, 5, 640x360 
0x1382CA98, 37353946217964752, 89662989, 89662993, 4, 640x360 
0x1382CA98, 37353946218298384, 89663029, 89663041, 12, 640x360 
0x1382CA98, 37353946218623152, 89663061, 89663066, 5, 640x360 
0x1382CA98, 37353946218934424, 89663094, 89663096, 2, 640x360 
0x1382CA98, 37353946219404136, 89663138, 89663141, 3, 640x360 
0x1382CA98, 37353946219728896, 89663174, 89663182, 8, 640x360 
0x1382CA98, 37353946220046288, 89663212, 89663219, 7, 640x360 
0x1382CA98, 37353946220370992, 89663227, 89663241, 14, 640x360 
0x1382CA98, 37353946220687128, 89663260, 89663263, 3, 640x360 
0x1382CA98, 37353946221024456, 89663291, 89663294, 3, 640x360 
0x1382CA98, 37353946221333328, 89663334, 89663337, 3, 640x360 
0x1382CA98, 37353946221649584, 89663356, 89663357, 1, 640x360 
0x1382CA98, 37353946221977976, 89663381, 89663386, 5, 640x360 
0x1382CA98, 37353946222288296, 89663421, 89663424, 3, 640x360 
0x1382CA98, 37353946222610392, 89663444, 89663447, 3, 640x360 
0x1382CA98, 37353946222931992, 89663476, 89663479, 3, 640x360 
0x1382CA98, 37353946223404752, 89663534, 89663541, 7, 640x360 
0x1382CA98, 37353946223722976, 89663567, 89663571, 4, 640x360 
0x1382CA98, 37353946224047616, 89663598, 89663607, 9, 640x360 
0x1382CA98, 37353946224363168, 89663625, 89663634, 9, 640x360 
0x1382CA98, 37353946224687768, 89663667, 89663670, 3, 640x360 
0x1382CA98, 37353946225003728, 89663689, 89663691, 2, 640x360 
0x1382CA98, 37353946225326624, 89663721, 89663723, 2, 640x360 
0x1382CA98, 37353946225646400, 89663755, 89663761, 6, 640x360 
0x1382CA98, 37353946225963656, 89663784, 89663787, 3, 640x360 
0x1382CA98, 37353946226286832, 89663813, 89663816, 3, 640x360 
0x1382CA98, 37353946226609480, 89663852, 89663854, 2, 640x360 
0x1382CA98, 37353946226958712, 89663885, 89663887, 2, 640x360 
0x1382CA98, 37353946227405920, 89663929, 89663935, 6, 640x360 
0x1382CA98, 37353946227747128, 89663958, 89663960, 2, 640x360 
0x1382CA98, 37353946228055200, 89664000, 89664002, 2, 640x360 
0x1382CA98, 37353946228367824, 89664031, 89664033, 2, 640x360 
0x1382CA98, 37353946228683152, 89664052, 89664058, 6, 640x360 
0x1382CA98, 37353946229008512, 89664086, 89664089, 3, 640x360 
0x1382CA98, 37353946229324456, 89664123, 89664125, 2, 640x360 
0x1382CA98, 37353946229675896, 89664157, 89664159, 2, 640x360 
0x1382CA98, 37353946229980128, 89664189, 89664191, 2, 640x360 
0x1382CA98, 37353946230298016, 89664222, 89664224, 2, 640x360 
0x1382CA98, 37353946230603816, 89664243, 89664246, 3, 640x360 
0x1382CA98, 37353946230928888, 89664275, 89664278, 3, 640x360 
0x1382CA98, 37353946231402992, 89664333, 89664335, 2, 640x360 
0x1382CA98, 37353946231723928, 89664367, 89664369, 2, 640x360 
0x1382CA98, 37353946232048800, 89664393, 89664402, 9, 640x360 
0x1382CA98, 37353946232397488, 89664427, 89664429, 2, 640x360 
0x1382CA98, 37353946232692360, 89664455, 89664458, 3, 640x360 
0x1382CA98, 37353946233007456, 89664487, 89664494, 7, 640x360 
0x1382CA98, 37353946233324224, 89664523, 89664532, 9, 640x360 
0x1382CA98, 37353946233644608, 89664566, 89664575, 9, 640x360 
0x1382CA98, 37353946233964024, 89664593, 89664595, 2, 640x360 
0x1382CA98, 37353946234289768, 89664622, 89664624, 2, 640x360 
0x1382CA98, 37353946234610784, 89664654, 89664657, 3, 640x360 
0x1382CA98, 37353946234924608, 89664688, 89664690, 2, 640x360 
0x1382CA98, 37353946235420736, 89664731, 89664740, 9, 640x360 
0x1382CA98, 37353946235722832, 89664764, 89664772, 8, 640x360 
0x1382CA98, 37353946236043032, 89664799, 89664802, 3, 640x360 
0x1382CA98, 37353946236363104, 89664821, 89664826, 5, 640x360 
0x1382CA98, 37353946236682920, 89664853, 89664855, 2, 640x360 
0x1382CA98, 37353946237004720, 89664899, 89664908, 9, 640x360 
0x1382CA98, 37353946237330720, 89664921, 89664923, 2, 640x360 
0x1382CA98, 37353946237649288, 89664968, 89664980, 12, 640x360 
0x1382CA98, 37353946237969744, 89664993, 89664999, 6, 640x360 
0x1382CA98, 37353946238284192, 89665013, 89665018, 5, 640x360 
0x1382CA98, 37353946238605272, 89665048, 89665056, 8, 640x360 
0x1382CA98, 37353946238930824, 89665084, 89665091, 7, 640x360 
0x1382CA98, 37353946239425160, 89665150, 89665156, 6, 640x360 
0x1382CA98, 37353946239724616, 89665163, 89665172, 9, 640x360 
0x1382CA98, 37353946240043128, 89665201, 89665211, 10, 640x360 
0x1382CA98, 37353946240386032, 89665237, 89665244, 7, 640x360 
0x1382CA98, 37353946240688592, 89665264, 89665266, 2, 640x360 
0x1382CA98, 37353946241002992, 89665288, 89665290, 2, 640x360 
0x1382CA98, 37353946241326040, 89665326, 89665329, 3, 640x360 
0x1382CA98, 37353946241643000, 89665357, 89665359, 2, 640x360 
0x1382CA98, 37353946241967888, 89665387, 89665389, 2, 640x360 
0x1382CA98, 37353946242286608, 89665422, 89665424, 2, 640x360 
0x1382CA98, 37353946242604288, 89665443, 89665448, 5, 640x360 
0x1382CA98, 37353946242924128, 89665476, 89665484, 8, 640x360 
0x1382CA98, 37353946243249280, 89665516, 89665519, 3, 640x360 
0x1382CA98, 37353946243725208, 89665569, 89665572, 3, 640x360 
0x1382CA98, 37353946244043912, 89665592, 89665594, 2, 640x360 
0x1382CA98, 37353946244368144, 89665628, 89665633, 5, 640x360 
0x1382CA98, 37353946244684728, 89665655, 89665661, 6, 640x360 
0x1382CA98, 37353946245032472, 89665690, 89665693, 3, 640x360 
0x1382CA98, 37353946245348200, 89665726, 89665729, 3, 640x360 
0x1382CA98, 37353946245657416, 89665760, 89665764, 4, 640x360 
0x1382CA98, 37353946245968496, 89665788, 89665794, 6, 640x360 
0x1382CA98, 37353946246288984, 89665824, 89665826, 2, 640x360 
0x1382CA98, 37353946246625352, 89665858, 89665860, 2, 640x360 
0x1382CA98, 37353946246975488, 89665890, 89665892, 2, 640x360 
0x1382CA98, 37353946247270696, 89665922, 89665927, 5, 640x360 
0x1382CA98, 37353946247722664, 89665959, 89665961, 2, 640x360 
0x1382CA98, 37353946248050984, 89666001, 89666004, 3, 640x360 
0x1382CA98, 37353946248365632, 89666031, 89666034, 3, 640x360 
0x1382CA98, 37353946248690992, 89666058, 89666060, 2, 640x360 
0x1382CA98, 37353946249007088, 89666093, 89666096, 3, 640x360 
0x1382CA98, 37353946249323272, 89666120, 89666126, 6, 640x360 
0x1382CA98, 37353946249643720, 89666155, 89666157, 2, 640x360 
0x1382CA98, 37353946249963176, 89666190, 89666192, 2, 640x360 
0x1382CA98, 37353946250282808, 89666220, 89666222, 2, 640x360 
0x1382CA98, 37353946250608208, 89666245, 89666258, 13, 640x360 
0x1382CA98, 37353946250930040, 89666287, 89666294, 7, 640x360 
0x1382CA98, 37353946251261264, 89666318, 89666321, 3, 640x360 
0x1382CA98, 37353946251722392, 89666364, 89666367, 3, 640x360 
0x1382CA98, 37353946252046608, 89666394, 89666397, 3, 640x360 
0x1382CA98, 37353946252363600, 89666425, 89666426, 1, 640x360 
0x1382CA98, 37353946252682768, 89666459, 89666461, 2, 640x360 
0x1382CA98, 37353946253007240, 89666485, 89666493, 8, 640x360 
0x1382CA98, 37353946253323392, 89666517, 89666521, 4, 640x360 
0x1382CA98, 37353946253643528, 89666544, 89666547, 3, 640x360 
0x1382CA98, 37353946253963832, 89666579, 89666590, 11, 640x360 
0x1382CA98, 37353946254283696, 89666610, 89666613, 3, 640x360 
0x1382CA98, 37353946254608128, 89666649, 89666657, 8, 640x360 
0x1382CA98, 37353946254930920, 89666686, 89666692, 6, 640x360 
0x1382CA98, 37353946255249512, 89666716, 89666720, 4, 640x360 
0x1382CA98, 37353946255722648, 89666762, 89666773, 11, 640x360 
0x1382CA98, 37353946256043296, 89666795, 89666801, 6, 640x360 
0x1382CA98, 37353946256365544, 89666824, 89666826, 2, 640x360 
0x1382CA98, 37353946256687744, 89666853, 89666856, 3, 640x360 
0x1382CA98, 37353946257006016, 89666885, 89666888, 3, 640x360 
0x1382CA98, 37353946257327152, 89666921, 89666927, 6, 640x360 
0x1382CA98, 37353946257669160, 89666967, 89666970, 3, 640x360 
0x1382CA98, 37353946257973224, 89666992, 89666994, 2, 640x360 
0x1382CA98, 37353946258284376, 89667017, 89667025, 8, 640x360 
0x1382CA98, 37353946258615072, 89667068, 89667072, 4, 640x360 
0x1382CA98, 37353946258926992, 89667088, 89667092, 4, 640x360 
0x1382CA98, 37353946259296104, 89667123, 89667125, 2, 640x360 
0x1382CA98, 37353946259722128, 89667167, 89667170, 3, 640x360 
0x1382CA98, 37353946260045056, 89667202, 89667205, 3, 640x360 
0x1382CA98, 37353946260362336, 89667226, 89667229, 3, 640x360 
0x1382CA98, 37353946260691368, 89667268, 89667270, 2, 640x360 
0x1382CA98, 37353946261008056, 89667295, 89667307, 12, 640x360 
0x1382CA98, 37353946261328408, 89667320, 89667322, 2, 640x360 
0x1382CA98, 37353946261643344, 89667346, 89667358, 12, 640x360 
0x1382CA98, 37353946261963248, 89667382, 89667388, 6, 640x360 
0x1382CA98, 37353946262283144, 89667416, 89667423, 7, 640x360 
0x1382CA98, 37353946262607424, 89667442, 89667446, 4, 640x360 
0x1382CA98, 37353946262932936, 89667477, 89667485, 8, 640x360 
0x1382CA98, 37353946263722216, 89667566, 89667573, 7, 640x360 
0x1382CA98, 37353946264046352, 89667599, 89667608, 9, 640x360 
0x1382CA98, 37353946264364216, 89667629, 89667635, 6, 640x360 
0x1382CA98, 37353946264682344, 89667654, 89667659, 5, 640x360 
0x1382CA98, 37353946265004424, 89667686, 89667692, 6, 640x360 
0x1382CA98, 37353946265332040, 89667720, 89667722, 2, 640x360 
0x1382CA98, 37353946265659968, 89667756, 89667758, 2, 640x360 
0x1382CA98, 37353946265983680, 89667789, 89667792, 3, 640x360 
0x1382CA98, 37353946266318272, 89667822, 89667824, 2, 640x360 
0x1382CA98, 37353946266610568, 89667852, 89667855, 3, 640x360 
0x1382CA98, 37353946266927888, 89667879, 89667884, 5, 640x360 
0x1382CA98, 37353946267245400, 89667908, 89667910, 2, 640x360 
0x1382CA98, 37353946267726536, 89667967, 89667970, 3, 640x360 
0x1382CA98, 37353946268053368, 89667993, 89667996, 3, 640x360 
0x1382CA98, 37353946268391272, 89668025, 89668028, 3, 640x360 
0x1382CA98, 37353946268686592, 89668058, 89668059, 1, 640x360 
0x1382CA98, 37353946269008080, 89668090, 89668091, 1, 640x360 
0x1382CA98, 37353946269329240, 89668117, 89668125, 8, 640x360 
0x1382CA98, 37353946269649472, 89668160, 89668163, 3, 640x360 
0x1382CA98, 37353946269985208, 89668193, 89668195, 2, 640x360 
0x1382CA98, 37353946270297048, 89668222, 89668224, 2, 640x360 
0x1382CA98, 37353946270603232, 89668251, 89668257, 6, 640x360 
0x1382CA98, 37353946270934344, 89668282, 89668289, 7, 640x360 
0x1382CA98, 37353946271247824, 89668315, 89668322, 7, 640x360 
0x1382CA98, 37353946271568272, 89668344, 89668348, 4, 640x360 
0x1382CA98, 37353946272042040, 89668399, 89668407, 8, 640x360 
0x1382CA98, 37353946272362704, 89668429, 89668438, 9, 640x360 
0x1382CA98, 37353946272686744, 89668462, 89668467, 5, 640x360 
0x1382CA98, 37353946273007744, 89668485, 89668488, 3, 640x360 
0x1382CA98, 37353946273326328, 89668523, 89668531, 8, 640x360 
0x1382CA98, 37353946273642392, 89668552, 89668559, 7, 640x360 
0x1382CA98, 37353946273962808, 89668593, 89668595, 2, 640x360 
0x1382CA98, 37353946274286896, 89668611, 89668615, 4, 640x360 
0x1382CA98, 37353946274606776, 89668644, 89668653, 9, 640x360 
0x1382CA98, 37353946274937536, 89668677, 89668680, 3, 640x360 
0x1382CA98, 37353946275246312, 89668717, 89668723, 6, 640x360 
0x1382CA98, 37353946275562872, 89668749, 89668756, 7, 640x360 
0x1382CA98, 37353946276042480, 89668800, 89668803, 3, 640x360 
0x1382CA98, 37353946276366024, 89668821, 89668828, 7, 640x360 
0x1382CA98, 37353946276686792, 89668861, 89668864, 3, 640x360 
0x1382CA98, 37353946277027248, 89668900, 89668906, 6, 640x360 
0x1382CA98, 37353946277327728, 89668936, 89668943, 7, 640x360 
0x1382CA98, 37353946277643392, 89668957, 89668961, 4, 640x360 
0x1382CA98, 37353946277967112, 89668994, 89668996, 2, 640x360 
0x1382CA98, 37353946278290616, 89669016, 89669019, 3, 640x360 
0x1382CA98, 37353946278607376, 89669041, 89669044, 3, 640x360 
0x1382CA98, 37353946278922752, 89669073, 89669076, 3, 640x360 
0x1382CA98, 37353946279270752, 89669114, 89669116, 2, 640x360 
0x1382CA98, 37353946279582216, 89669155, 89669158, 3, 640x360 
0x1382CA98, 37353946280042552, 89669203, 89669205, 2, 640x360 
0x1382CA98, 37353946280366832, 89669231, 89669234, 3, 640x360 
0x1382CA98, 37353946280682584, 89669262, 89669265, 3, 640x360 
0x1382CA98, 37353946281007512, 89669295, 89669299, 4, 640x360 
0x1382CA98, 37353946281322952, 89669322, 89669327, 5, 640x360 
0x1382CA98, 37353946281644912, 89669355, 89669362, 7, 640x360 
0x1382CA98, 37353946281962072, 89669387, 89669389, 2, 640x360 
0x1382CA98, 37353946282287344, 89669419, 89669427, 8, 640x360 
0x1382CA98, 37353946282608568, 89669451, 89669454, 3, 640x360 
0x1382CA98, 37353946282928968, 89669478, 89669485, 7, 640x360 
0x1382CA98, 37353946283250552, 89669511, 89669518, 7, 640x360 
0x1382CA98, 37353946283588672, 89669544, 89669555, 11, 640x360 
0x1382CA98, 37353946284045880, 89669597, 89669605, 8, 640x360 
0x1382CA98, 37353946284362544, 89669621, 89669626, 5, 640x360 
0x1382CA98, 37353946284686520, 89669654, 89669656, 2, 640x360 
0x1382CA98, 37353946285013536, 89669686, 89669690, 4, 640x360 
0x1382CA98, 37353946285325112, 89669717, 89669720, 3, 640x360 
0x1382CA98, 37353946285642648, 89669755, 89669757, 2, 640x360 
0x1382CA98, 37353946285966552, 89669780, 89669785, 5, 640x360 
0x1382CA98, 37353946286282096, 89669812, 89669817, 5, 640x360 
0x1382CA98, 37353946286602672, 89669845, 89669849, 4, 640x360 
0x1382CA98, 37353946286923000, 89669876, 89669879, 3, 640x360 
0x1382CA98, 37353946287250280, 89669917, 89669920, 3, 640x360 
0x1382CA98, 37353946287591280, 89669943, 89669946, 3, 640x360 
0x1382CA98, 37353946288046248, 89669995, 89670000, 5, 640x360 
0x1382CA98, 37353946288366720, 89670030, 89670036, 6, 640x360 
0x1382CA98, 37353946288687824, 89670057, 89670063, 6, 640x360 
0x1382CA98, 37353946289005456, 89670093, 89670099, 6, 640x360 
0x1382CA98, 37353946289323840, 89670123, 89670125, 2, 640x360 
0x1382CA98, 37353946289667048, 89670156, 89670158, 2, 640x360 
0x1382CA98, 37353946289980664, 89670193, 89670200, 7, 640x360 
0x1382CA98, 37353946290304712, 89670223, 89670225, 2, 640x360 
0x1382CA98, 37353946290601896, 89670253, 89670258, 5, 640x360 
0x1382CA98, 37353946290935832, 89670283, 89670286, 3, 640x360 
0x1382CA98, 37353946291249640, 89670307, 89670309, 2, 640x360 
0x1382CA98, 37353946291563272, 89670343, 89670346, 3, 640x360 
0x1382CA98, 37353946292042088, 89670397, 89670407, 10, 640x360 
0x1382CA98, 37353946292362008, 89670433, 89670442, 9, 640x360 
0x1382CA98, 37353946292690224, 89670454, 89670457, 3, 640x360 
0x1382CA98, 37353946293001880, 89670493, 89670495, 2, 640x360 
0x1382CA98, 37353946293323376, 89670516, 89670525, 9, 640x360 
0x1382CA98, 37353946293641824, 89670553, 89670560, 7, 640x360 
0x1382CA98, 37353946293961920, 89670582, 89670591, 9, 640x360 
0x1382CA98, 37353946294282824, 89670617, 89670623, 6, 640x360 
0x1382CA98, 37353946294604112, 89670643, 89670647, 4, 640x360 
0x1382CA98, 37353946294922048, 89670676, 89670677, 1, 640x360 
0x1382CA98, 37353946295247096, 89670720, 89670722, 2, 640x360 
0x1382CA98, 37353946295562416, 89670749, 89670752, 3, 640x360 
0x1382CA98, 37353946296041712, 89670793, 89670796, 3, 640x360 
0x1382CA98, 37353946296361480, 89670821, 89670825, 4, 640x360 
0x1382CA98, 37353946296686112, 89670859, 89670861, 2, 640x360 
0x1382CA98, 37353946297003712, 89670888, 89670894, 6, 640x360 
0x1382CA98, 37353946297333624, 89670919, 89670922, 3, 640x360 
0x1382CA98, 37353946297651688, 89670953, 89670960, 7, 640x360 
0x1382CA98, 37353946297962248, 89670983, 89670986, 3, 640x360 
0x1382CA98, 37353946298287504, 89671014, 89671022, 8, 640x360 
0x1382CA98, 37353946298614328, 89671045, 89671052, 7, 640x360 
0x1382CA98, 37353946298922752, 89671074, 89671076, 2, 640x360 
0x1382CA98, 37353946299245576, 89671118, 89671120, 2, 640x360 
0x1382CA98, 37353946299568816, 89671144, 89671147, 3, 640x360 
0x1382CA98, 37353946300361656, 89671221, 89671223, 2, 640x360 
0x1382CA98, 37353946300684880, 89671255, 89671257, 2, 640x360 
0x1382CA98, 37353946301004800, 89671287, 89671290, 3, 640x360 
0x1382CA98, 37353946301321904, 89671322, 89671328, 6, 640x360 
0x1382CA98, 37353946301646464, 89671348, 89671351, 3, 640x360 
0x1382CA98, 37353946301962552, 89671381, 89671385, 4, 640x360 
0x1382CA98, 37353946302281928, 89671411, 89671414, 3, 640x360 
0x1382CA98, 37353946302602296, 89671443, 89671446, 3, 640x360 
0x1382CA98, 37353946302929048, 89671474, 89671476, 2, 640x360 
0x1382CA98, 37353946303254792, 89671510, 89671512, 2, 640x360 
0x1382CA98, 37353946303562224, 89671541, 89671543, 2, 640x360 
0x1382CA98, 37353946303882776, 89671572, 89671574, 2, 640x360 
0x1382CA98, 37353946304362224, 89671619, 89671622, 3, 640x360 
0x1382CA98, 37353946304681584, 89671655, 89671660, 5, 640x360 
0x1382CA98, 37353946305005496, 89671687, 89671689, 2, 640x360 
0x1382CA98, 37353946305322152, 89671718, 89671721, 3, 640x360 
0x1382CA98, 37353946305642376, 89671749, 89671753, 4, 640x360 
0x1382CA98, 37353946305962328, 89671780, 89671787, 7, 640x360 
0x1382CA98, 37353946306282312, 89671811, 89671817, 6, 640x360 
0x1382CA98, 37353946306601808, 89671842, 89671847, 5, 640x360 
0x1382CA98, 37353946306922344, 89671878, 89671883, 5, 640x360 
0x1382CA98, 37353946307242576, 89671909, 89671912, 3, 640x360 
0x1382CA98, 37353946307563032, 89671941, 89671943, 2, 640x360 
0x1382CA98, 37353946307882528, 89671970, 89671973, 3, 640x360 
0x1382CA98, 37353946308362072, 89672018, 89672021, 3, 640x360 
0x1382CA98, 37353946308687128, 89672054, 89672056, 2, 640x360 
0x1382CA98, 37353946309002224, 89672085, 89672092, 7, 640x360 
0x1382CA98, 37353946309321992, 89672119, 89672122, 3, 640x360 
0x1382CA98, 37353946309650312, 89672150, 89672154, 4, 640x360 
0x1382CA98, 37353946309969416, 89672182, 89672187, 5, 640x360 
0x1382CA98, 37353946310281768, 89672214, 89672216, 2, 640x360 
0x1382CA98, 37353946310605056, 89672245, 89672249, 4, 640x360 
0x1382CA98, 37353946310926296, 89672283, 89672286, 3, 640x360 
0x1382CA98, 37353946311249344, 89672320, 89672323, 3, 640x360 
0x1382CA98, 37353946311593640, 89672348, 89672351, 3, 640x360 
0x1382CA98, 37353946311888000, 89672374, 89672377, 3, 640x360 
0x1382CA98, 37353946312361064, 89672427, 89672429, 2, 640x360 
0x1382CA98, 37353946312684928, 89672454, 89672456, 2, 640x360 
0x1382CA98, 37353946313006256, 89672489, 89672492, 3, 640x360 
0x1382CA98, 37353946313325944, 89672520, 89672522, 2, 640x360 
0x1382CA98, 37353946313645856, 89672555, 89672557, 2, 640x360 
0x1382CA98, 37353946313965832, 89672582, 89672586, 4, 640x360 
0x1382CA98, 37353946314284712, 89672613, 89672615, 2, 640x360 
0x1382CA98, 37353946314601016, 89672646, 89672655, 9, 640x360 
0x1382CA98, 37353946314924288, 89672685, 89672688, 3, 640x360 
0x1382CA98, 37353946315286800, 89672719, 89672723, 4, 640x360 
0x1382CA98, 37353946315568920, 89672750, 89672762, 12, 640x360 
0x1382CA98, 37353946315888360, 89672787, 89672790, 3, 640x360 
0x1382CA98, 37353946316364176, 89672824, 89672827, 3, 640x360 
0x1382CA98, 37353946316686176, 89672868, 89672870, 2, 640x360 
0x1382CA98, 37353946317004600, 89672891, 89672897, 6, 640x360 
0x1382CA98, 37353946317324736, 89672922, 89672924, 2, 640x360 
0x1382CA98, 37353946317646224, 89672948, 89672952, 4, 640x360 
0x1382CA98, 37353946317968576, 89672988, 89672991, 3, 640x360 
0x1382CA98, 37353946318280984, 89673012, 89673018, 6, 640x360 
0x1382CA98, 37353946318611648, 89673043, 89673046, 3, 640x360 
0x1382CA98, 37353946318938232, 89673077, 89673080, 3, 640x360 
0x1382CA98, 37353946319259488, 89673111, 89673116, 5, 640x360 
0x1382CA98, 37353946319561104, 89673143, 89673149, 6, 640x360 
0x1382CA98, 37353946319881856, 89673179, 89673184, 5, 640x360 
0x1382CA98, 37353946320362216, 89673228, 89673233, 5, 640x360 
0x1382CA98, 37353946320681528, 89673252, 89673259, 7, 640x360 
0x1382CA98, 37353946321007048, 89673288, 89673294, 6, 640x360 
0x1382CA98, 37353946321338360, 89673322, 89673325, 3, 640x360 
0x1382CA98, 37353946321668072, 89673365, 89673371, 6, 640x360 
0x1382CA98, 37353946321967264, 89673379, 89673386, 7, 640x360 
0x1382CA98, 37353946322285416, 89673417, 89673424, 7, 640x360 
0x1382CA98, 37353946322624680, 89673457, 89673464, 7, 640x360 
0x1382CA98, 37353946322921768, 89673484, 89673492, 8, 640x360 
0x1382CA98, 37353946323253600, 89673520, 89673527, 7, 640x360 
0x1382CA98, 37353946323560968, 89673551, 89673553, 2, 640x360 
0x1382CA98, 37353946323880952, 89673583, 89673591, 8, 640x360 
0x1382CA98, 37353946324204880, 89673612, 89673617, 5, 640x360 
0x1382CA98, 37353946324680336, 89673661, 89673663, 2, 640x360 
0x1382CA98, 37353946325001712, 89673688, 89673694, 6, 640x360 
0x1382CA98, 37353946325330904, 89673727, 89673730, 3, 640x360 
0x1382CA98, 37353946325648456, 89673756, 89673758, 2, 640x360 
0x1382CA98, 37353946325968872, 89673781, 89673786, 5, 640x360 
0x1382CA98, 37353946326284616, 89673812, 89673821, 9, 640x360 
0x1382CA98, 37353946326602736, 89673851, 89673854, 3, 640x360 
0x1382CA98, 37353946326927904, 89673882, 89673891, 9, 640x360 
0x1382CA98, 37353946327241872, 89673919, 89673926, 7, 640x360 
0x1382CA98, 37353946327562712, 89673952, 89673960, 8, 640x360 
0x1382CA98, 37353946327881168, 89673977, 89673981, 4, 640x360 
0x1382CA98, 37353946328201248, 89674013, 89674023, 10, 640x360 
0x1382CA98, 37353946328685872, 89674053, 89674058, 5, 640x360 
0x1382CA98, 37353946329001216, 89674100, 89674108, 8, 640x360 
0x1382CA98, 37353946329323824, 89674121, 89674135, 14, 640x360 
0x1382CA98, 37353946329640432, 89674157, 89674166, 9, 640x360 
0x1382CA98, 37353946329960928, 89674180, 89674188, 8, 640x360 
0x1382CA98, 37353946330281072, 89674213, 89674218, 5, 640x360 
0x1382CA98, 37353946330607248, 89674246, 89674252, 6, 640x360 
0x1382CA98, 37353946330927640, 89674290, 89674292, 2, 640x360 
0x1382CA98, 37353946331258960, 89674312, 89674325, 13, 640x360 
0x1382CA98, 37353946331565488, 89674354, 89674356, 2, 640x360 
0x1382CA98, 37353946331885984, 89674374, 89674377, 3, 640x360 
0x1382CA98, 37353946332201696, 89674406, 89674410, 4, 640x360 
0x1382CA98, 37353946332684528, 89674454, 89674457, 3, 640x360 
0x1382CA98, 37353946333005392, 89674490, 89674492, 2, 640x360 
0x1382CA98, 37353946333321176, 89674527, 89674530, 3, 640x360 
0x1382CA98, 37353946333645112, 89674551, 89674555, 4, 640x360 
0x1382CA98, 37353946333965824, 89674583, 89674587, 4, 640x360 
0x1382CA98, 37353946334281216, 89674623, 89674625, 2, 640x360 
0x1382CA98, 37353946334606456, 89674648, 89674652, 4, 640x360 
0x1382CA98, 37353946334930152, 89674682, 89674685, 3, 640x360 
0x1382CA98, 37353946335261784, 89674714, 89674719, 5, 640x360 
0x1382CA98, 37353946335565344, 89674747, 89674759, 12, 640x360 
0x1382CA98, 37353946335882400, 89674784, 89674787, 3, 640x360 
0x1382CA98, 37353946336219744, 89674813, 89674818, 5, 640x360 
0x1382CA98, 37353946336684488, 89674858, 89674863, 5, 640x360 
0x1382CA98, 37353946337004432, 89674890, 89674895, 5, 640x360 
0x1382CA98, 37353946337320600, 89674916, 89674919, 3, 640x360 
0x1382CA98, 37353946337640664, 89674945, 89674948, 3, 640x360 
0x1382CA98, 37353946337961584, 89674980, 89674991, 11, 640x360 
0x1382CA98, 37353946338284048, 89675011, 89675015, 4, 640x360 
0x1382CA98, 37353946338604448, 89675054, 89675062, 8, 640x360 
0x1382CA98, 37353946338921448, 89675076, 89675079, 3, 640x360 
0x1382CA98, 37353946339246064, 89675108, 89675111, 3, 640x360 
0x1382CA98, 37353946339561920, 89675142, 89675145, 3, 640x360 
0x1382CA98, 37353946339881592, 89675176, 89675178, 2, 640x360 
0x1382CA98, 37353946340206456, 89675205, 89675207, 2, 640x360 
0x1382CA98, 37353946340680360, 89675259, 89675262, 3, 640x360 
0x1382CA98, 37353946341007784, 89675296, 89675301, 5, 640x360 
0x1382CA98, 37353946341344056, 89675334, 89675336, 2, 640x360 
0x1382CA98, 37353946341641816, 89675356, 89675358, 2, 640x360 
0x1382CA98, 37353946341965744, 89675386, 89675388, 2, 640x360 
0x1382CA98, 37353946342285944, 89675416, 89675423, 7, 640x360 
0x1382CA98, 37353946342613048, 89675449, 89675458, 9, 640x360 
0x1382CA98, 37353946342927176, 89675483, 89675490, 7, 640x360 
0x1382CA98, 37353946343241984, 89675515, 89675518, 3, 640x360 
0x1382CA98, 37353946343560584, 89675544, 89675546, 2, 640x360 
0x1382CA98, 37353946343881104, 89675579, 89675583, 4, 640x360 
0x1382CA98, 37353946344205136, 89675612, 89675614, 2, 640x360 
0x1382CA98, 37353946344683352, 89675662, 89675666, 4, 640x360 
0x1382CA98, 37353946345005704, 89675685, 89675687, 2, 640x360 
0x1382CA98, 37353946345326264, 89675727, 89675731, 4, 640x360 
0x1382CA98, 37353946345640688, 89675754, 89675756, 2, 640x360 
0x1382CA98, 37353946345965456, 89675788, 89675790, 2, 640x360 
0x1382CA98, 37353946346284544, 89675812, 89675835, 23, 640x360 
0x1382CA98, 37353946346611296, 89675846, 89675858, 12, 640x360 
0x1382CA98, 37353946346930512, 89675877, 89675882, 5, 640x360 
0x1382CA98, 37353946347246792, 89675909, 89675918, 9, 640x360 
0x1382CA98, 37353946347560960, 89675945, 89675948, 3, 640x360 
0x1382CA98, 37353946347881160, 89675974, 89675977, 3, 640x360 
0x1382CA98, 37353946348200472, 89676008, 89676010, 2, 640x360 
0x1382CA98, 37353946348679680, 89676060, 89676062, 2, 640x360 
0x1382CA98, 37353946349000216, 89676095, 89676098, 3, 640x360 
0x1382CA98, 37353946349322712, 89676129, 89676134, 5, 640x360 
0x1382CA98, 37353946349640272, 89676157, 89676159, 2, 640x360 
0x1382CA98, 37353946349963512, 89676189, 89676191, 2, 640x360 
0x1382CA98, 37353946350285176, 89676219, 89676221, 2, 640x360 
0x1382CA98, 37353946350600624, 89676250, 89676253, 3, 640x360 
0x1382CA98, 37353946350930504, 89676278, 89676280, 2, 640x360 
0x1382CA98, 37353946351241232, 89676316, 89676319, 3, 640x360 
0x1382CA98, 37353946351565376, 89676351, 89676354, 3, 640x360 
0x1382CA98, 37353946351885848, 89676375, 89676377, 2, 640x360 
0x1382CA98, 37353946352215744, 89676421, 89676428, 7, 640x360 
0x1382CA98, 37353946352525040, 89676439, 89676443, 4, 640x360 
0x1382CA98, 37353946353000288, 89676494, 89676496, 2, 640x360 
0x1382CA98, 37353946353327592, 89676526, 89676536, 10, 640x360 
0x1382CA98, 37353946353643464, 89676554, 89676557, 3, 640x360 
0x1382CA98, 37353946353966312, 89676593, 89676595, 2, 640x360 
0x1382CA98, 37353946354285256, 89676611, 89676615, 4, 640x360 
0x1382CA98, 37353946354600920, 89676643, 89676646, 3, 640x360 
0x1382CA98, 37353946354926888, 89676680, 89676688, 8, 640x360 
0x1382CA98, 37353946355245400, 89676708, 89676711, 3, 640x360 
0x1382CA98, 37353946355560552, 89676742, 89676745, 3, 640x360 
0x1382CA98, 37353946355886864, 89676774, 89676776, 2, 640x360 
0x1382CA98, 37353946356213768, 89676811, 89676813, 2, 640x360 
0x1382CA98, 37353946356526936, 89676837, 89676840, 3, 640x360 
0x1382CA98, 37353946357003912, 89676885, 89676891, 6, 640x360 
0x1382CA98, 37353946357320776, 89676916, 89676921, 5, 640x360 
0x1382CA98, 37353946357641304, 89676949, 89676955, 6, 640x360 
0x1382CA98, 37353946357976672, 89676988, 89676994, 6, 640x360 
0x1382CA98, 37353946358281296, 89677019, 89677034, 15, 640x360 
0x1382CA98, 37353946358606664, 89677053, 89677060, 7, 640x360 
0x1382CA98, 37353946358939248, 89677080, 89677089, 9, 640x360 
0x1382CA98, 37353946359253552, 89677118, 89677126, 8, 640x360 
0x1382CA98, 37353946359564312, 89677151, 89677162, 11, 640x360 
0x1382CA98, 37353946359886888, 89677183, 89677194, 11, 640x360 
0x1382CA98, 37353946360217760, 89677216, 89677218, 2, 640x360 
0x1382CA98, 37353946360530920, 89677249, 89677251, 2, 640x360 
0x1382CA98, 37353946361003728, 89677295, 89677298, 3, 640x360 
0x1382CA98, 37353946361327264, 89677328, 89677331, 3, 640x360 
0x1382CA98, 37353946361645720, 89677361, 89677363, 2, 640x360 
0x1382CA98, 37353946361964320, 89677382, 89677394, 12, 640x360 
0x1382CA98, 37353946362280624, 89677415, 89677423, 8, 640x360 
0x1382CA98, 37353946362601680, 89677451, 89677456, 5, 640x360 
0x1382CA98, 37353946362925568, 89677482, 89677492, 10, 640x360 
0x1382CA98, 37353946363253536, 89677525, 89677527, 2, 640x360 
0x1382CA98, 37353946363562320, 89677549, 89677558, 9, 640x360 
0x1382CA98, 37353946363882296, 89677590, 89677594, 4, 640x360 
0x1382CA98, 37353946364220096, 89677618, 89677627, 9, 640x360 
0x1382CA98, 37353946364527552, 89677644, 89677650, 6, 640x360 
0x1382CA98, 37353946364999992, 89677696, 89677700, 4, 640x360 
0x1382CA98, 37353946365323848, 89677724, 89677731, 7, 640x360 
0x1382CA98, 37353946365640264, 89677757, 89677763, 6, 640x360 
0x1382CA98, 37353946365959664, 89677778, 89677781, 3, 640x360 
0x1382CA98, 37353946366279608, 89677816, 89677824, 8, 640x360 
0x1382CA98, 37353946366607768, 89677853, 89677861, 8, 640x360 
0x1382CA98, 37353946366930968, 89677877, 89677882, 5, 640x360 
0x1382CA98, 37353946367242344, 89677911, 89677914, 3, 640x360 
0x1382CA98, 37353946367564712, 89677943, 89677945, 2, 640x360 
0x1382CA98, 37353946367881192, 89677977, 89677980, 3, 640x360 
0x1382CA98, 37353946368204896, 89678008, 89678010, 2, 640x360 
0x1382CA98, 37353946368523096, 89678043, 89678045, 2, 640x360 
0x1382CA98, 37353946369000080, 89678086, 89678092, 6, 640x360 
0x1382CA98, 37353946369320072, 89678134, 89678143, 9, 640x360 
0x1382CA98, 37353946369666832, 89678162, 89678173, 11, 640x360 
0x1382CA98, 37353946370022240, 89678199, 89678206, 7, 640x360 
0x1382CA98, 37353946370293248, 89678223, 89678225, 2, 640x360 
0x1382CA98, 37353946370621848, 89678257, 89678260, 3, 640x360 
0x1382CA98, 37353946370936872, 89678287, 89678289, 2, 640x360 
0x1382CA98, 37353946371308312, 89678327, 89678330, 3, 640x360 
0x1382CA98, 37353946371572776, 89678369, 89678385, 16, 640x360 
0x1382CA98, 37353946371898016, 89678386, 89678390, 4, 640x360 
0x1382CA98, 37353946372207792, 89678455, 89678461, 6, 640x360 
0x1382CA98, 37353946373035616, 89678523, 89678530, 7, 640x360 
0x1382CA98, 37353946373359248, 89678531, 89678543, 12, 640x360 
0x1382CA98, 37353946373660920, 89678568, 89678587, 19, 640x360 
0x1382CA98, 37353946373986392, 89678591, 89678601, 10, 640x360 
0x1382CA98, 37353946374287056, 89678614, 89678632, 18, 640x360 
0x1382CA98, 37353946374612104, 89678656, 89678659, 3, 640x360 
0x1382CA98, 37353946374938112, 89678690, 89678693, 3, 640x360 
0x1382CA98, 37353946375247072, 89678720, 89678737, 17, 640x360 
0x1382CA98, 37353946375636344, 89678760, 89678764, 4, 640x360 
0x1382CA98, 37353946375891064, 89678788, 89678791, 3, 640x360 
0x1382CA98, 37353946376201120, 89678824, 89678829, 5, 640x360 
0x1382CA98, 37353946376522944, 89678844, 89678861, 17, 640x360 
0x1382CA98, 37353946377006016, 89678904, 89678910, 6, 640x360 
0x1382CA98, 37353946377337112, 89678939, 89678946, 7, 640x360 
0x1382CA98, 37353946377696888, 89679034, 89679043, 9, 640x360 
0x1382CA98, 37353946378352616, 89679043, 89679070, 27, 640x360 
0x1382CA98, 37353946378649088, 89679079, 89679099, 20, 640x360 
0x1382CA98, 37353946378965512, 89679120, 89679154, 34, 640x360 
0x1382CA98, 37353946379274520, 89679162, 89679189, 27, 640x360 
0x1382CA98, 37353946379605168, 89679201, 89679217, 16, 640x360 
0x1382CA98, 37353946380216856, 89679238, 89679249, 11, 640x360 
0x1382CA98, 37353946380537960, 89679267, 89679270, 3, 640x360 
0x1382CA98, 37353946380846832, 89679279, 89679290, 11, 640x360 
0x1382CA98, 37353946381337072, 89679341, 89679343, 2, 640x360 
0x1382CA98, 37353946381644304, 89679362, 89679368, 6, 640x360 
0x1382CA98, 37353946381960240, 89679390, 89679392, 2, 640x360 
0x1382CA98, 37353946382283320, 89679428, 89679431, 3, 640x360 
0x1382CA98, 37353946382606688, 89679452, 89679458, 6, 640x360 
0x1382CA98, 37353946382932696, 89679476, 89679478, 2, 640x360 
0x1382CA98, 37353946383243312, 89679513, 89679517, 4, 640x360 
0x1382CA98, 37353946383562728, 89679545, 89679548, 3, 640x360 
0x1382CA98, 37353946383889056, 89679583, 89679586, 3, 640x360 
0x1382CA98, 37353946384204016, 89679608, 89679610, 2, 640x360 
0x1382CA98, 37353946384522024, 89679644, 89679648, 4, 640x360 
0x1382CA98, 37353946384843928, 89679671, 89679680, 9, 640x360 
0x1382CA98, 37353946385325256, 89679725, 89679734, 9, 640x360 
0x1382CA98, 37353946385639488, 89679757, 89679760, 3, 640x360 
0x1382CA98, 37353946386000376, 89679794, 89679798, 4, 640x360 
0x1382CA98, 37353946386292984, 89679830, 89679843, 13, 640x360 
0x1382CA98, 37353946386614296, 89679856, 89679858, 2, 640x360 
0x1382CA98, 37353946386937616, 89679901, 89679910, 9, 640x360 
0x1382CA98, 37353946387259480, 89679924, 89679933, 9, 640x360 
0x1382CA98, 37353946387560384, 89679947, 89679955, 8, 640x360 
0x1382CA98, 37353946387883728, 89679999, 89680002, 3, 640x360 
0x1382CA98, 37353946388213216, 89680020, 89680022, 2, 640x360 
0x1382CA98, 37353946388519320, 89680042, 89680053, 11, 640x360 
0x1382CA98, 37353946388849800, 89680079, 89680085, 6, 640x360 
0x1382CA98, 37353946389323704, 89680134, 89680137, 3, 640x360 
0x1382CA98, 37353946389639264, 89680148, 89680161, 13, 640x360 
0x1382CA98, 37353946389983512, 89680189, 89680196, 7, 640x360 
0x1382CA98, 37353946390286136, 89680216, 89680219, 3, 640x360 
0x1382CA98, 37353946390607984, 89680249, 89680258, 9, 640x360 
0x1382CA98, 37353946390933184, 89680292, 89680298, 6, 640x360 
0x1382CA98, 37353946391239800, 89680319, 89680322, 3, 640x360 
0x1382CA98, 37353946391558912, 89680349, 89680353, 4, 640x360 
0x1382CA98, 37353946391880552, 89680373, 89680375, 2, 640x360 
0x1382CA98, 37353946392204280, 89680413, 89680419, 6, 640x360 
0x1382CA98, 37353946392534112, 89680453, 89680455, 2, 640x360 
0x1382CA98, 37353946392839192, 89680470, 89680473, 3, 640x360 
0x1382CA98, 37353946393320560, 89680518, 89680521, 3, 640x360 
0x1382CA98, 37353946393643008, 89680549, 89680558, 9, 640x360 
0x1382CA98, 37353946393960248, 89680598, 89680603, 5, 640x360 
0x1382CA98, 37353946394287656, 89680622, 89680625, 3, 640x360 
0x1382CA98, 37353946394603936, 89680644, 89680646, 2, 640x360 
0x1382CA98, 37353946394928208, 89680686, 89680689, 3, 640x360 
0x1382CA98, 37353946395242192, 89680717, 89680720, 3, 640x360 
0x1382CA98, 37353946395564248, 89680742, 89680745, 3, 640x360 
0x1382CA98, 37353946395897008, 89680783, 89680785, 2, 640x360 
0x1382CA98, 37353946396206416, 89680817, 89680819, 2, 640x360 
0x1382CA98, 37353946396519016, 89680840, 89680848, 8, 640x360 
0x1382CA98, 37353946396842840, 89680871, 89680880, 9, 640x360 
0x1382CA98, 37353946397329656, 89680922, 89680925, 3, 640x360 
0x1382CA98, 37353946397639344, 89680955, 89680957, 2, 640x360 
0x1382CA98, 37353946397984720, 89680987, 89680990, 3, 640x360 
0x1382CA98, 37353946398282464, 89681017, 89681027, 10, 640x360 
0x1382CA98, 37353946398620320, 89681060, 89681063, 3, 640x360 
0x1382CA98, 37353946398923104, 89681084, 89681087, 3, 640x360 
0x1382CA98, 37353946399242608, 89681119, 89681122, 3, 640x360 
0x1382CA98, 37353946399558648, 89681143, 89681154, 11, 640x360 
0x1382CA98, 37353946399879272, 89681177, 89681182, 5, 640x360 
0x1382CA98, 37353946400230816, 89681220, 89681222, 2, 640x360 
0x1382CA98, 37353946400528192, 89681243, 89681246, 3, 640x360 
0x1382CA98, 37353946400853912, 89681278, 89681293, 15, 640x360 
0x1382CA98, 37353946401411216, 89681325, 89681327, 2, 640x360 
0x1382CA98, 37353946401647368, 89681363, 89681367, 4, 640x360 
0x1382CA98, 37353946401958904, 89681386, 89681392, 6, 640x360 
0x1382CA98, 37353946402283264, 89681413, 89681427, 14, 640x360 
0x1382CA98, 37353946402615080, 89681451, 89681453, 2, 640x360 
0x1382CA98, 37353946402931552, 89681476, 89681478, 2, 640x360 
0x1382CA98, 37353946403241880, 89681517, 89681519, 2, 640x360 
0x1382CA98, 37353946403558920, 89681548, 89681551, 3, 640x360 
0x1382CA98, 37353946403883992, 89681576, 89681578, 2, 640x360 
0x1382CA98, 37353946404209824, 89681604, 89681607, 3, 640x360 
0x1382CA98, 37353946404519768, 89681637, 89681640, 3, 640x360 
0x1382CA98, 37353946404839744, 89681675, 89681677, 2, 640x360 
0x1382CA98, 37353946405160096, 89681703, 89681708, 5, 640x360 
0x1382CA98, 37353946405639424, 89681748, 89681756, 8, 640x360 
0x1382CA98, 37353946405959464, 89681782, 89681788, 6, 640x360 
0x1382CA98, 37353946406278976, 89681808, 89681810, 2, 640x360 
0x1382CA98, 37353946406605688, 89681845, 89681851, 6, 640x360 
0x1382CA98, 37353946406923688, 89681884, 89681889, 5, 640x360 
0x1382CA98, 37353946407255560, 89681917, 89681926, 9, 640x360 
0x1382CA98, 37353946407621752, 89681956, 89681959, 3, 640x360 
0x1382CA98, 37353946407879960, 89681999, 89682003, 4, 640x360 
0x1382CA98, 37353946408213000, 89682020, 89682023, 3, 640x360 
0x1382CA98, 37353946408531160, 89682042, 89682044, 2, 640x360 
0x1382CA98, 37353946408857880, 89682080, 89682084, 4, 640x360 
0x1382CA98, 37353946409182104, 89682110, 89682113, 3, 640x360 
0x1382CA98, 37353946409638896, 89682145, 89682148, 3, 640x360 
0x1382CA98, 37353946409959008, 89682189, 89682192, 3, 640x360 
0x1382CA98, 37353946410278784, 89682211, 89682215, 4, 640x360 
0x1382CA98, 37353946410603520, 89682243, 89682245, 2, 640x360 
0x1382CA98, 37353946410925456, 89682277, 89682279, 2, 640x360 
0x1382CA98, 37353946411240976, 89682309, 89682312, 3, 640x360 
0x1382CA98, 37353946411565576, 89682348, 89682356, 8, 640x360 
0x1382CA98, 37353946411879896, 89682385, 89682387, 2, 640x360 
0x1382CA98, 37353946412202864, 89682424, 89682427, 3, 640x360 
0x1382CA98, 37353946412519848, 89682446, 89682459, 13, 640x360 
0x1382CA98, 37353946412847872, 89682477, 89682482, 5, 640x360 
0x1382CA98, 37353946413170368, 89682507, 89682510, 3, 640x360 
0x1382CA98, 37353946413657584, 89682554, 89682559, 5, 640x360 
0x1382CA98, 37353946413962680, 89682590, 89682593, 3, 640x360 
0x1382CA98, 37353946414325840, 89682625, 89682628, 3, 640x360 
0x1382CA98, 37353946414603144, 89682655, 89682657, 2, 640x360 
0x1382CA98, 37353946414920720, 89682680, 89682689, 9, 640x360 
0x1382CA98, 37353946415241960, 89682722, 89682724, 2, 640x360 
0x1382CA98, 37353946415559136, 89682749, 89682751, 2, 640x360 
0x1382CA98, 37353946415878528, 89682778, 89682780, 2, 640x360 
0x1382CA98, 37353946416204448, 89682809, 89682811, 2, 640x360 
0x1382CA98, 37353946416523048, 89682840, 89682842, 2, 640x360 
0x1382CA98, 37353946416838944, 89682869, 89682879, 10, 640x360 
0x1382CA98, 37353946417159296, 89682904, 89682907, 3, 640x360 
0x1382CA98, 37353946417638920, 89682948, 89682959, 11, 640x360 
0x1382CA98, 37353946417958872, 89682981, 89682993, 12, 640x360 
0x1382CA98, 37353946418279112, 89683019, 89683026, 7, 640x360 
0x1382CA98, 37353946418603424, 89683044, 89683047, 3, 640x360 
0x1382CA98, 37353946418943896, 89683082, 89683089, 7, 640x360 
0x1382CA98, 37353946419252640, 89683113, 89683119, 6, 640x360 
0x1382CA98, 37353946419560064, 89683147, 89683152, 5, 640x360 
0x1382CA98, 37353946419878368, 89683178, 89683180, 2, 640x360 
0x1382CA98, 37353946420198896, 89683206, 89683209, 3, 640x360 
0x1382CA98, 37353946420518552, 89683244, 89683246, 2, 640x360 
0x1382CA98, 37353946420839064, 89683269, 89683277, 8, 640x360 
0x1382CA98, 37353946421167448, 89683315, 89683324, 9, 640x360 
0x1382CA98, 37353946421637816, 89683345, 89683350, 5, 640x360 
0x1382CA98, 37353946421958768, 89683393, 89683395, 2, 640x360 
0x1382CA98, 37353946422279544, 89683410, 89683413, 3, 640x360 
0x1382CA98, 37353946422603112, 89683451, 89683455, 4, 640x360 
0x1382CA98, 37353946422929672, 89683477, 89683490, 13, 640x360 
0x1382CA98, 37353946423290960, 89683525, 89683527, 2, 640x360 
0x1382CA98, 37353946423558192, 89683554, 89683557, 3, 640x360 
0x1382CA98, 37353946423882144, 89683579, 89683584, 5, 640x360 
0x1382CA98, 37353946424199240, 89683615, 89683618, 3, 640x360 
0x1382CA98, 37353946424520568, 89683642, 89683644, 2, 640x360 
0x1382CA98, 37353946424842504, 89683678, 89683680, 2, 640x360 
0x1382CA98, 37353946425158464, 89683701, 89683704, 3, 640x360 
0x1382CA98, 37353946425640584, 89683750, 89683752, 2, 640x360 
0x1382CA98, 37353946425958792, 89683779, 89683782, 3, 640x360 
0x1382CA98, 37353946426278544, 89683812, 89683818, 6, 640x360 
0x1382CA98, 37353946426604464, 89683843, 89683846, 3, 640x360 
0x1382CA98, 37353946426928888, 89683884, 89683886, 2, 640x360 
0x1382CA98, 37353946427243072, 89683908, 89683910, 2, 640x360 
0x1382CA98, 37353946427575944, 89683944, 89683947, 3, 640x360 
0x1382CA98, 37353946427879016, 89683976, 89683978, 2, 640x360 
0x1382CA98, 37353946428199184, 89684011, 89684021, 10, 640x360 
0x1382CA98, 37353946428519048, 89684039, 89684042, 3, 640x360 
0x1382CA98, 37353946428846792, 89684072, 89684075, 3, 640x360 
0x1382CA98, 37353946429158944, 89684104, 89684110, 6, 640x360 
0x1382CA98, 37353946429642480, 89684152, 89684155, 3, 640x360 
0x1382CA98, 37353946429958632, 89684177, 89684180, 3, 640x360 
0x1382CA98, 37353946430279488, 89684209, 89684213, 4, 640x360 
0x1382CA98, 37353946430598104, 89684241, 89684244, 3, 640x360 
0x1382CA98, 37353946430919584, 89684280, 89684286, 6, 640x360 
0x1382CA98, 37353946431250120, 89684311, 89684318, 7, 640x360 
0x1382CA98, 37353946431563616, 89684344, 89684346, 2, 640x360 
0x1382CA98, 37353946431888968, 89684372, 89684375, 3, 640x360 
0x1382CA98, 37353946432206536, 89684409, 89684417, 8, 640x360 
0x1382CA98, 37353946432523584, 89684449, 89684453, 4, 640x360 
0x1382CA98, 37353946432840848, 89684474, 89684476, 2, 640x360 
0x1382CA98, 37353946433161976, 89684505, 89684513, 8, 640x360 
0x1382CA98, 37353946433483680, 89684542, 89684546, 4, 640x360 
0x1382CA98, 37353946433957856, 89684578, 89684581, 3, 640x360 
0x1382CA98, 37353946434277608, 89684609, 89684612, 3, 640x360 
0x1382CA98, 37353946434600952, 89684646, 89684648, 2, 640x360 
0x1382CA98, 37353946434925504, 89684675, 89684677, 2, 640x360 
0x1382CA98, 37353946435242568, 89684711, 89684720, 9, 640x360 
0x1382CA98, 37353946435564480, 89684742, 89684745, 3, 640x360 
0x1382CA98, 37353946435881624, 89684773, 89684775, 2, 640x360 
0x1382CA98, 37353946436203216, 89684805, 89684814, 9, 640x360 
0x1382CA98, 37353946436518488, 89684838, 89684840, 2, 640x360 
0x1382CA98, 37353946436842768, 89684871, 89684874, 3, 640x360 
0x1382CA98, 37353946437158888, 89684902, 89684905, 3, 640x360 
0x1382CA98, 37353946437490168, 89684935, 89684939, 4, 640x360 
0x1382CA98, 37353946437963824, 89684981, 89684983, 2, 640x360 
0x1382CA98, 37353946438277880, 89685015, 89685022, 7, 640x360 
0x1382CA98, 37353946438605192, 89685052, 89685054, 2, 640x360 
0x1382CA98, 37353946438919600, 89685081, 89685085, 4, 640x360 
0x1382CA98, 37353946439255680, 89685110, 89685116, 6, 640x360 
0x1382CA98, 37353946439557768, 89685143, 89685146, 3, 640x360 
0x1382CA98, 37353946439877752, 89685175, 89685177, 2, 640x360 
0x1382CA98, 37353946440201752, 89685205, 89685209, 4, 640x360 
0x1382CA98, 37353946440519888, 89685238, 89685240, 2, 640x360 
0x1382CA98, 37353946440840848, 89685276, 89685278, 2, 640x360 
0x1382CA98, 37353946441159784, 89685308, 89685309, 1, 640x360 
0x1382CA98, 37353946441484784, 89685343, 89685345, 2, 640x360 
0x1382CA98, 37353946441958216, 89685383, 89685389, 6, 640x360 
0x1382CA98, 37353946442282416, 89685414, 89685418, 4, 640x360 
0x1382CA98, 37353946442597848, 89685448, 89685452, 4, 640x360 
0x1382CA98, 37353946442918128, 89685478, 89685485, 7, 640x360 
0x1382CA98, 37353946443238560, 89685518, 89685520, 2, 640x360 
0x1382CA98, 37353946443564896, 89685554, 89685565, 11, 640x360 
0x1382CA98, 37353946443886912, 89685586, 89685588, 2, 640x360 
0x1382CA98, 37353946444198512, 89685605, 89685611, 6, 640x360 
0x1382CA98, 37353946444518752, 89685637, 89685640, 3, 640x360 
0x1382CA98, 37353946444838680, 89685671, 89685673, 2, 640x360 
0x1382CA98, 37353946445162696, 89685701, 89685710, 9, 640x360 
0x1382CA98, 37353946445478856, 89685737, 89685739, 2, 640x360 
0x1382CA98, 37353946445958552, 89685778, 89685784, 6, 640x360 
0x1382CA98, 37353946446280216, 89685811, 89685820, 9, 640x360 
0x1382CA98, 37353946446597384, 89685844, 89685848, 4, 640x360 
0x1382CA98, 37353946446917888, 89685876, 89685880, 4, 640x360 
0x1382CA98, 37353946447240976, 89685913, 89685917, 4, 640x360 
0x1382CA98, 37353946447576448, 89685940, 89685943, 3, 640x360 
0x1382CA98, 37353946447894032, 89685972, 89685974, 2, 640x360 
0x1382CA98, 37353946448205944, 89686004, 89686007, 3, 640x360 
0x1382CA98, 37353946448518792, 89686036, 89686039, 3, 640x360 
0x1382CA98, 37353946448838824, 89686067, 89686070, 3, 640x360 
0x1382CA98, 37353946449160208, 89686109, 89686111, 2, 640x360 
0x1382CA98, 37353946449483336, 89686140, 89686142, 2, 640x360 
0x1382CA98, 37353946449957744, 89686185, 89686191, 6, 640x360 
0x1382CA98, 37353946450281512, 89686209, 89686217, 8, 640x360 
0x1382CA98, 37353946450615768, 89686245, 89686258, 13, 640x360 
0x1382CA98, 37353946450941296, 89686281, 89686297, 16, 640x360 
0x1382CA98, 37353946451249368, 89686312, 89686325, 13, 640x360 
0x1382CA98, 37353946451557464, 89686345, 89686355, 10, 640x360 
0x1382CA98, 37353946451878800, 89686383, 89686390, 7, 640x360 
0x1382CA98, 37353946452199008, 89686411, 89686418, 7, 640x360 
0x1382CA98, 37353946452534584, 89686451, 89686454, 3, 640x360 
0x1382CA98, 37353946452838024, 89686473, 89686475, 2, 640x360 
0x1382CA98, 37353946453159408, 89686505, 89686507, 2, 640x360 
0x1382CA98, 37353946453485512, 89686547, 89686552, 5, 640x360 
0x1382CA98, 37353946453961992, 89686580, 89686585, 5, 640x360 
0x1382CA98, 37353946454281480, 89686620, 89686622, 2, 640x360 
0x1382CA98, 37353946454597808, 89686651, 89686653, 2, 640x360 
0x1382CA98, 37353946454938968, 89686684, 89686688, 4, 640x360 
0x1382CA98, 37353946455247816, 89686711, 89686715, 4, 640x360 
0x1382CA98, 37353946455558264, 89686749, 89686757, 8, 640x360 
0x1382CA98, 37353946455878104, 89686783, 89686793, 10, 640x360 
0x1382CA98, 37353946456202224, 89686810, 89686813, 3, 640x360 
0x1382CA98, 37353946456518264, 89686841, 89686843, 2, 640x360 
0x1382CA98, 37353946456838184, 89686879, 89686892, 13, 640x360 
0x1382CA98, 37353946457186400, 89686914, 89686924, 10, 640x360 
0x1382CA98, 37353946457481440, 89686946, 89686950, 4, 640x360 
0x1382CA98, 37353946457801664, 89686977, 89686980, 3, 640x360 
0x1382CA98, 37353946458282240, 89687016, 89687020, 4, 640x360 
0x1382CA98, 37353946458596872, 89687042, 89687045, 3, 640x360 
0x1382CA98, 37353946458923064, 89687082, 89687090, 8, 640x360 
0x1382CA98, 37353946459237048, 89687114, 89687123, 9, 640x360 
0x1382CA98, 37353946459561104, 89687144, 89687154, 10, 640x360 
0x1382CA98, 37353946459884832, 89687173, 89687175, 2, 640x360 
0x1382CA98, 37353946460202568, 89687205, 89687211, 6, 640x360 
0x1382CA98, 37353946460524760, 89687237, 89687240, 3, 640x360 
0x1382CA98, 37353946460842720, 89687275, 89687281, 6, 640x360 
0x1382CA98, 37353946461158224, 89687302, 89687310, 8, 640x360 
0x1382CA98, 37353946461481968, 89687337, 89687347, 10, 640x360 
0x1382CA98, 37353946461806712, 89687375, 89687384, 9, 640x360 
0x1382CA98, 37353946462295840, 89687427, 89687430, 3, 640x360 
0x1382CA98, 37353946462617056, 89687460, 89687463, 3, 640x360 
0x1382CA98, 37353946462934656, 89687482, 89687485, 3, 640x360 
0x1382CA98, 37353946463238624, 89687520, 89687522, 2, 640x360 
0x1382CA98, 37353946463578152, 89687553, 89687556, 3, 640x360 
0x1382CA98, 37353946463877328, 89687575, 89687577, 2, 640x360 
0x1382CA98, 37353946464197184, 89687614, 89687624, 10, 640x360 
0x1382CA98, 37353946464517784, 89687636, 89687644, 8, 640x360 
0x1382CA98, 37353946464849184, 89687674, 89687681, 7, 640x360 
0x1382CA98, 37353946465157024, 89687715, 89687719, 4, 640x360 
0x1382CA98, 37353946465477968, 89687742, 89687748, 6, 640x360 
0x1382CA98, 37353946465801760, 89687763, 89687778, 15, 640x360 
0x1382CA98, 37353946466276632, 89687818, 89687821, 3, 640x360 
0x1382CA98, 37353946466602128, 89687848, 89687856, 8, 640x360 
0x1382CA98, 37353946466917552, 89687881, 89687885, 4, 640x360 
0x1382CA98, 37353946467248040, 89687910, 89687914, 4, 640x360 
0x1382CA98, 37353946467561160, 89687949, 89687952, 3, 640x360 
0x1382CA98, 37353946467882136, 89687980, 89687984, 4, 640x360 
0x1382CA98, 37353946468197280, 89688006, 89688008, 2, 640x360 
0x1382CA98, 37353946468517800, 89688038, 89688045, 7, 640x360 
0x1382CA98, 37353946468853056, 89688072, 89688075, 3, 640x360 
0x1382CA98, 37353946469157904, 89688104, 89688106, 2, 640x360 
0x1382CA98, 37353946469486344, 89688138, 89688146, 8, 640x360 
0x1382CA98, 37353946469802192, 89688169, 89688173, 4, 640x360 
0x1382CA98, 37353946470280552, 89688213, 89688221, 8, 640x360 
0x1382CA98, 37353946470601232, 89688249, 89688252, 3, 640x360 
0x1382CA98, 37353946470929928, 89688277, 89688280, 3, 640x360 
0x1382CA98, 37353946471239480, 89688316, 89688319, 3, 640x360 
0x1382CA98, 37353946471582752, 89688356, 89688358, 2, 640x360 
0x1382CA98, 37353946471876776, 89688378, 89688381, 3, 640x360 
0x1382CA98, 37353946472197040, 89688405, 89688408, 3, 640x360 
0x1382CA98, 37353946472522112, 89688438, 89688441, 3, 640x360 
0x1382CA98, 37353946472838520, 89688478, 89688484, 6, 640x360 
0x1382CA98, 37353946473186488, 89688527, 89688533, 6, 640x360 
0x1382CA98, 37353946473485976, 89688546, 89688558, 12, 640x360 
0x1382CA98, 37353946473797840, 89688579, 89688584, 5, 640x360 
0x1382CA98, 37353946474276968, 89688611, 89688617, 6, 640x360 
0x1382CA98, 37353946474624560, 89688660, 89688662, 2, 640x360 
0x1382CA98, 37353946474951408, 89688687, 89688689, 2, 640x360 
0x1382CA98, 37353946475244264, 89688711, 89688715, 4, 640x360 
0x1382CA98, 37353946475556472, 89688744, 89688748, 4, 640x360 
0x1382CA98, 37353946475888360, 89688776, 89688779, 3, 640x360 
0x1382CA98, 37353946476202560, 89688812, 89688816, 4, 640x360 
0x1382CA98, 37353946476524016, 89688841, 89688844, 3, 640x360 
0x1382CA98, 37353946476837432, 89688872, 89688874, 2, 640x360 
0x1382CA98, 37353946477221592, 89688909, 89688913, 4, 640x360 
0x1382CA98, 37353946477521440, 89688944, 89688948, 4, 640x360 
0x1382CA98, 37353946477798040, 89688977, 89688979, 2, 640x360 
0x1382CA98, 37353946478280272, 89689009, 89689013, 4, 640x360 
0x1382CA98, 37353946478614536, 89689048, 89689054, 6, 640x360 
0x1382CA98, 37353946478923816, 89689078, 89689084, 6, 640x360 
0x1382CA98, 37353946479243640, 89689107, 89689109, 2, 640x360 
0x1382CA98, 37353946479561928, 89689144, 89689148, 4, 640x360 
0x1382CA98, 37353946479881888, 89689177, 89689179, 2, 640x360 
0x1382CA98, 37353946480203864, 89689211, 89689213, 2, 640x360 
0x1382CA98, 37353946480517000, 89689240, 89689242, 2, 640x360 
0x1382CA98, 37353946480838160, 89689274, 89689276, 2, 640x360 
0x1382CA98, 37353946481160744, 89689308, 89689309, 1, 640x360 
0x1382CA98, 37353946481493912, 89689337, 89689340, 3, 640x360 
0x1382CA98, 37353946481805128, 89689376, 89689378, 2, 640x360 
0x1382CA98, 37353946482282664, 89689421, 89689428, 7, 640x360 
0x1382CA98, 37353946482599648, 89689453, 89689456, 3, 640x360 
0x1382CA98, 37353946482916776, 89689483, 89689486, 3, 640x360 
0x1382CA98, 37353946483241384, 89689510, 89689513, 3, 640x360 
0x1382CA98, 37353946483556720, 89689542, 89689545, 3, 640x360 
0x1382CA98, 37353946483877176, 89689581, 89689586, 5, 640x360 
0x1382CA98, 37353946484201640, 89689607, 89689610, 3, 640x360 
0x1382CA98, 37353946484549328, 89689649, 89689655, 6, 640x360 
0x1382CA98, 37353946484836592, 89689690, 89689698, 8, 640x360 
0x1382CA98, 37353946485159648, 89689709, 89689719, 10, 640x360 
0x1382CA98, 37353946485477488, 89689741, 89689743, 2, 640x360 
0x1382CA98, 37353946485804064, 89689777, 89689780, 3, 640x360 
0x1382CA98, 37353946486118256, 89689807, 89689809, 2, 640x360 
0x1382CA98, 37353946486602184, 89689844, 89689846, 2, 640x360 
0x1382CA98, 37353946486921880, 89689882, 89689885, 3, 640x360 
0x1382CA98, 37353946487240832, 89689914, 89689919, 5, 640x360 
0x1382CA98, 37353946487561104, 89689951, 89689954, 3, 640x360 
0x1382CA98, 37353946487880496, 89689983, 89689987, 4, 640x360 
0x1382CA98, 37353946488200592, 89690007, 89690016, 9, 640x360 
0x1382CA98, 37353946488519920, 89690040, 89690048, 8, 640x360 
0x1382CA98, 37353946488840368, 89690067, 89690069, 2, 640x360 
0x1382CA98, 37353946489159888, 89690111, 89690113, 2, 640x360 
0x1382CA98, 37353946489483736, 89690138, 89690140, 2, 640x360 
0x1382CA98, 37353946489804872, 89690178, 89690182, 4, 640x360 
0x1382CA98, 37353946490117464, 89690209, 89690211, 2, 640x360 
0x1382CA98, 37353946490596560, 89690252, 89690254, 2, 640x360 
0x1382CA98, 37353946490923408, 89690284, 89690287, 3, 640x360 
0x1382CA98, 37353946491258712, 89690313, 89690319, 6, 640x360 
0x1382CA98, 37353946491559160, 89690352, 89690355, 3, 640x360 
0x1382CA98, 37353946491884664, 89690373, 89690375, 2, 640x360 
0x1382CA98, 37353946492212248, 89690417, 89690419, 2, 640x360 
0x1382CA98, 37353946492520688, 89690438, 89690448, 10, 640x360 
0x1382CA98, 37353946492841520, 89690472, 89690478, 6, 640x360 
0x1382CA98, 37353946493160360, 89690504, 89690507, 3, 640x360 
0x1382CA98, 37353946493490856, 89690541, 89690544, 3, 640x360 
0x1382CA98, 37353946493814992, 89690578, 89690580, 2, 640x360 
0x1382CA98, 37353946494121000, 89690601, 89690609, 8, 640x360 
0x1382CA98, 37353946494596656, 89690651, 89690658, 7, 640x360 
0x1382CA98, 37353946494927240, 89690688, 89690693, 5, 640x360 
0x1382CA98, 37353946495236480, 89690718, 89690721, 3, 640x360 
0x1382CA98, 37353946495563832, 89690751, 89690753, 2, 640x360 
0x1382CA98, 37353946495887008, 89690784, 89690786, 2, 640x360 
0x1382CA98, 37353946496212200, 89690808, 89690811, 3, 640x360 
0x1382CA98, 37353946496521784, 89690843, 89690845, 2, 640x360 
0x1382CA98, 37353946496839280, 89690873, 89690876, 3, 640x360 
0x1382CA98, 37353946497162000, 89690904, 89690907, 3, 640x360 
0x1382CA98, 37353946497481376, 89690940, 89690942, 2, 640x360 
0x1382CA98, 37353946497827320, 89690982, 89690991, 9, 640x360 
0x1382CA98, 37353946498121128, 89691005, 89691007, 2, 640x360 
0x1382CA98, 37353946498606168, 89691046, 89691053, 7, 640x360 
0x1382CA98, 37353946498933912, 89691082, 89691085, 3, 640x360 
0x1382CA98, 37353946499240912, 89691114, 89691117, 3, 640x360 
0x1382CA98, 37353946499586688, 89691147, 89691152, 5, 640x360 
0x1382CA98, 37353946499877272, 89691178, 89691180, 2, 640x360 
0x1382CA98, 37353946500200720, 89691212, 89691214, 2, 640x360 
0x1382CA98, 37353946500517072, 89691238, 89691240, 2, 640x360 
0x1382CA98, 37353946500840312, 89691274, 89691276, 2, 640x360 
0x1382CA98, 37353946501157224, 89691314, 89691320, 6, 640x360 
0x1382CA98, 37353946501477176, 89691345, 89691349, 4, 640x360 
0x1382CA98, 37353946501826568, 89691374, 89691376, 2, 640x360 
0x1382CA98, 37353946502125744, 89691408, 89691410, 2, 640x360 
0x1382CA98, 37353946502605448, 89691454, 89691457, 3, 640x360 
0x1382CA98, 37353946502924912, 89691490, 89691502, 12, 640x360 
0x1382CA98, 37353946503271464, 89691516, 89691520, 4, 640x360 
0x1382CA98, 37353946503561288, 89691544, 89691547, 3, 640x360 
0x1382CA98, 37353946503880408, 89691585, 89691588, 3, 640x360 
0x1382CA98, 37353946504200000, 89691612, 89691615, 3, 640x360 
0x1382CA98, 37353946504515904, 89691640, 89691642, 2, 640x360 
0x1382CA98, 37353946504839504, 89691673, 89691675, 2, 640x360 
0x1382CA98, 37353946505156104, 89691712, 89691715, 3, 640x360 
0x1382CA98, 37353946505478704, 89691733, 89691743, 10, 640x360 
0x1382CA98, 37353946505800344, 89691766, 89691772, 6, 640x360 
0x1382CA98, 37353946506120896, 89691797, 89691808, 11, 640x360 
0x1382CA98, 37353946506607304, 89691848, 89691856, 8, 640x360 
0x1382CA98, 37353946506918632, 89691879, 89691885, 6, 640x360 
0x1382CA98, 37353946507262824, 89691916, 89691920, 4, 640x360 
0x1382CA98, 37353946507655384, 89691952, 89691961, 9, 640x360 
0x1382CA98, 37353946507883968, 89691987, 89691998, 11, 640x360 
0x1382CA98, 37353946508195936, 89692010, 89692015, 5, 640x360 
0x1382CA98, 37353946508521264, 89692043, 89692045, 2, 640x360 
0x1382CA98, 37353946508836632, 89692074, 89692076, 2, 640x360 
0x1382CA98, 37353946509155952, 89692111, 89692114, 3, 640x360 
0x1382CA98, 37353946509479272, 89692145, 89692150, 5, 640x360 
0x1382CA98, 37353946509801888, 89692178, 89692182, 4, 640x360 
0x1382CA98, 37353946510116088, 89692195, 89692197, 2, 640x360 
0x1382CA98, 37353946510595480, 89692247, 89692257, 10, 640x360 
0x1382CA98, 37353946510918448, 89692287, 89692293, 6, 640x360 
0x1382CA98, 37353946511240184, 89692311, 89692317, 6, 640x360 
0x1382CA98, 37353946511555616, 89692346, 89692348, 2, 640x360 
0x1382CA98, 37353946511888920, 89692376, 89692379, 3, 640x360 
0x1382CA98, 37353946512196944, 89692421, 89692424, 3, 640x360 
0x1382CA98, 37353946512520648, 89692440, 89692442, 2, 640x360 
0x1382CA98, 37353946512835968, 89692471, 89692473, 2, 640x360 
0x1382CA98, 37353946513159896, 89692502, 89692505, 3, 640x360 
0x1382CA98, 37353946513487944, 89692540, 89692542, 2, 640x360 
0x1382CA98, 37353946513809384, 89692564, 89692576, 12, 640x360 
0x1382CA98, 37353946514117224, 89692596, 89692601, 5, 640x360 
0x1382CA98, 37353946514437136, 89692631, 89692638, 7, 640x360 
0x1382CA98, 37353946514924856, 89692689, 89692695, 6, 640x360 
0x1382CA98, 37353946515236312, 89692712, 89692715, 3, 640x360 
0x1382CA98, 37353946515555664, 89692747, 89692752, 5, 640x360 
0x1382CA98, 37353946515878288, 89692777, 89692779, 2, 640x360 
0x1382CA98, 37353946516201704, 89692818, 89692826, 8, 640x360 
0x1382CA98, 37353946516523880, 89692852, 89692859, 7, 640x360 
0x1382CA98, 37353946516840824, 89692884, 89692886, 2, 640x360 
0x1382CA98, 37353946517160616, 89692906, 89692908, 2, 640x360 
0x1382CA98, 37353946517487304, 89692947, 89692951, 4, 640x360 
0x1382CA98, 37353946517800184, 89692978, 89692984, 6, 640x360 
0x1382CA98, 37353946518118464, 89693004, 89693006, 2, 640x360 
0x1382CA98, 37353946518436224, 89693028, 89693034, 6, 640x360 
0x1382CA98, 37353946518925400, 89693083, 89693087, 4, 640x360 
0x1382CA98, 37353946519249928, 89693112, 89693119, 7, 640x360 
0x1382CA98, 37353946519560432, 89693149, 89693159, 10, 640x360 
0x1382CA98, 37353946519889792, 89693184, 89693186, 2, 640x360 
0x1382CA98, 37353946520205392, 89693209, 89693211, 2, 640x360 
0x1382CA98, 37353946520516304, 89693237, 89693244, 7, 640x360 
0x1382CA98, 37353946520836104, 89693274, 89693276, 2, 640x360 
0x1382CA98, 37353946521160048, 89693303, 89693311, 8, 640x360 
0x1382CA98, 37353946521478312, 89693348, 89693360, 12, 640x360 
0x1382CA98, 37353946521816856, 89693377, 89693379, 2, 640x360 
0x1382CA98, 37353946522148640, 89693406, 89693408, 2, 640x360 
0x1382CA98, 37353946522437088, 89693433, 89693437, 4, 640x360 
0x1382CA98, 37353946522918616, 89693480, 89693489, 9, 640x360 
0x1382CA98, 37353946523239736, 89693508, 89693510, 2, 640x360 
0x1382CA98, 37353946523589712, 89693550, 89693552, 2, 640x360 
0x1382CA98, 37353946523875328, 89693582, 89693592, 10, 640x360 
0x1382CA98, 37353946524199216, 89693606, 89693608, 2, 640x360 
0x1382CA98, 37353946524515632, 89693641, 89693642, 1, 640x360 
0x1382CA98, 37353946524839296, 89693671, 89693674, 3, 640x360 
0x1382CA98, 37353946525155592, 89693702, 89693704, 2, 640x360 
0x1382CA98, 37353946525479360, 89693740, 89693747, 7, 640x360 
0x1382CA98, 37353946525804280, 89693774, 89693776, 2, 640x360 
0x1382CA98, 37353946526119432, 89693812, 89693815, 3, 640x360 
0x1382CA98, 37353946526438024, 89693838, 89693841, 3, 640x360 
0x1382CA98, 37353946526920520, 89693876, 89693879, 3, 640x360 
0x1382CA98, 37353946527235416, 89693923, 89693926, 3, 640x360 
0x1382CA98, 37353946527597264, 89693965, 89693975, 10, 640x360 
0x1382CA98, 37353946527997976, 89694006, 89694026, 20, 640x360 
0x1382CA98, 37353946528296600, 89694045, 89694058, 13, 640x360 
0x1382CA98, 37353946528540048, 89694068, 89694085, 17, 640x360 
0x1382CA98, 37353946528852040, 89694095, 89694112, 17, 640x360 
0x1382CA98, 37353946529174512, 89694141, 89694145, 4, 640x360 
0x1382CA98, 37353946529497448, 89694168, 89694178, 10, 640x360 
0x1382CA98, 37353946529827536, 89694190, 89694192, 2, 640x360 
0x1382CA98, 37353946530141408, 89694219, 89694222, 3, 640x360 
0x1382CA98, 37353946530442360, 89694234, 89694241, 7, 640x360 
0x1382CA98, 37353946530942112, 89694295, 89694301, 6, 640x360 
0x1382CA98, 37353946531269936, 89694313, 89694321, 8, 640x360 
0x1382CA98, 37353946531560000, 89694344, 89694347, 3, 640x360 
0x1382CA98, 37353946531884672, 89694384, 89694387, 3, 640x360 
0x1382CA98, 37353946532213544, 89694420, 89694422, 2, 640x360 
0x1382CA98, 37353946532515296, 89694438, 89694444, 6, 640x360 
0x1382CA98, 37353946532863824, 89694478, 89694495, 17, 640x360 
0x1382CA98, 37353946533164712, 89694516, 89694520, 4, 640x360 
0x1382CA98, 37353946533481544, 89694545, 89694547, 2, 640x360 
0x1382CA98, 37353946533803888, 89694584, 89694588, 4, 640x360 
0x1382CA98, 37353946534119872, 89694611, 89694612, 1, 640x360 
0x1382CA98, 37353946534447680, 89694643, 89694645, 2, 640x360 
0x1382CA98, 37353946534947368, 89694694, 89694696, 2, 640x360 
0x1382CA98, 37353946535236232, 89694720, 89694722, 2, 640x360 
0x1382CA98, 37353946535614384, 89694753, 89694768, 15, 640x360 
0x1382CA98, 37353946535884872, 89694784, 89694789, 5, 640x360 
0x1382CA98, 37353946536204616, 89694813, 89694827, 14, 640x360 
0x1382CA98, 37353946536532592, 89694852, 89694855, 3, 640x360 
0x1382CA98, 37353946536846424, 89694878, 89694880, 2, 640x360 
0x1382CA98, 37353946537160904, 89694914, 89694918, 4, 640x360 
0x1382CA98, 37353946537477056, 89694941, 89694944, 3, 640x360 
0x1382CA98, 37353946537805688, 89694973, 89694975, 2, 640x360 
0x1382CA98, 37353946538120976, 89695008, 89695014, 6, 640x360 
0x1382CA98, 37353946538452880, 89695041, 89695055, 14, 640x360 
0x1382CA98, 37353946538765944, 89695070, 89695073, 3, 640x360 
0x1382CA98, 37353946539235584, 89695120, 89695132, 12, 640x360 
0x1382CA98, 37353946539572360, 89695152, 89695155, 3, 640x360 
0x1382CA98, 37353946539876824, 89695194, 89695199, 5, 640x360 
0x1382CA98, 37353946540196008, 89695221, 89695225, 4, 640x360 
0x1382CA98, 37353946540515680, 89695250, 89695258, 8, 640x360 
0x1382CA98, 37353946540836072, 89695276, 89695278, 2, 640x360 
0x1382CA98, 37353946541178672, 89695309, 89695312, 3, 640x360 
0x1382CA98, 37353946541485152, 89695337, 89695340, 3, 640x360 
0x1382CA98, 37353946541804320, 89695382, 89695386, 4, 640x360 
0x1382CA98, 37353946542119136, 89695408, 89695410, 2, 640x360 
0x1382CA98, 37353946542436888, 89695439, 89695441, 2, 640x360 
0x1382CA98, 37353946542757136, 89695468, 89695475, 7, 640x360 
0x1382CA98, 37353946543247912, 89695517, 89695527, 10, 640x360 
0x1382CA98, 37353946543557264, 89695559, 89695566, 7, 640x360 
0x1382CA98, 37353946543886168, 89695589, 89695595, 6, 640x360 
0x1382CA98, 37353946544209688, 89695616, 89695620, 4, 640x360 
0x1382CA98, 37353946544515376, 89695652, 89695659, 7, 640x360 
0x1382CA98, 37353946544854208, 89695693, 89695695, 2, 640x360 
0x1382CA98, 37353946545169040, 89695712, 89695716, 4, 640x360 
0x1382CA98, 37353946545488464, 89695751, 89695759, 8, 640x360 
0x1382CA98, 37353946545798120, 89695774, 89695777, 3, 640x360 
0x1382CA98, 37353946546118848, 89695805, 89695814, 9, 640x360 
0x1382CA98, 37353946546435496, 89695840, 89695842, 2, 640x360 
0x1382CA98, 37353946546761480, 89695877, 89695881, 4, 640x360 
0x1382CA98, 37353946547245984, 89695928, 89695934, 6, 640x360 
0x1382CA98, 37353946547556392, 89695955, 89695958, 3, 640x360 
0x1382CA98, 37353946547877184, 89695982, 89695986, 4, 640x360 
0x1382CA98, 37353946548195088, 89696007, 89696009, 2, 640x360 
0x1382CA98, 37353946548521928, 89696040, 89696043, 3, 640x360 
0x1382CA98, 37353946548843448, 89696079, 89696084, 5, 640x360 
0x1382CA98, 37353946549175992, 89696110, 89696113, 3, 640x360 
0x1382CA98, 37353946549516048, 89696152, 89696161, 9, 640x360 
0x1382CA98, 37353946549856832, 89696183, 89696187, 4, 640x360 
0x1382CA98, 37353946550117632, 89696204, 89696207, 3, 640x360 
0x1382CA98, 37353946550435816, 89696236, 89696238, 2, 640x360 
0x1382CA98, 37353946550786560, 89696273, 89696274, 1, 640x360 
0x1382CA98, 37353946551234848, 89696320, 89696322, 2, 640x360 
0x1382CA98, 37353946551559624, 89696354, 89696356, 2, 640x360 
0x1382CA98, 37353946551874960, 89696387, 89696393, 6, 640x360 
0x1382CA98, 37353946552197360, 89696420, 89696422, 2, 640x360 
0x1382CA98, 37353946552516168, 89696439, 89696442, 3, 640x360 
0x1382CA98, 37353946552834952, 89696482, 89696485, 3, 640x360 
0x1382CA98, 37353946553154784, 89696509, 89696515, 6, 640x360 
0x1382CA98, 37353946553474664, 89696540, 89696542, 2, 640x360 
0x1382CA98, 37353946553798752, 89696565, 89696576, 11, 640x360 
0x1382CA98, 37353946554122848, 89696616, 89696634, 18, 640x360 
0x1382CA98, 37353946554446744, 89696646, 89696676, 30, 640x360 
0x1382CA98, 37353946554779472, 89696679, 89696687, 8, 640x360 
0x1382CA98, 37353946555275600, 89696718, 89696723, 5, 640x360 
0x1382CA98, 37353946555559944, 89696744, 89696748, 4, 640x360 
0x1382CA98, 37353946555879888, 89696790, 89696796, 6, 640x360 
0x1382CA98, 37353946556216000, 89696820, 89696839, 19, 640x360 
0x1382CA98, 37353946556584928, 89696858, 89696862, 4, 640x360 
0x1382CA98, 37353946556840288, 89696887, 89696898, 11, 640x360 
0x1382CA98, 37353946557155232, 89696923, 89696926, 3, 640x360 
0x1382CA98, 37353946557482904, 89696945, 89696947, 2, 640x360 
0x1382CA98, 37353946557805504, 89696975, 89696986, 11, 640x360 
0x1382CA98, 37353946558136504, 89697010, 89697018, 8, 640x360 
0x1382CA98, 37353946558440040, 89697033, 89697043, 10, 640x360 
0x1382CA98, 37353946558774024, 89697061, 89697065, 4, 640x360 
0x1382CA98, 37353946559234104, 89697113, 89697116, 3, 640x360 
0x1382CA98, 37353946559558136, 89697145, 89697147, 2, 640x360 
0x1382CA98, 37353946559878288, 89697184, 89697194, 10, 640x360 
0x1382CA98, 37353946560199392, 89697209, 89697218, 9, 640x360 
0x1382CA98, 37353946560514536, 89697240, 89697249, 9, 640x360 
0x1382CA98, 37353946560835424, 89697275, 89697278, 3, 640x360 
0x1382CA98, 37353946561155080, 89697311, 89697325, 14, 640x360 
0x1382CA98, 37353946561479880, 89697339, 89697341, 2, 640x360 
0x1382CA98, 37353946561802784, 89697368, 89697377, 9, 640x360 
0x1382CA98, 37353946562120760, 89697406, 89697414, 8, 640x360 
0x1382CA98, 37353946562435208, 89697429, 89697436, 7, 640x360 
0x1382CA98, 37353946562782000, 89697476, 89697482, 6, 640x360 
0x1382CA98, 37353946563234344, 89697510, 89697514, 4, 640x360 
0x1382CA98, 37353946563554424, 89697544, 89697546, 2, 640x360 
0x1382CA98, 37353946563878664, 89697576, 89697578, 2, 640x360 
0x1382CA98, 37353946564194784, 89697618, 89697621, 3, 640x360 
0x1382CA98, 37353946564516456, 89697640, 89697643, 3, 640x360 
0x1382CA98, 37353946564838560, 89697673, 89697675, 2, 640x360 
0x1382CA98, 37353946565154648, 89697704, 89697706, 2, 640x360 
0x1382CA98, 37353946565475256, 89697735, 89697737, 2, 640x360 
0x1382CA98, 37353946565799752, 89697771, 89697777, 6, 640x360 
0x1382CA98, 37353946566114720, 89697799, 89697801, 2, 640x360 
0x1382CA98, 37353946566435112, 89697830, 89697835, 5, 640x360 
0x1382CA98, 37353946566760456, 89697861, 89697863, 2, 640x360 
0x1382CA98, 37353946567558992, 89697945, 89697948, 3, 640x360 
0x1382CA98, 37353946567882184, 89697986, 89697988, 2, 640x360 
0x1382CA98, 37353946568198344, 89698016, 89698018, 2, 640x360 
0x1382CA98, 37353946568514816, 89698036, 89698043, 7, 640x360 
0x1382CA98, 37353946568838320, 89698071, 89698073, 2, 640x360 
0x1382CA98, 37353946569154368, 89698106, 89698116, 10, 640x360 
0x1382CA98, 37353946569476360, 89698138, 89698141, 3, 640x360 
0x1382CA98, 37353946569816776, 89698200, 89698206, 6, 640x360 
0x1382CA98, 37353946570128504, 89698224, 89698235, 11, 640x360 
0x1382CA98, 37353946570455576, 89698256, 89698258, 2, 640x360 
0x1382CA98, 37353946570779120, 89698276, 89698278, 2, 640x360 
0x1382CA98, 37353946571100400, 89698305, 89698307, 2, 640x360 
0x1382CA98, 37353946571554240, 89698345, 89698348, 3, 640x360 
0x1382CA98, 37353946571874160, 89698376, 89698380, 4, 640x360 
0x1382CA98, 37353946572210976, 89698415, 89698423, 8, 640x360 
0x1382CA98, 37353946572515552, 89698445, 89698465, 20, 640x360 
0x1382CA98, 37353946572895584, 89698495, 89698504, 9, 640x360 
0x1382CA98, 37353946573168200, 89698508, 89698511, 3, 640x360 
0x1382CA98, 37353946573499792, 89698558, 89698562, 4, 640x360 
0x1382CA98, 37353946573800024, 89698585, 89698600, 15, 640x360 
0x1382CA98, 37353946574127048, 89698621, 89698623, 2, 640x360 
0x1382CA98, 37353946574452080, 89698638, 89698643, 5, 640x360 
0x1382CA98, 37353946574765072, 89698675, 89698681, 6, 640x360 
0x1382CA98, 37353946575092104, 89698727, 89698742, 15, 640x360 
0x1382CA98, 37353946575585608, 89698763, 89698778, 15, 640x360 
0x1382CA98, 37353946575880912, 89698809, 89698815, 6, 640x360 
0x1382CA98, 37353946576236928, 89698822, 89698835, 13, 640x360 
0x1382CA98, 37353946576524792, 89698851, 89698861, 10, 640x360 
0x1382CA98, 37353946576853296, 89698906, 89698918, 12, 640x360 
0x1382CA98, 37353946577161256, 89698941, 89698952, 11, 640x360 
0x1382CA98, 37353946577486112, 89698952, 89698971, 19, 640x360 
0x1382CA98, 37353946577796168, 89698985, 89698991, 6, 640x360 
0x1382CA98, 37353946578125816, 89699004, 89699008, 4, 640x360 
0x1382CA98, 37353946578444496, 89699045, 89699052, 7, 640x360 
0x1382CA98, 37353946578763680, 89699067, 89699069, 2, 640x360 
0x1382CA98, 37353946579074872, 89699093, 89699095, 2, 640x360 
0x1382CA98, 37353946579558968, 89699154, 89699158, 4, 640x360 
0x1382CA98, 37353946579874424, 89699189, 89699191, 2, 640x360 
0x1382CA98, 37353946580193552, 89699217, 89699221, 4, 640x360 
0x1382CA98, 37353946580514488, 89699237, 89699240, 3, 640x360 
0x1382CA98, 37353946580843000, 89699273, 89699282, 9, 640x360 
0x1382CA98, 37353946581160616, 89699318, 89699327, 9, 640x360 
0x1382CA98, 37353946581478784, 89699341, 89699347, 6, 640x360 
0x1382CA98, 37353946581819640, 89699382, 89699392, 10, 640x360 
0x1382CA98, 37353946582123696, 89699413, 89699423, 10, 640x360 
0x1382CA98, 37353946582441944, 89699434, 89699444, 10, 640x360 
0x1382CA98, 37353946582776304, 89699462, 89699475, 13, 640x360 
0x1382CA98, 37353946583074888, 89699494, 89699498, 4, 640x360 
0x1382CA98, 37353946583553416, 89699549, 89699552, 3, 640x360 
0x1382CA98, 37353946583888752, 89699582, 89699585, 3, 640x360 
0x1382CA98, 37353946584203424, 89699612, 89699615, 3, 640x360 
0x1382CA98, 37353946584515864, 89699637, 89699645, 8, 640x360 
0x1382CA98, 37353946584833936, 89699680, 89699684, 4, 640x360 
0x1382CA98, 37353946585181640, 89699706, 89699709, 3, 640x360 
0x1382CA98, 37353946585484440, 89699743, 89699745, 2, 640x360 
0x1382CA98, 37353946585794424, 89699777, 89699779, 2, 640x360 
0x1382CA98, 37353946586117432, 89699802, 89699809, 7, 640x360 
0x1382CA98, 37353946586441216, 89699827, 89699831, 4, 640x360 
0x1382CA98, 37353946586777728, 89699867, 89699873, 6, 640x360 
0x1382CA98, 37353946587075608, 89699893, 89699897, 4, 640x360 
0x1382CA98, 37353946587553720, 89699949, 89699957, 8, 640x360 
0x1382CA98, 37353946587873944, 89699983, 89699990, 7, 640x360 
0x1382CA98, 37353946588194536, 89700015, 89700024, 9, 640x360 
0x1382CA98, 37353946588515720, 89700041, 89700043, 2, 640x360 
0x1382CA98, 37353946588833936, 89700080, 89700090, 10, 640x360 
0x1382CA98, 37353946589156872, 89700111, 89700112, 1, 640x360 
0x1382CA98, 37353946589477816, 89700144, 89700146, 2, 640x360 
0x1382CA98, 37353946589805328, 89700167, 89700175, 8, 640x360 
0x1382CA98, 37353946590113952, 89700202, 89700209, 7, 640x360 
0x1382CA98, 37353946590446704, 89700233, 89700241, 8, 640x360 
0x1382CA98, 37353946590763456, 89700268, 89700276, 8, 640x360 
0x1382CA98, 37353946591080392, 89700295, 89700299, 4, 640x360 
0x1382CA98, 37353946591553424, 89700351, 89700353, 2, 640x360 
0x1382CA98, 37353946591877328, 89700384, 89700387, 3, 640x360 
0x1382CA98, 37353946592197288, 89700406, 89700409, 3, 640x360 
0x1382CA98, 37353946592517704, 89700438, 89700444, 6, 640x360 
0x1382CA98, 37353946592833960, 89700471, 89700480, 9, 640x360 
0x1382CA98, 37353946593157768, 89700505, 89700507, 2, 640x360 
0x1382CA98, 37353946593475536, 89700544, 89700547, 3, 640x360 
0x1382CA98, 37353946593795664, 89700562, 89700566, 4, 640x360 
0x1382CA98, 37353946594113768, 89700594, 89700598, 4, 640x360 
0x1382CA98, 37353946594434096, 89700627, 89700633, 6, 640x360 
0x1382CA98, 37353946594764288, 89700661, 89700665, 4, 640x360 
0x1382CA98, 37353946595074464, 89700694, 89700698, 4, 640x360 
0x1382CA98, 37353946595394136, 89700726, 89700730, 4, 640x360 
0x1382CA98, 37353946595873448, 89700780, 89700786, 6, 640x360 
0x1382CA98, 37353946596198488, 89700806, 89700809, 3, 640x360 
0x1382CA98, 37353946596514192, 89700840, 89700842, 2, 640x360 
0x1382CA98, 37353946596834672, 89700878, 89700881, 3, 640x360 
0x1382CA98, 37353946597164696, 89700910, 89700912, 2, 640x360 
0x1382CA98, 37353946597477448, 89700944, 89700947, 3, 640x360 
0x1382CA98, 37353946597793968, 89700968, 89700977, 9, 640x360 
0x1382CA98, 37353946598114312, 89700994, 89700998, 4, 640x360 
0x1382CA98, 37353946598439472, 89701045, 89701047, 2, 640x360 
0x1382CA98, 37353946598773984, 89701083, 89701087, 4, 640x360 
0x1382CA98, 37353946599083392, 89701110, 89701114, 4, 640x360 
0x1382CA98, 37353946599393960, 89701134, 89701141, 7, 640x360 
0x1382CA98, 37353946599873712, 89701176, 89701178, 2, 640x360 
0x1382CA98, 37353946600193848, 89701216, 89701219, 3, 640x360 
0x1382CA98, 37353946600513376, 89701238, 89701241, 3, 640x360 
0x1382CA98, 37353946600838152, 89701271, 89701274, 3, 640x360 
0x1382CA98, 37353946601159312, 89701303, 89701311, 8, 640x360 
0x1382CA98, 37353946601479656, 89701338, 89701340, 2, 640x360 
0x1382CA98, 37353946601798496, 89701371, 89701373, 2, 640x360 
0x1382CA98, 37353946602116176, 89701402, 89701406, 4, 640x360 
0x1382CA98, 37353946602434512, 89701434, 89701436, 2, 640x360 
0x1382CA98, 37353946602755600, 89701460, 89701462, 2, 640x360 
0x1382CA98, 37353946603084112, 89701494, 89701496, 2, 640x360 
0x1382CA98, 37353946603413360, 89701537, 89701546, 9, 640x360 
0x1382CA98, 37353946603876752, 89701580, 89701584, 4, 640x360 
0x1382CA98, 37353946604195976, 89701605, 89701607, 2, 640x360 
0x1382CA98, 37353946604513600, 89701640, 89701642, 2, 640x360 
0x1382CA98, 37353946604842608, 89701678, 89701684, 6, 640x360 
0x1382CA98, 37353946605154120, 89701702, 89701706, 4, 640x360 
0x1382CA98, 37353946605477920, 89701739, 89701741, 2, 640x360 
0x1382CA98, 37353946605793984, 89701769, 89701772, 3, 640x360 
0x1382CA98, 37353946606120240, 89701800, 89701803, 3, 640x360 
0x1382CA98, 37353946606434256, 89701830, 89701834, 4, 640x360 
0x1382CA98, 37353946606763672, 89701869, 89701871, 2, 640x360 
0x1382CA98, 37353946607094784, 89701895, 89701908, 13, 640x360 
0x1382CA98, 37353946607393792, 89701931, 89701936, 5, 640x360 
0x1382CA98, 37353946607876664, 89701983, 89701991, 8, 640x360 
0x1382CA98, 37353946608193184, 89702017, 89702019, 2, 640x360 
0x1382CA98, 37353946608519088, 89702037, 89702044, 7, 640x360 
0x1382CA98, 37353946608850240, 89702082, 89702085, 3, 640x360 
0x1382CA98, 37353946609173248, 89702113, 89702125, 12, 640x360 
0x1382CA98, 37353946609478008, 89702151, 89702161, 10, 640x360 
0x1382CA98, 37353946609820136, 89702175, 89702177, 2, 640x360 
0x1382CA98, 37353946610116624, 89702203, 89702206, 3, 640x360 
0x1382CA98, 37353946610436016, 89702241, 89702242, 1, 640x360 
0x1382CA98, 37353946610783336, 89702279, 89702285, 6, 640x360 
0x1382CA98, 37353946611107160, 89702308, 89702310, 2, 640x360 
0x1382CA98, 37353946611394360, 89702327, 89702330, 3, 640x360 
0x1382CA98, 37353946611872720, 89702382, 89702389, 7, 640x360 
0x1382CA98, 37353946612193048, 89702413, 89702418, 5, 640x360 
0x1382CA98, 37353946612521936, 89702440, 89702442, 2, 640x360 
0x1382CA98, 37353946612837176, 89702486, 89702489, 3, 640x360 
0x1382CA98, 37353946613161248, 89702501, 89702504, 3, 640x360 
0x1382CA98, 37353946613481424, 89702551, 89702555, 4, 640x360 
0x1382CA98, 37353946613799448, 89702564, 89702573, 9, 640x360 
0x1382CA98, 37353946614117032, 89702597, 89702601, 4, 640x360 
0x1382CA98, 37353946614433704, 89702640, 89702642, 2, 640x360 
0x1382CA98, 37353946614756152, 89702665, 89702668, 3, 640x360 
0x1382CA98, 37353946615094784, 89702699, 89702710, 11, 640x360 
0x1382CA98, 37353946615425176, 89702737, 89702742, 5, 640x360 
0x1382CA98, 37353946615872536, 89702784, 89702790, 6, 640x360 
0x1382CA98, 37353946616207768, 89702817, 89702825, 8, 640x360 
0x1382CA98, 37353946616515664, 89702846, 89702850, 4, 640x360 
0x1382CA98, 37353946616841800, 89702878, 89702880, 2, 640x360 
0x1382CA98, 37353946617168456, 89702912, 89702921, 9, 640x360 
0x1382CA98, 37353946617486320, 89702943, 89702948, 5, 640x360 
0x1382CA98, 37353946617800816, 89702974, 89702976, 2, 640x360 
0x1382CA98, 37353946618125008, 89703008, 89703022, 14, 640x360 
0x1382CA98, 37353946618485792, 89703055, 89703059, 4, 640x360 
0x1382CA98, 37353946618772224, 89703076, 89703085, 9, 640x360 
0x1382CA98, 37353946619120496, 89703106, 89703108, 2, 640x360 
0x1382CA98, 37353946619452416, 89703139, 89703160, 21, 640x360 
0x1382CA98, 37353946619724776, 89703175, 89703177, 2, 640x360 
0x1382CA98, 37353946620192432, 89703203, 89703213, 10, 640x360 
0x1382CA98, 37353946620525112, 89703250, 89703259, 9, 640x360 
0x1382CA98, 37353946620836080, 89703271, 89703274, 3, 640x360 
0x1382CA98, 37353946621152696, 89703314, 89703318, 4, 640x360 
0x1382CA98, 37353946621473304, 89703335, 89703338, 3, 640x360 
0x1382CA98, 37353946621793144, 89703371, 89703373, 2, 640x360 
0x1382CA98, 37353946622113184, 89703397, 89703411, 14, 640x360 
0x1382CA98, 37353946622439608, 89703429, 89703433, 4, 640x360 
0x1382CA98, 37353946622775336, 89703461, 89703466, 5, 640x360 
0x1382CA98, 37353946623076512, 89703495, 89703499, 4, 640x360 
0x1382CA98, 37353946623393832, 89703532, 89703537, 5, 640x360 
0x1382CA98, 37353946623719376, 89703560, 89703564, 4, 640x360 
0x1382CA98, 37353946624193728, 89703616, 89703622, 6, 640x360 
0x1382CA98, 37353946624518240, 89703647, 89703657, 10, 640x360 
0x1382CA98, 37353946624833736, 89703684, 89703693, 9, 640x360 
0x1382CA98, 37353946625166136, 89703705, 89703708, 3, 640x360 
0x1382CA98, 37353946625473376, 89703744, 89703747, 3, 640x360 
0x1382CA98, 37353946625798928, 89703770, 89703772, 2, 640x360 
0x1382CA98, 37353946626117608, 89703799, 89703801, 2, 640x360 
0x1382CA98, 37353946626447496, 89703838, 89703841, 3, 640x360 
0x1382CA98, 37353946626768664, 89703866, 89703874, 8, 640x360 
0x1382CA98, 37353946627074336, 89703899, 89703902, 3, 640x360 
0x1382CA98, 37353946627397416, 89703926, 89703935, 9, 640x360 
0x1382CA98, 37353946627714824, 89703967, 89703975, 8, 640x360 
0x1382CA98, 37353946628194816, 89704011, 89704014, 3, 640x360 
0x1382CA98, 37353946628512792, 89704044, 89704046, 2, 640x360 
0x1382CA98, 37353946628837440, 89704074, 89704076, 2, 640x360 
0x1382CA98, 37353946629159264, 89704114, 89704124, 10, 640x360 
0x1382CA98, 37353946629477360, 89704148, 89704153, 5, 640x360 
0x1382CA98, 37353946629800112, 89704168, 89704174, 6, 640x360 
0x1382CA98, 37353946630112656, 89704196, 89704201, 5, 640x360 
0x1382CA98, 37353946630437648, 89704239, 89704241, 2, 640x360 
0x1382CA98, 37353946630754544, 89704261, 89704264, 3, 640x360 
0x1382CA98, 37353946631078272, 89704293, 89704295, 2, 640x360 
0x1382CA98, 37353946631411520, 89704330, 89704336, 6, 640x360 
0x1382CA98, 37353946631713856, 89704358, 89704360, 2, 640x360 
0x1382CA98, 37353946632195600, 89704411, 89704425, 14, 640x360 
0x1382CA98, 37353946632514584, 89704451, 89704454, 3, 640x360 
0x1382CA98, 37353946632839280, 89704474, 89704476, 2, 640x360 
0x1382CA98, 37353946633162104, 89704506, 89704513, 7, 640x360 
0x1382CA98, 37353946633476448, 89704541, 89704551, 10, 640x360 
0x1382CA98, 37353946633794880, 89704565, 89704576, 11, 640x360 
0x1382CA98, 37353946634112400, 89704600, 89704608, 8, 640x360 
0x1382CA98, 37353946634440784, 89704630, 89704641, 11, 640x360 
0x1382CA98, 37353946634782480, 89704664, 89704676, 12, 640x360 
0x1382CA98, 37353946635073656, 89704702, 89704705, 3, 640x360 
0x1382CA98, 37353946635402592, 89704726, 89704729, 3, 640x360 
0x1382CA98, 37353946635714504, 89704766, 89704769, 3, 640x360 
0x1382CA98, 37353946636192936, 89704816, 89704818, 2, 640x360 
0x1382CA98, 37353946636513424, 89704837, 89704844, 7, 640x360 
0x1382CA98, 37353946636837184, 89704872, 89704874, 2, 640x360 
0x1382CA98, 37353946637155576, 89704903, 89704913, 10, 640x360 
0x1382CA98, 37353946637474200, 89704939, 89704949, 10, 640x360 
0x1382CA98, 37353946637804528, 89704965, 89704975, 10, 640x360 
0x1382CA98, 37353946638115040, 89705003, 89705005, 2, 640x360 
0x1382CA98, 37353946638441704, 89705033, 89705037, 4, 640x360 
0x1382CA98, 37353946638754376, 89705060, 89705062, 2, 640x360 
0x1382CA98, 37353946639090440, 89705094, 89705096, 2, 640x360 
0x1382CA98, 37353946639393128, 89705128, 89705132, 4, 640x360 
0x1382CA98, 37353946639713312, 89705160, 89705163, 3, 640x360 
0x1382CA98, 37353946640193072, 89705211, 89705213, 2, 640x360 
0x1382CA98, 37353946640513168, 89705240, 89705243, 3, 640x360 
0x1382CA98, 37353946640832760, 89705273, 89705281, 8, 640x360 
0x1382CA98, 37353946641157488, 89705307, 89705309, 2, 640x360 
0x1382CA98, 37353946641475720, 89705340, 89705345, 5, 640x360 
0x1382CA98, 37353946641792744, 89705370, 89705376, 6, 640x360 
0x1382CA98, 37353946642113416, 89705400, 89705407, 7, 640x360 
0x1382CA98, 37353946642440184, 89705438, 89705446, 8, 640x360 
0x1382CA98, 37353946642769432, 89705468, 89705469, 1, 640x360 
0x1382CA98, 37353946643078904, 89705492, 89705495, 3, 640x360 
0x1382CA98, 37353946643392496, 89705525, 89705528, 3, 640x360 
0x1382CA98, 37353946643712936, 89705560, 89705562, 2, 640x360 
0x1382CA98, 37353946644193392, 89705610, 89705613, 3, 640x360 
0x1382CA98, 37353946644513312, 89705645, 89705648, 3, 640x360 
0x1382CA98, 37353946644835408, 89705669, 89705671, 2, 640x360 
0x1382CA98, 37353946645152168, 89705705, 89705711, 6, 640x360 
0x1382CA98, 37353946645474112, 89705736, 89705739, 3, 640x360 
0x1382CA98, 37353946645795824, 89705770, 89705780, 10, 640x360 
0x1382CA98, 37353946646112912, 89705799, 89705803, 4, 640x360 
0x1382CA98, 37353946646437752, 89705837, 89705840, 3, 640x360 
0x1382CA98, 37353946646752384, 89705861, 89705864, 3, 640x360 
0x1382CA98, 37353946647079272, 89705900, 89705903, 3, 640x360 
0x1382CA98, 37353946647392416, 89705923, 89705930, 7, 640x360 
0x1382CA98, 37353946647712512, 89705966, 89705970, 4, 640x360 
0x1382CA98, 37353946648032424, 89705998, 89706002, 4, 640x360 
0x1382CA98, 37353946648512064, 89706043, 89706045, 2, 640x360 
0x1382CA98, 37353946648837072, 89706070, 89706073, 3, 640x360 
0x1382CA98, 37353946649154376, 89706100, 89706114, 14, 640x360 
0x1382CA98, 37353946649472200, 89706136, 89706140, 4, 640x360 
0x1382CA98, 37353946649798568, 89706165, 89706176, 11, 640x360 
0x1382CA98, 37353946650121552, 89706200, 89706206, 6, 640x360 
0x1382CA98, 37353946650435344, 89706226, 89706231, 5, 640x360 
0x1382CA98, 37353946650756616, 89706268, 89706271, 3, 640x360 
0x1382CA98, 37353946651077280, 89706294, 89706296, 2, 640x360 
0x1382CA98, 37353946651393208, 89706326, 89706329, 3, 640x360 
0x1382CA98, 37353946651713632, 89706363, 89706369, 6, 640x360 
0x1382CA98, 37353946652033312, 89706389, 89706393, 4, 640x360 
0x1382CA98, 37353946652512800, 89706437, 89706439, 2, 640x360 
0x1382CA98, 37353946652842784, 89706473, 89706475, 2, 640x360 
0x1382CA98, 37353946653152248, 89706506, 89706512, 6, 640x360 
0x1382CA98, 37353946653473472, 89706538, 89706543, 5, 640x360 
0x1382CA98, 37353946653793664, 89706564, 89706567, 3, 640x360 
0x1382CA98, 37353946654112560, 89706596, 89706598, 2, 640x360 
0x1382CA98, 37353946654433344, 89706631, 89706642, 11, 640x360 
0x1382CA98, 37353946654761312, 89706669, 89706671, 2, 640x360 
0x1382CA98, 37353946655077704, 89706701, 89706705, 4, 640x360 
0x1382CA98, 37353946655392672, 89706737, 89706739, 2, 640x360 
0x1382CA98, 37353946655712384, 89706762, 89706764, 2, 640x360 
0x1382CA98, 37353946656036544, 89706789, 89706795, 6, 640x360 
0x1382CA98, 37353946656512656, 89706846, 89706851, 5, 640x360 
0x1382CA98, 37353946656832648, 89706872, 89706881, 9, 640x360 
0x1382CA98, 37353946657156544, 89706912, 89706916, 4, 640x360 
0x1382CA98, 37353946657471696, 89706949, 89706960, 11, 640x360 
0x1382CA98, 37353946657794400, 89706982, 89706993, 11, 640x360 
0x1382CA98, 37353946658117776, 89707016, 89707019, 3, 640x360 
0x1382CA98, 37353946658446928, 89707035, 89707042, 7, 640x360 
0x1382CA98, 37353946658775832, 89707073, 89707083, 10, 640x360 
0x1382CA98, 37353946659076760, 89707105, 89707108, 3, 640x360 
0x1382CA98, 37353946659416792, 89707125, 89707127, 2, 640x360 
0x1382CA98, 37353946659712416, 89707162, 89707164, 2, 640x360 
0x1382CA98, 37353946660032000, 89707201, 89707203, 2, 640x360 
0x1382CA98, 37353946660514936, 89707237, 89707239, 2, 640x360 
0x1382CA98, 37353946660834304, 89707277, 89707283, 6, 640x360 
0x1382CA98, 37353946661157328, 89707305, 89707308, 3, 640x360 
0x1382CA98, 37353946661478416, 89707333, 89707343, 10, 640x360 
0x1382CA98, 37353946661792904, 89707367, 89707374, 7, 640x360 
0x1382CA98, 37353946662112344, 89707405, 89707407, 2, 640x360 
0x1382CA98, 37353946662432208, 89707434, 89707442, 8, 640x360 
0x1382CA98, 37353946662752320, 89707466, 89707471, 5, 640x360 
0x1382CA98, 37353946663078480, 89707496, 89707501, 5, 640x360 
0x1382CA98, 37353946663397480, 89707529, 89707532, 3, 640x360 
0x1382CA98, 37353946663712056, 89707559, 89707562, 3, 640x360 
0x1382CA98, 37353946664031872, 89707598, 89707607, 9, 640x360 
0x1382CA98, 37353946664513040, 89707645, 89707648, 3, 640x360 
0x1382CA98, 37353946664831984, 89707678, 89707681, 3, 640x360 
0x1382CA98, 37353946665151456, 89707703, 89707707, 4, 640x360 
0x1382CA98, 37353946665474712, 89707737, 89707740, 3, 640x360 
0x1382CA98, 37353946665791408, 89707766, 89707770, 4, 640x360 
0x1382CA98, 37353946666115960, 89707796, 89707801, 5, 640x360 
0x1382CA98, 37353946666433144, 89707836, 89707839, 3, 640x360 
0x1382CA98, 37353946666755736, 89707866, 89707875, 9, 640x360 
0x1382CA98, 37353946667075472, 89707902, 89707905, 3, 640x360 
0x1382CA98, 37353946667392152, 89707939, 89707942, 3, 640x360 
0x1382CA98, 37353946667712120, 89707959, 89707961, 2, 640x360 
0x1382CA98, 37353946668034464, 89707988, 89707992, 4, 640x360 
0x1382CA98, 37353946668511424, 89708037, 89708044, 7, 640x360 
0x1382CA98, 37353946668835768, 89708073, 89708079, 6, 640x360 
0x1382CA98, 37353946669153080, 89708107, 89708119, 12, 640x360 
0x1382CA98, 37353946669471704, 89708151, 89708154, 3, 640x360 
0x1382CA98, 37353946669792896, 89708172, 89708174, 2, 640x360 
0x1382CA98, 37353946670111520, 89708196, 89708199, 3, 640x360 
0x1382CA98, 37353946670433520, 89708235, 89708238, 3, 640x360 
0x1382CA98, 37353946670754536, 89708260, 89708262, 2, 640x360 
0x1382CA98, 37353946671071976, 89708294, 89708298, 4, 640x360 
0x1382CA98, 37353946671392920, 89708327, 89708329, 2, 640x360 
0x1382CA98, 37353946671712824, 89708366, 89708375, 9, 640x360 
0x1382CA98, 37353946672033096, 89708389, 89708392, 3, 640x360 
0x1382CA98, 37353946672516656, 89708444, 89708448, 4, 640x360 
0x1382CA98, 37353946672847944, 89708485, 89708487, 2, 640x360 
0x1382CA98, 37353946673151816, 89708505, 89708508, 3, 640x360 
0x1382CA98, 37353946673473744, 89708541, 89708543, 2, 640x360 
0x1382CA98, 37353946673816896, 89708580, 89708585, 5, 640x360 
0x1382CA98, 37353946674123656, 89708612, 89708617, 5, 640x360 
0x1382CA98, 37353946674440256, 89708631, 89708642, 11, 640x360 
0x1382CA98, 37353946674757608, 89708669, 89708672, 3, 640x360 
0x1382CA98, 37353946675072496, 89708696, 89708699, 3, 640x360 
0x1382CA98, 37353946675391856, 89708738, 89708746, 8, 640x360 
0x1382CA98, 37353946675712656, 89708768, 89708770, 2, 640x360 
0x1382CA98, 37353946676031568, 89708790, 89708793, 3, 640x360 
0x1382CA98, 37353946676355504, 89708823, 89708829, 6, 640x360 
0x1382CA98, 37353946676834712, 89708870, 89708874, 4, 640x360 
0x1382CA98, 37353946677154720, 89708908, 89708910, 2, 640x360 
0x1382CA98, 37353946677471944, 89708934, 89708938, 4, 640x360 
0x1382CA98, 37353946677796480, 89708964, 89708969, 5, 640x360 
0x1382CA98, 37353946678112200, 89708996, 89709003, 7, 640x360 
0x1382CA98, 37353946678431944, 89709030, 89709035, 5, 640x360 
0x1382CA98, 37353946678758352, 89709062, 89709068, 6, 640x360 
0x1382CA98, 37353946679075848, 89709091, 89709093, 2, 640x360 
0x1382CA98, 37353946679392048, 89709124, 89709127, 3, 640x360 
0x1382CA98, 37353946679712384, 89709158, 89709161, 3, 640x360 
0x1382CA98, 37353946680032352, 89709201, 89709211, 10, 640x360 
0x1382CA98, 37353946680354848, 89709224, 89709231, 7, 640x360 
0x1382CA98, 37353946680831792, 89709278, 89709282, 4, 640x360 
0x1382CA98, 37353946681156992, 89709318, 89709321, 3, 640x360 
0x1382CA98, 37353946681471408, 89709351, 89709360, 9, 640x360 
0x1382CA98, 37353946681817240, 89709385, 89709388, 3, 640x360 
0x1382CA98, 37353946682124272, 89709406, 89709412, 6, 640x360 
0x1382CA98, 37353946682468848, 89709443, 89709445, 2, 640x360 
0x1382CA98, 37353946682762728, 89709464, 89709470, 6, 640x360 
0x1382CA98, 37353946683079936, 89709498, 89709502, 4, 640x360 
0x1382CA98, 37353946683406304, 89709532, 89709536, 4, 640x360 
0x1382CA98, 37353946683711752, 89709564, 89709568, 4, 640x360 
0x1382CA98, 37353946684035880, 89709591, 89709593, 2, 640x360 
0x1382CA98, 37353946684358744, 89709624, 89709627, 3, 640x360 
0x1382CA98, 37353946684832064, 89709665, 89709669, 4, 640x360 
0x1382CA98, 37353946685152192, 89709706, 89709709, 3, 640x360 
0x1382CA98, 37353946685471696, 89709738, 89709741, 3, 640x360 
0x1382CA98, 37353946685792008, 89709761, 89709764, 3, 640x360 
0x1382CA98, 37353946686118584, 89709802, 89709804, 2, 640x360 
0x1382CA98, 37353946686431776, 89709836, 89709839, 3, 640x360 
0x1382CA98, 37353946686752496, 89709863, 89709870, 7, 640x360 
0x1382CA98, 37353946687080888, 89709895, 89709901, 6, 640x360 
0x1382CA98, 37353946687392304, 89709929, 89709933, 4, 640x360 
0x1382CA98, 37353946687722624, 89709957, 89709960, 3, 640x360 
0x1382CA98, 37353946688037032, 89709993, 89709995, 2, 640x360 
0x1382CA98, 37353946688355920, 89710026, 89710029, 3, 640x360 
0x1382CA98, 37353946688836760, 89710068, 89710072, 4, 640x360 
0x1382CA98, 37353946689155328, 89710101, 89710104, 3, 640x360 
0x1382CA98, 37353946689475040, 89710132, 89710136, 4, 640x360 
0x1382CA98, 37353946689791656, 89710165, 89710169, 4, 640x360 
0x1382CA98, 37353946690111792, 89710196, 89710202, 6, 640x360 
0x1382CA98, 37353946690432144, 89710227, 89710232, 5, 640x360 
0x1382CA98, 37353946690753328, 89710268, 89710272, 4, 640x360 
0x1382CA98, 37353946691076408, 89710295, 89710301, 6, 640x360 
0x1382CA98, 37353946691392392, 89710335, 89710339, 4, 640x360 
0x1382CA98, 37353946691712464, 89710370, 89710375, 5, 640x360 
0x1382CA98, 37353946692032792, 89710393, 89710406, 13, 640x360 
0x1382CA98, 37353946692358464, 89710424, 89710434, 10, 640x360 
0x1382CA98, 37353946692835096, 89710476, 89710482, 6, 640x360 
0x1382CA98, 37353946693154792, 89710516, 89710521, 5, 640x360 
0x1382CA98, 37353946693478112, 89710543, 89710545, 2, 640x360 
0x1382CA98, 37353946693805624, 89710577, 89710579, 2, 640x360 
0x1382CA98, 37353946694111176, 89710600, 89710603, 3, 640x360 
0x1382CA98, 37353946694439072, 89710629, 89710632, 3, 640x360 
0x1382CA98, 37353946694766760, 89710665, 89710667, 2, 640x360 
0x1382CA98, 37353946695075128, 89710695, 89710697, 2, 640x360 
0x1382CA98, 37353946695391880, 89710726, 89710728, 2, 640x360 
0x1382CA98, 37353946695716120, 89710773, 89710775, 2, 640x360 
0x1382CA98, 37353946696032296, 89710801, 89710804, 3, 640x360 
0x1382CA98, 37353946696351016, 89710829, 89710831, 2, 640x360 
0x1382CA98, 37353946696835240, 89710885, 89710888, 3, 640x360 
0x1382CA98, 37353946697151440, 89710908, 89710912, 4, 640x360 
0x1382CA98, 37353946697473328, 89710949, 89710954, 5, 640x360 
0x1382CA98, 37353946697790784, 89710974, 89710976, 2, 640x360 
0x1382CA98, 37353946698111808, 89711008, 89711010, 2, 640x360 
0x1382CA98, 37353946698430840, 89711036, 89711040, 4, 640x360 
0x1382CA98, 37353946698755776, 89711068, 89711070, 2, 640x360 
0x1382CA98, 37353946699076240, 89711103, 89711105, 2, 640x360 
0x1382CA98, 37353946699393200, 89711136, 89711138, 2, 640x360 
0x1382CA98, 37353946699711168, 89711164, 89711170, 6, 640x360 
0x1382CA98, 37353946700031720, 89711196, 89711200, 4, 640x360 
0x1382CA98, 37353946700351144, 89711228, 89711230, 2, 640x360 
0x1382CA98, 37353946700830960, 89711279, 89711282, 3, 640x360 
0x1382CA98, 37353946701153800, 89711303, 89711312, 9, 640x360 
0x1382CA98, 37353946701471632, 89711351, 89711354, 3, 640x360 
0x1382CA98, 37353946701794648, 89711373, 89711375, 2, 640x360 
0x1382CA98, 37353946702111072, 89711394, 89711397, 3, 640x360 
0x1382CA98, 37353946702431232, 89711428, 89711431, 3, 640x360 
0x1382CA98, 37353946702760408, 89711466, 89711478, 12, 640x360 
0x1382CA98, 37353946703072304, 89711502, 89711511, 9, 640x360 
0x1382CA98, 37353946703411376, 89711538, 89711542, 4, 640x360 
0x1382CA98, 37353946703719712, 89711564, 89711585, 21, 640x360 
0x1382CA98, 37353946704053648, 89711596, 89711607, 11, 640x360 
0x1382CA98, 37353946704354808, 89711629, 89711632, 3, 640x360 
0x1382CA98, 37353946704672800, 89711664, 89711668, 4, 640x360 
0x1382CA98, 37353946705152880, 89711711, 89711713, 2, 640x360 
0x1382CA98, 37353946705479040, 89711748, 89711752, 4, 640x360 
0x1382CA98, 37353946705792088, 89711766, 89711773, 7, 640x360 
0x1382CA98, 37353946706111352, 89711805, 89711807, 2, 640x360 
0x1382CA98, 37353946706430456, 89711828, 89711834, 6, 640x360 
0x1382CA98, 37353946706765824, 89711864, 89711872, 8, 640x360 
0x1382CA98, 37353946707071888, 89711895, 89711898, 3, 640x360 
0x1382CA98, 37353946707395448, 89711937, 89711945, 8, 640x360 
0x1382CA98, 37353946707711272, 89711962, 89711970, 8, 640x360 
0x1382CA98, 37353946708030944, 89711989, 89711991, 2, 640x360 
0x1382CA98, 37353946708350864, 89712025, 89712026, 1, 640x360 
0x1382CA98, 37353946708671032, 89712057, 89712059, 2, 640x360 
0x1382CA98, 37353946709151768, 89712106, 89712112, 6, 640x360 
0x1382CA98, 37353946709511952, 89712138, 89712151, 13, 640x360 
0x1382CA98, 37353946709812000, 89712171, 89712178, 7, 640x360 
0x1382CA98, 37353946710114920, 89712199, 89712204, 5, 640x360 
0x1382CA98, 37353946710430688, 89712230, 89712240, 10, 640x360 
0x1382CA98, 37353946710762336, 89712261, 89712263, 2, 640x360 
0x1382CA98, 37353946711073984, 89712293, 89712295, 2, 640x360 
0x1382CA98, 37353946711390808, 89712330, 89712343, 13, 640x360 
0x1382CA98, 37353946711711384, 89712362, 89712372, 10, 640x360 
0x1382CA98, 37353946712031376, 89712402, 89712405, 3, 640x360 
0x1382CA98, 37353946712359096, 89712428, 89712433, 5, 640x360 
0x1382CA98, 37353946712675464, 89712454, 89712460, 6, 640x360 
0x1382CA98, 37353946713150144, 89712510, 89712512, 2, 640x360 
0x1382CA98, 37353946713474288, 89712539, 89712542, 3, 640x360 
0x1382CA98, 37353946713790888, 89712574, 89712585, 11, 640x360 
0x1382CA98, 37353946714113240, 89712597, 89712610, 13, 640x360 
0x1382CA98, 37353946714437704, 89712629, 89712641, 12, 640x360 
0x1382CA98, 37353946714761040, 89712667, 89712672, 5, 640x360 
0x1382CA98, 37353946715078784, 89712702, 89712711, 9, 640x360 
0x1382CA98, 37353946715390456, 89712739, 89712742, 3, 640x360 
0x1382CA98, 37353946715710336, 89712765, 89712770, 5, 640x360 
0x1382CA98, 37353946716030384, 89712788, 89712795, 7, 640x360 
0x1382CA98, 37353946716354032, 89712821, 89712828, 7, 640x360 
0x1382CA98, 37353946716671152, 89712857, 89712866, 9, 640x360 
0x1382CA98, 37353946717155520, 89712908, 89712912, 4, 640x360 
0x1382CA98, 37353946717475344, 89712957, 89712965, 8, 640x360 
0x1382CA98, 37353946717794760, 89712973, 89712982, 9, 640x360 
0x1382CA98, 37353946718117616, 89713006, 89713012, 6, 640x360 
0x1382CA98, 37353946718463896, 89713045, 89713057, 12, 640x360 
0x1382CA98, 37353946718795872, 89713073, 89713080, 7, 640x360 
0x1382CA98, 37353946719072544, 89713100, 89713103, 3, 640x360 
0x1382CA98, 37353946719397752, 89713130, 89713135, 5, 640x360 
0x1382CA98, 37353946719710912, 89713166, 89713176, 10, 640x360 
0x1382CA98, 37353946720031008, 89713209, 89713211, 2, 640x360 
0x1382CA98, 37353946720350672, 89713229, 89713232, 3, 640x360 
0x1382CA98, 37353946720673224, 89713255, 89713261, 6, 640x360 
0x1382CA98, 37353946721158816, 89713317, 89713320, 3, 640x360 
0x1382CA98, 37353946721470744, 89713336, 89713341, 5, 640x360 
0x1382CA98, 37353946721790040, 89713363, 89713372, 9, 640x360 
0x1382CA98, 37353946722110488, 89713404, 89713406, 2, 640x360 
0x1382CA98, 37353946722430128, 89713440, 89713443, 3, 640x360 
0x1382CA98, 37353946722750952, 89713468, 89713471, 3, 640x360 
0x1382CA98, 37353946723078144, 89713501, 89713506, 5, 640x360 
0x1382CA98, 37353946723390944, 89713528, 89713534, 6, 640x360 
0x1382CA98, 37353946723710712, 89713569, 89713573, 4, 640x360 
0x1382CA98, 37353946724030464, 89713595, 89713602, 7, 640x360 
0x1382CA98, 37353946724350328, 89713623, 89713625, 2, 640x360 
0x1382CA98, 37353946724670408, 89713664, 89713673, 9, 640x360 
0x1382CA98, 37353946725149848, 89713697, 89713709, 12, 640x360 
0x1382CA98, 37353946725533296, 89713753, 89713758, 5, 640x360 
0x1382CA98, 37353946725874920, 89713782, 89713797, 15, 640x360 
0x1382CA98, 37353946726204520, 89713826, 89713838, 12, 640x360 
0x1382CA98, 37353946726517592, 89713884, 89713901, 17, 640x360 
0x1382CA98, 37353946726966648, 89713902, 89713910, 8, 640x360 
0x1382CA98, 37353946727133264, 89713925, 89713931, 6, 640x360 
0x1382CA98, 37353946727452608, 89713955, 89713958, 3, 640x360 
0x1382CA98, 37353946727712096, 89713978, 89713981, 3, 640x360 
0x1382CA98, 37353946728033312, 89713995, 89713997, 2, 640x360 
0x1382CA98, 37353946728362024, 89714035, 89714038, 3, 640x360 
0x1382CA98, 37353946728674096, 89714056, 89714064, 8, 640x360 
0x1382CA98, 37353946728994072, 89714091, 89714093, 2, 640x360 
0x1382CA98, 37353946729474928, 89714137, 89714143, 6, 640x360 
0x1382CA98, 37353946729795016, 89714164, 89714176, 12, 640x360 
0x1382CA98, 37353946730111528, 89714196, 89714204, 8, 640x360 
0x1382CA98, 37353946730433320, 89714229, 89714232, 3, 640x360 
0x1382CA98, 37353946730762824, 89714262, 89714267, 5, 640x360 
0x1382CA98, 37353946731080704, 89714294, 89714298, 4, 640x360 
0x1382CA98, 37353946731393976, 89714335, 89714338, 3, 640x360 
0x1382CA98, 37353946731720000, 89714366, 89714369, 3, 640x360 
0x1382CA98, 37353946732030200, 89714393, 89714395, 2, 640x360 
0x1382CA98, 37353946732351184, 89714430, 89714435, 5, 640x360 
0x1382CA98, 37353946732679640, 89714460, 89714462, 2, 640x360 
0x1382CA98, 37353946732998184, 89714493, 89714499, 6, 640x360 
0x1382CA98, 37353946733479960, 89714541, 89714546, 5, 640x360 
0x1382CA98, 37353946733801080, 89714568, 89714573, 5, 640x360 
0x1382CA98, 37353946734112256, 89714602, 89714612, 10, 640x360 
0x1382CA98, 37353946734453352, 89714634, 89714646, 12, 640x360 
0x1382CA98, 37353946734779208, 89714666, 89714671, 5, 640x360 
0x1382CA98, 37353946735077216, 89714694, 89714698, 4, 640x360 
0x1382CA98, 37353946735393536, 89714731, 89714742, 11, 640x360 
0x1382CA98, 37353946735710128, 89714768, 89714771, 3, 640x360 
0x1382CA98, 37353946736042216, 89714794, 89714795, 1, 640x360 
0x1382CA98, 37353946736350368, 89714822, 89714828, 6, 640x360 
0x1382CA98, 37353946736671296, 89714854, 89714862, 8, 640x360 
0x1382CA98, 37353946736990536, 89714888, 89714896, 8, 640x360 
0x1382CA98, 37353946737469656, 89714931, 89714942, 11, 640x360 
0x1382CA98, 37353946737794960, 89714964, 89714974, 10, 640x360 
0x1382CA98, 37353946738110608, 89715003, 89715006, 3, 640x360 
0x1382CA98, 37353946738437216, 89715029, 89715034, 5, 640x360 
0x1382CA98, 37353946738758504, 89715064, 89715071, 7, 640x360 
0x1382CA98, 37353946739076320, 89715096, 89715101, 5, 640x360 
0x1382CA98, 37353946739390472, 89715138, 89715148, 10, 640x360 
0x1382CA98, 37353946739725504, 89715170, 89715173, 3, 640x360 
0x1382CA98, 37353946740029920, 89715189, 89715191, 2, 640x360 
0x1382CA98, 37353946740350264, 89715228, 89715230, 2, 640x360 
0x1382CA98, 37353946740670088, 89715257, 89715259, 2, 640x360 
0x1382CA98, 37353946740990144, 89715296, 89715298, 2, 640x360 
0x1382CA98, 37353946741469248, 89715336, 89715343, 7, 640x360 
0x1382CA98, 37353946741791432, 89715366, 89715373, 7, 640x360 
0x1382CA98, 37353946742110944, 89715407, 89715409, 2, 640x360 
0x1382CA98, 37353946742430856, 89715433, 89715436, 3, 640x360 
0x1382CA98, 37353946742755120, 89715460, 89715462, 2, 640x360 
0x1382CA98, 37353946743077992, 89715494, 89715495, 1, 640x360 
0x1382CA98, 37353946743393096, 89715537, 89715539, 2, 640x360 
0x1382CA98, 37353946743709952, 89715562, 89715564, 2, 640x360 
0x1382CA98, 37353946744031216, 89715592, 89715594, 2, 640x360 
0x1382CA98, 37353946744352936, 89715621, 89715624, 3, 640x360 
0x1382CA98, 37353946744670400, 89715657, 89715659, 2, 640x360 
0x1382CA98, 37353946744991384, 89715689, 89715694, 5, 640x360 
0x1382CA98, 37353946745474960, 89715742, 89715748, 6, 640x360 
0x1382CA98, 37353946745804920, 89715778, 89715780, 2, 640x360 
0x1382CA98, 37353946746110456, 89715803, 89715811, 8, 640x360 
0x1382CA98, 37353946746446904, 89715829, 89715836, 7, 640x360 
0x1382CA98, 37353946746757840, 89715869, 89715873, 4, 640x360 
0x1382CA98, 37353946747076032, 89715895, 89715900, 5, 640x360 
0x1382CA98, 37353946747389712, 89715939, 89715948, 9, 640x360 
0x1382CA98, 37353946747740952, 89715969, 89715971, 2, 640x360 
0x1382CA98, 37353946748033832, 89715990, 89715993, 3, 640x360 
0x1382CA98, 37353946748350856, 89716025, 89716026, 1, 640x360 
0x1382CA98, 37353946748676336, 89716059, 89716061, 2, 640x360 
0x1382CA98, 37353946749000928, 89716096, 89716098, 2, 640x360 
0x1382CA98, 37353946749479600, 89716152, 89716162, 10, 640x360 
0x1382CA98, 37353946749863512, 89716192, 89716201, 9, 640x360 
0x1382CA98, 37353946750125504, 89716211, 89716214, 3, 640x360 
0x1382CA98, 37353946750429904, 89716242, 89716245, 3, 640x360 
0x1382CA98, 37353946750755600, 89716273, 89716275, 2, 640x360 
0x1382CA98, 37353946751086232, 89716312, 89716326, 14, 640x360 
0x1382CA98, 37353946751390400, 89716348, 89716354, 6, 640x360 
0x1382CA98, 37353946751712840, 89716374, 89716377, 3, 640x360 
0x1382CA98, 37353946752033144, 89716402, 89716416, 14, 640x360 
0x1382CA98, 37353946752353768, 89716435, 89716437, 2, 640x360 
0x1382CA98, 37353946752669640, 89716467, 89716474, 7, 640x360 
0x1382CA98, 37353946752993296, 89716495, 89716500, 5, 640x360 
0x1382CA98, 37353946753471720, 89716531, 89716541, 10, 640x360 
0x1382CA98, 37353946753794672, 89716572, 89716580, 8, 640x360 
0x1382CA98, 37353946754110232, 89716598, 89716603, 5, 640x360 
0x1382CA98, 37353946754445032, 89716629, 89716636, 7, 640x360 
0x1382CA98, 37353946754756864, 89716667, 89716676, 9, 640x360 
0x1382CA98, 37353946755070376, 89716694, 89716701, 7, 640x360 
0x1382CA98, 37353946755389432, 89716736, 89716745, 9, 640x360 
0x1382CA98, 37353946755710440, 89716768, 89716770, 2, 640x360 
0x1382CA98, 37353946756029496, 89716790, 89716793, 3, 640x360 
0x1382CA98, 37353946756350504, 89716828, 89716830, 2, 640x360 
0x1382CA98, 37353946756672072, 89716863, 89716868, 5, 640x360 
0x1382CA98, 37353946756994528, 89716886, 89716893, 7, 640x360 
0x1382CA98, 37353946757313392, 89716929, 89716935, 6, 640x360 
0x1382CA98, 37353946757789544, 89716966, 89716974, 8, 640x360 
0x1382CA98, 37353946758114608, 89716995, 89716999, 4, 640x360 
0x1382CA98, 37353946758429216, 89717029, 89717031, 2, 640x360 
0x1382CA98, 37353946758755112, 89717069, 89717071, 2, 640x360 
0x1382CA98, 37353946759075048, 89717101, 89717110, 9, 640x360 
0x1382CA98, 37353946759389920, 89717138, 89717146, 8, 640x360 
0x1382CA98, 37353946759715272, 89717173, 89717175, 2, 640x360 
0x1382CA98, 37353946760030224, 89717200, 89717209, 9, 640x360 
0x1382CA98, 37353946760351504, 89717229, 89717232, 3, 640x360 
0x1382CA98, 37353946760669432, 89717252, 89717254, 2, 640x360 
0x1382CA98, 37353946760997784, 89717295, 89717298, 3, 640x360 
0x1382CA98, 37353946761309568, 89717322, 89717324, 2, 640x360 
0x1382CA98, 37353946761793736, 89717365, 89717370, 5, 640x360 
0x1382CA98, 37353946762114136, 89717400, 89717404, 4, 640x360 
0x1382CA98, 37353946762429360, 89717430, 89717442, 12, 640x360 
0x1382CA98, 37353946762750408, 89717468, 89717475, 7, 640x360 
0x1382CA98, 37353946763069976, 89717493, 89717497, 4, 640x360 
0x1382CA98, 37353946763389808, 89717527, 89717529, 2, 640x360 
0x1382CA98, 37353946763709440, 89717559, 89717561, 2, 640x360 
0x1382CA98, 37353946764030168, 89717586, 89717595, 9, 640x360 
0x1382CA98, 37353946764350000, 89717622, 89717624, 2, 640x360 
0x1382CA98, 37353946764670432, 89717653, 89717661, 8, 640x360 
0x1382CA98, 37353946764990592, 89717689, 89717702, 13, 640x360 
0x1382CA98, 37353946765310368, 89717734, 89717737, 3, 640x360 
0x1382CA98, 37353946765789136, 89717785, 89717787, 2, 640x360 
0x1382CA98, 37353946766114440, 89717805, 89717807, 2, 640x360 
0x1382CA98, 37353946766429224, 89717839, 89717841, 2, 640x360 
0x1382CA98, 37353946766770424, 89717871, 89717874, 3, 640x360 
0x1382CA98, 37353946767093568, 89717905, 89717909, 4, 640x360 
0x1382CA98, 37353946767709072, 89717965, 89717974, 9, 320x180 
0x1382CA98, 37353946768351496, 89718021, 89718028, 7, 320x180 
0x1382CA98, 37353946768994328, 89718089, 89718090, 1, 320x180 
0x1382CA98, 37353946769788896, 89718168, 89718176, 8, 320x180 
0x1382CA98, 37353946770433968, 89718229, 89718231, 2, 320x180 
0x1382CA98, 37353946771074472, 89718298, 89718301, 3, 320x180 
0x1382CA98, 37353946772350416, 89718429, 89718431, 2, 320x180 
0x1382CA98, 37353946772989888, 89718487, 89718489, 2, 320x180 
0x1382CA98, 37353946773789272, 89718571, 89718573, 2, 320x180 
0x1382CA98, 37353946774429352, 89718629, 89718635, 6, 320x180 
0x1382CA98, 37353946775069768, 89718701, 89718703, 2, 320x180 
0x1382CA98, 37353946775712928, 89718776, 89718778, 2, 320x180 
0x1382CA98, 37353946776350624, 89718832, 89718836, 4, 320x180 
0x1382CA98, 37353946777032776, 89718894, 89718901, 7, 320x180 
0x1382CA98, 37353946777809672, 89718995, 89719003, 8, 320x180 
0x1382CA98, 37353946778444352, 89719058, 89719083, 25, 320x180 
0x1382CA98, 37353946779106576, 89719128, 89719144, 16, 320x180 
0x1382CA98, 37353946779723264, 89719199, 89719227, 28, 320x180 
0x1382CA98, 37353946780363616, 89719248, 89719287, 39, 320x180 
0x1382CA98, 37353946781029024, 89719329, 89719334, 5, 320x180 
0x1382CA98, 37353946782122992, 89719436, 89719438, 2, 320x180 
0x1382CA98, 37353946782788784, 89719493, 89719494, 1, 320x180 
0x1382CA98, 37353946783415520, 89719546, 89719549, 3, 320x180 
0x1382CA98, 37353946784033432, 89719604, 89719606, 2, 320x180 
0x1382CA98, 37353946784690256, 89719674, 89719677, 3, 320x180 
0x1382CA98, 37353946785318552, 89719729, 89719731, 2, 320x180 
0x1382CA98, 37353946786115400, 89719815, 89719819, 4, 320x180 
0x1382CA98, 37353946786757304, 89719871, 89719873, 2, 320x180 
0x1382CA98, 37353946787391256, 89719941, 89719943, 2, 320x180 
0x1382CA98, 37353946788031584, 89719998, 89720009, 11, 320x180 
0x1382CA98, 37353946788671800, 89720063, 89720065, 2, 320x180 
0x1382CA98, 37353946789315832, 89720126, 89720128, 2, 320x180 
0x1382CA98, 37353946790115264, 89720220, 89720223, 3, 320x180 
0x1382CA98, 37353946790770576, 89720275, 89720276, 1, 320x180 
0x1382CA98, 37353946791389264, 89720361, 89720366, 5, 320x180 
0x1382CA98, 37353946792032744, 89720407, 89720421, 14, 320x180 
0x1382CA98, 37353946792674616, 89720466, 89720488, 22, 320x180 
0x1382CA98, 37353946793309520, 89720526, 89720529, 3, 320x180 
0x1382CA98, 37353946794139616, 89720624, 89720637, 13, 320x180 
0x1382CA98, 37353946794813336, 89720687, 89720693, 6, 320x180 
0x1382CA98, 37353946795425952, 89720739, 89720742, 3, 320x180 
0x1382CA98, 37353946796032056, 89720806, 89720810, 4, 320x180 
0x1382CA98, 37353946796693208, 89720875, 89720877, 2, 320x180 
0x1382CA98, 37353946797308872, 89720936, 89720941, 5, 320x180 
0x1382CA98, 37353946798129632, 89721019, 89721029, 10, 320x180 
0x1382CA98, 37353946798752376, 89721071, 89721083, 12, 320x180 
0x1382CA98, 37353946799389552, 89721152, 89721156, 4, 320x180 
0x1382CA98, 37353946800042968, 89721224, 89721227, 3, 320x180 
0x1382CA98, 37353946800674568, 89721287, 89721292, 5, 320x180 
0x1382CA98, 37353946801381648, 89721351, 89721358, 7, 320x180 
0x1382CA98, 37353946802146536, 89721419, 89721436, 17, 320x180 
0x1382CA98, 37353946802774496, 89721477, 89721479, 2, 320x180 
0x1382CA98, 37353946803390520, 89721543, 89721545, 2, 320x180 
0x1382CA98, 37353946804033456, 89721611, 89721616, 5, 320x180 
0x1382CA98, 37353946804673832, 89721669, 89721671, 2, 320x180 
0x1382CA98, 37353946805314656, 89721732, 89721742, 10, 320x180 
0x1382CA98, 37353946806107888, 89721805, 89721806, 1, 320x180 
0x1382CA98, 37353946806748896, 89721873, 89721875, 2, 320x180 
0x1382CA98, 37353946807388112, 89721929, 89721941, 12, 320x180 
0x1382CA98, 37353946808029008, 89722002, 89722011, 9, 320x180 
0x1382CA98, 37353946808684384, 89722071, 89722083, 12, 320x180 
0x1382CA98, 37353946809313456, 89722135, 89722152, 17, 320x180 
0x1382CA98, 37353946810115760, 89722214, 89722220, 6, 320x180 
0x1382CA98, 37353946810749248, 89722275, 89722277, 2, 320x180 
0x1382CA98, 37353946811388304, 89722338, 89722348, 10, 320x180 
0x1382CA98, 37353946812028200, 89722403, 89722405, 2, 320x180 
0x1382CA98, 37353946812668056, 89722456, 89722465, 9, 320x180 
0x1382CA98, 37353946813320256, 89722533, 89722542, 9, 320x180 
0x1382CA98, 37353946813952648, 89722595, 89722597, 2, 320x180 
0x1382CA98, 37353946814767472, 89722671, 89722678, 7, 320x180 
0x1382CA98, 37353946815387640, 89722727, 89722728, 1, 320x180 
0x1382CA98, 37353946816032048, 89722801, 89722802, 1, 320x180 
0x1382CA98, 37353946816667824, 89722854, 89722856, 2, 320x180 
0x1382CA98, 37353946817307848, 89722926, 89722928, 2, 320x180 
0x1382CA98, 37353946817948144, 89722995, 89723001, 6, 320x180 
0x1382CA98, 37353946818775384, 89723070, 89723077, 7, 320x180 
0x1382CA98, 37353946819461312, 89723151, 89723159, 8, 320x180 
0x1382CA98, 37353946820046104, 89723223, 89723227, 4, 320x180 
0x1382CA98, 37353946820674432, 89723276, 89723278, 2, 320x180 
0x1382CA98, 37353946821318352, 89723326, 89723328, 2, 320x180 
0x1382CA98, 37353946821967824, 89723395, 89723398, 3, 320x180 
0x1382CA98, 37353946822782696, 89723474, 89723490, 16, 320x180 
0x1382CA98, 37353946823396056, 89723556, 89723559, 3, 320x180 
0x1382CA98, 37353946824036496, 89723638, 89723646, 8, 320x180 
0x1382CA98, 37353946824733792, 89723682, 89723702, 20, 320x180 
0x1382CA98, 37353946825319192, 89723740, 89723754, 14, 320x180 
0x1382CA98, 37353946825964504, 89723809, 89723811, 2, 320x180 
0x1382CA98, 37353946826763056, 89723884, 89723887, 3, 320x180 
0x1382CA98, 37353946827398456, 89723934, 89723949, 15, 320x180 
0x1382CA98, 37353946828048272, 89724013, 89724021, 8, 320x180 
0x1382CA98, 37353946828674904, 89724058, 89724062, 4, 320x180 
0x1382CA98, 37353946829327192, 89724139, 89724144, 5, 320x180 
0x1382CA98, 37353946829954936, 89724190, 89724195, 5, 320x180 
0x1382CA98, 37353946830804872, 89724274, 89724276, 2, 320x180 
0x1382CA98, 37353946831388352, 89724354, 89724356, 2, 320x180 
0x1382CA98, 37353946832027352, 89724390, 89724401, 11, 320x180 
0x1382CA98, 37353946832669304, 89724462, 89724463, 1, 320x180 
0x1382CA98, 37353946833308368, 89724541, 89724542, 1, 320x180 
0x1382CA98, 37353946833971048, 89724590, 89724593, 3, 320x180 
0x1382CA98, 37353946834752224, 89724672, 89724674, 2, 320x180 
0x1382CA98, 37353946835422096, 89724739, 89724744, 5, 320x180 
0x1382CA98, 37353946836053736, 89724803, 89724805, 2, 320x180 
0x1382CA98, 37353946836681520, 89724869, 89724871, 2, 320x180 
0x1382CA98, 37353946837307408, 89724927, 89724929, 2, 320x180 
0x1382CA98, 37353946837957112, 89724990, 89724992, 2, 320x180 
0x1382CA98, 37353946838750712, 89725070, 89725075, 5, 320x180 
0x1382CA98, 37353946839388448, 89725140, 89725142, 2, 320x180 
0x1382CA98, 37353946840027032, 89725203, 89725205, 2, 320x180 
0x1382CA98, 37353946840667904, 89725259, 89725260, 1, 320x180 
0x1382CA98, 37353946841311848, 89725325, 89725328, 3, 320x180 
0x1382CA98, 37353946841953040, 89725406, 89725420, 14, 320x180 
0x1382CA98, 37353946842751712, 89725474, 89725486, 12, 320x180 
0x1382CA98, 37353946843457256, 89725557, 89725561, 4, 320x180 
0x1382CA98, 37353946844031104, 89725598, 89725602, 4, 320x180 
0x1382CA98, 37353946844666968, 89725660, 89725661, 1, 320x180 
0x1382CA98, 37353946845307712, 89725726, 89725728, 2, 320x180 
0x1382CA98, 37353946845968344, 89725792, 89725794, 2, 320x180 
0x1382CA98, 37353946846778296, 89725876, 89725877, 1, 320x180 
0x1382CA98, 37353946847390624, 89725940, 89725943, 3, 320x180 
0x1382CA98, 37353946848028088, 89726000, 89726010, 10, 320x180 
0x1382CA98, 37353946848673944, 89726078, 89726099, 21, 320x180 
0x1382CA98, 37353946849343800, 89726140, 89726154, 14, 320x180 
0x1382CA98, 37353946850013928, 89726211, 89726220, 9, 320x180 
0x1382CA98, 37353946850764232, 89726272, 89726275, 3, 320x180 
0x1382CA98, 37353946851392304, 89726332, 89726334, 2, 320x180 
0x1382CA98, 37353946852035392, 89726396, 89726406, 10, 320x180 
0x1382CA98, 37353946852681568, 89726472, 89726480, 8, 320x180 
0x1382CA98, 37353946853307472, 89726528, 89726529, 1, 320x180 
0x1382CA98, 37353946853961136, 89726589, 89726592, 3, 320x180 
0x1382CA98, 37353946854756520, 89726680, 89726684, 4, 320x180 
0x1382CA98, 37353946855391384, 89726758, 89726768, 10, 320x180 
0x1382CA98, 37353946856031608, 89726795, 89726797, 2, 320x180 
0x1382CA98, 37353946856669480, 89726867, 89726871, 4, 320x180 
0x1382CA98, 37353946857312712, 89726929, 89726935, 6, 320x180 
0x1382CA98, 37353946857947176, 89727024, 89727025, 1, 320x180 
0x1382CA98, 37353946858752832, 89727066, 89727077, 11, 320x180 
0x1382CA98, 37353946859393336, 89727140, 89727144, 4, 320x180 
0x1382CA98, 37353946860027312, 89727195, 89727199, 4, 320x180 
0x1382CA98, 37353946860677448, 89727282, 89727283, 1, 320x180 
0x1382CA98, 37353946861312296, 89727328, 89727331, 3, 320x180 
0x1382CA98, 37353946862749640, 89727470, 89727478, 8, 640x360 
0x1382CA98, 37353946863067920, 89727503, 89727510, 7, 640x360 
0x1382CA98, 37353946863387032, 89727533, 89727541, 8, 640x360 
0x1382CA98, 37353946863710144, 89727566, 89727580, 14, 640x360 
0x1382CA98, 37353946864047184, 89727598, 89727603, 5, 640x360 
0x1382CA98, 37353946864350232, 89727635, 89727638, 3, 640x360 
0x1382CA98, 37353946864669696, 89727689, 89727698, 9, 640x360 
0x1382CA98, 37353946865005960, 89727698, 89727703, 5, 640x360 
0x1382CA98, 37353946865316896, 89727729, 89727735, 6, 640x360 
0x1382CA98, 37353946865632864, 89727764, 89727775, 11, 640x360 
0x1382CA98, 37353946865960208, 89727795, 89727801, 6, 640x360 
0x1382CA98, 37353946866279096, 89727829, 89727854, 25, 640x360 
0x1382CA98, 37353946866650712, 89727870, 89727874, 4, 640x360 
0x1382CA98, 37353946867091656, 89727902, 89727905, 3, 640x360 
0x1382CA98, 37353946867391240, 89727939, 89727943, 4, 640x360 
0x1382CA98, 37353946867707160, 89727973, 89727978, 5, 640x360 
0x1382CA98, 37353946868042576, 89728026, 89728029, 3, 640x360 
0x1382CA98, 37353946868360720, 89728034, 89728038, 4, 640x360 
0x1382CA98, 37353946868695008, 89728064, 89728080, 16, 640x360 
0x1382CA98, 37353946869021528, 89728096, 89728101, 5, 640x360 
0x1382CA98, 37353946869317992, 89728124, 89728128, 4, 640x360 
0x1382CA98, 37353946869672784, 89728172, 89728183, 11, 640x360 
0x1382CA98, 37353946869968576, 89728193, 89728196, 3, 640x360 
0x1382CA98, 37353946870295952, 89728230, 89728241, 11, 640x360 
0x1382CA98, 37353946870612952, 89728256, 89728268, 12, 640x360 
0x1382CA98, 37353946871066648, 89728303, 89728312, 9, 640x360 
0x1382CA98, 37353946871386224, 89728338, 89728341, 3, 640x360 
0x1382CA98, 37353946871706648, 89728376, 89728378, 2, 640x360 
0x1382CA98, 37353946872027008, 89728404, 89728412, 8, 640x360 
0x1382CA98, 37353946872357392, 89728439, 89728442, 3, 640x360 
0x1382CA98, 37353946872668048, 89728458, 89728463, 5, 640x360 
0x1382CA98, 37353946873014080, 89728498, 89728502, 4, 640x360 
0x1382CA98, 37353946873317672, 89728526, 89728529, 3, 640x360 
0x1382CA98, 37353946873669912, 89728579, 89728582, 3, 640x360 
0x1382CA98, 37353946873964152, 89728597, 89728602, 5, 640x360 
0x1382CA98, 37353946874270416, 89728626, 89728628, 2, 640x360 
0x1382CA98, 37353946874623360, 89728658, 89728661, 3, 640x360 
0x1382CA98, 37353946875066232, 89728694, 89728698, 4, 640x360 
0x1382CA98, 37353946875385776, 89728729, 89728734, 5, 640x360 
0x1382CA98, 37353946875710992, 89728771, 89728776, 5, 640x360 
0x1382CA98, 37353946876028288, 89728805, 89728813, 8, 640x360 
0x1382CA98, 37353946876346320, 89728841, 89728843, 2, 640x360 
0x1382CA98, 37353946876669080, 89728856, 89728862, 6, 640x360 
0x1382CA98, 37353946877017528, 89728890, 89728893, 3, 640x360 
0x1382CA98, 37353946877321040, 89728925, 89728933, 8, 640x360 
0x1382CA98, 37353946877630752, 89728969, 89728976, 7, 640x360 
0x1382CA98, 37353946877967424, 89728993, 89728996, 3, 640x360 
0x1382CA98, 37353946878273472, 89729026, 89729029, 3, 640x360 
0x1382CA98, 37353946878597296, 89729076, 89729092, 16, 640x360 
0x1382CA98, 37353946879176632, 89729135, 89729142, 7, 640x360 
0x1382CA98, 37353946879484312, 89729155, 89729157, 2, 640x360 
0x1382CA98, 37353946879708176, 89729184, 89729189, 5, 640x360 
0x1382CA98, 37353946880046544, 89729204, 89729206, 2, 640x360 
0x1382CA98, 37353946880347136, 89729238, 89729259, 21, 640x360 
0x1382CA98, 37353946880673720, 89729286, 89729293, 7, 640x360 
0x1382CA98, 37353946880991248, 89729300, 89729320, 20, 640x360 
0x1382CA98, 37353946881306728, 89729336, 89729353, 17, 640x360 
0x1382CA98, 37353946881630288, 89729368, 89729372, 4, 640x360 
0x1382CA98, 37353946881958800, 89729393, 89729395, 2, 640x360 
0x1382CA98, 37353946882282008, 89729421, 89729425, 4, 640x360 
0x1382CA98, 37353946882640576, 89729471, 89729474, 3, 640x360 
0x1382CA98, 37353946883070488, 89729507, 89729509, 2, 640x360 
0x1382CA98, 37353946883393736, 89729533, 89729536, 3, 640x360 
0x1382CA98, 37353946883715320, 89729571, 89729574, 3, 640x360 
0x1382CA98, 37353946884029656, 89729596, 89729601, 5, 640x360 
0x1382CA98, 37353946884352696, 89729627, 89729630, 3, 640x360 
0x1382CA98, 37353946884667768, 89729667, 89729673, 6, 640x360 
0x1382CA98, 37353946884993160, 89729695, 89729698, 3, 640x360 
0x1382CA98, 37353946885307776, 89729728, 89729752, 24, 640x360 
0x1382CA98, 37353946885629296, 89729767, 89729772, 5, 640x360 
0x1382CA98, 37353946885954144, 89729802, 89729806, 4, 640x360 
0x1382CA98, 37353946886277344, 89729824, 89729838, 14, 640x360 
0x1382CA98, 37353946886619896, 89729856, 89729859, 3, 640x360 
0x1382CA98, 37353946887097088, 89729907, 89729909, 2, 640x360 
0x1382CA98, 37353946887402200, 89729932, 89729936, 4, 640x360 
0x1382CA98, 37353946887721792, 89729960, 89729963, 3, 640x360 
0x1382CA98, 37353946888040536, 89729993, 89729996, 3, 640x360 
0x1382CA98, 37353946888349360, 89730025, 89730035, 10, 640x360 
0x1382CA98, 37353946888670632, 89730065, 89730068, 3, 640x360 
0x1382CA98, 37353946888987504, 89730091, 89730094, 3, 640x360 
0x1382CA98, 37353946889310696, 89730124, 89730137, 13, 640x360 
0x1382CA98, 37353946889628032, 89730166, 89730176, 10, 640x360 
0x1382CA98, 37353946889963864, 89730195, 89730197, 2, 640x360 
0x1382CA98, 37353946890277232, 89730217, 89730222, 5, 640x360 
0x1382CA98, 37353946890593576, 89730248, 89730251, 3, 640x360 
0x1382CA98, 37353946891069080, 89730303, 89730305, 2, 640x360 
0x1382CA98, 37353946891385664, 89730329, 89730333, 4, 640x360 
0x1382CA98, 37353946891705552, 89730362, 89730366, 4, 640x360 
0x1382CA98, 37353946892025376, 89730393, 89730395, 2, 640x360 
0x1382CA98, 37353946892350880, 89730424, 89730426, 2, 640x360 
0x1382CA98, 37353946892670352, 89730462, 89730464, 2, 640x360 
0x1382CA98, 37353946892990104, 89730489, 89730491, 2, 640x360 
0x1382CA98, 37353946893309368, 89730521, 89730528, 7, 640x360 
0x1382CA98, 37353946893628168, 89730548, 89730555, 7, 640x360 
0x1382CA98, 37353946893946072, 89730578, 89730581, 3, 640x360 
0x1382CA98, 37353946894266736, 89730609, 89730612, 3, 640x360 
0x1382CA98, 37353946894587032, 89730652, 89730669, 17, 640x360 
0x1382CA98, 37353946894955472, 89730688, 89730706, 18, 640x360 
0x1382CA98, 37353946895385760, 89730739, 89730743, 4, 640x360 
0x1382CA98, 37353946895709424, 89730761, 89730779, 18, 640x360 
0x1382CA98, 37353946896027240, 89730793, 89730804, 11, 640x360 
0x1382CA98, 37353946896350472, 89730836, 89730840, 4, 640x360 
0x1382CA98, 37353946896668392, 89730860, 89730863, 3, 640x360 
0x1382CA98, 37353946896988800, 89730903, 89730910, 7, 640x360 
0x1382CA98, 37353946897313792, 89730941, 89730951, 10, 640x360 
0x1382CA98, 37353946897648744, 89730960, 89730962, 2, 640x360 
0x1382CA98, 37353946897978064, 89730990, 89730993, 3, 640x360 
0x1382CA98, 37353946898271016, 89731024, 89731026, 2, 640x360 
0x1382CA98, 37353946898603800, 89731057, 89731059, 2, 640x360 
0x1382CA98, 37353946898942320, 89731083, 89731088, 5, 640x360 
0x1382CA98, 37353946899390936, 89731134, 89731138, 4, 640x360 
0x1382CA98, 37353946899710296, 89731164, 89731168, 4, 640x360 
0x1382CA98, 37353946900028112, 89731201, 89731203, 2, 640x360 
0x1382CA98, 37353946900354888, 89731231, 89731233, 2, 640x360 
0x1382CA98, 37353946900668992, 89731270, 89731272, 2, 640x360 
0x1382CA98, 37353946900987328, 89731290, 89731292, 2, 640x360 
0x1382CA98, 37353946901308896, 89731321, 89731331, 10, 640x360 
0x1382CA98, 37353946901627080, 89731353, 89731361, 8, 640x360 
0x1382CA98, 37353946901947664, 89731389, 89731391, 2, 640x360 
0x1382CA98, 37353946902265640, 89731412, 89731414, 2, 640x360 
0x1382CA98, 37353946902613800, 89731455, 89731458, 3, 640x360 
0x1382CA98, 37353946902924008, 89731481, 89731487, 6, 640x360 
0x1382CA98, 37353946903389272, 89731529, 89731533, 4, 640x360 
0x1382CA98, 37353946903705824, 89731568, 89731570, 2, 640x360 
0x1382CA98, 37353946904025248, 89731590, 89731596, 6, 640x360 
0x1382CA98, 37353946904355336, 89731630, 89731635, 5, 640x360 
0x1382CA98, 37353946904665464, 89731651, 89731655, 4, 640x360 
0x1382CA98, 37353946904986024, 89731687, 89731689, 2, 640x360 
0x1382CA98, 37353946905305352, 89731729, 89731732, 3, 640x360 
0x1382CA98, 37353946905626040, 89731754, 89731759, 5, 640x360 
0x1382CA98, 37353946905945864, 89731781, 89731789, 8, 640x360 
0x1382CA98, 37353946906270488, 89731812, 89731816, 4, 640x360 
0x1382CA98, 37353946906586360, 89731843, 89731845, 2, 640x360 
0x1382CA98, 37353946906914424, 89731879, 89731881, 2, 640x360 
0x1382CA98, 37353946907385376, 89731928, 89731930, 2, 640x360 
0x1382CA98, 37353946907705400, 89731961, 89731963, 2, 640x360 
0x1382CA98, 37353946908025448, 89731994, 89731997, 3, 640x360 
0x1382CA98, 37353946908346312, 89732021, 89732024, 3, 640x360 
0x1382CA98, 37353946908684712, 89732067, 89732070, 3, 640x360 
0x1382CA98, 37353946908986008, 89732104, 89732107, 3, 640x360 
0x1382CA98, 37353946909310120, 89732133, 89732139, 6, 640x360 
0x1382CA98, 37353946909625608, 89732155, 89732159, 4, 640x360 
0x1382CA98, 37353946909951352, 89732197, 89732203, 6, 640x360 
0x1382CA98, 37353946910279952, 89732235, 89732239, 4, 640x360 
0x1382CA98, 37353946910612264, 89732268, 89732280, 12, 640x360 
0x1382CA98, 37353946910931192, 89732292, 89732296, 4, 640x360 
0x1382CA98, 37353946911385256, 89732355, 89732362, 7, 640x360 
0x1382CA98, 37353946911712968, 89732371, 89732375, 4, 640x360 
0x1382CA98, 37353946912025056, 89732405, 89732413, 8, 640x360 
0x1382CA98, 37353946912364936, 89732434, 89732441, 7, 640x360 
0x1382CA98, 37353946912669216, 89732463, 89732466, 3, 640x360 
0x1382CA98, 37353946912996912, 89732500, 89732504, 4, 640x360 
0x1382CA98, 37353946913320640, 89732532, 89732549, 17, 640x360 
0x1382CA98, 37353946913629504, 89732557, 89732561, 4, 640x360 
0x1382CA98, 37353946913974912, 89732591, 89732593, 2, 640x360 
0x1382CA98, 37353946914278752, 89732633, 89732636, 3, 640x360 
0x1382CA98, 37353946914594992, 89732646, 89732654, 8, 640x360 
0x1382CA98, 37353946914910560, 89732685, 89732688, 3, 640x360 
0x1382CA98, 37353946915389064, 89732730, 89732732, 2, 640x360 
0x1382CA98, 37353946915705592, 89732761, 89732764, 3, 640x360 
0x1382CA98, 37353946916029184, 89732795, 89732797, 2, 640x360 
0x1382CA98, 37353946916348808, 89732824, 89732826, 2, 640x360 
0x1382CA98, 37353946916666416, 89732855, 89732865, 10, 640x360 
0x1382CA98, 37353946916985160, 89732887, 89732890, 3, 640x360 
0x1382CA98, 37353946917304952, 89732915, 89732920, 5, 640x360 
0x1382CA98, 37353946917625248, 89732950, 89732961, 11, 640x360 
0x1382CA98, 37353946917948728, 89732977, 89732980, 3, 640x360 
0x1382CA98, 37353946918269904, 89733012, 89733024, 12, 640x360 
0x1382CA98, 37353946918605944, 89733053, 89733062, 9, 640x360 
0x1382CA98, 37353946918922936, 89733093, 89733096, 3, 640x360 
0x1382CA98, 37353946919704528, 89733173, 89733186, 13, 640x360 
0x1382CA98, 37353946920024664, 89733198, 89733202, 4, 640x360 
0x1382CA98, 37353946920344832, 89733228, 89733230, 2, 640x360 
0x1382CA98, 37353946920676808, 89733268, 89733286, 18, 640x360 
0x1382CA98, 37353946921001296, 89733302, 89733305, 3, 640x360 
0x1382CA98, 37353946921306224, 89733342, 89733348, 6, 640x360 
0x1382CA98, 37353946921638128, 89733357, 89733360, 3, 640x360 
0x1382CA98, 37353946921977184, 89733400, 89733405, 5, 640x360 
0x1382CA98, 37353946922272136, 89733419, 89733422, 3, 640x360 
0x1382CA98, 37353946922618432, 89733456, 89733458, 2, 640x360 
0x1382CA98, 37353946922906552, 89733484, 89733495, 11, 640x360 
0x1382CA98, 37353946923228888, 89733524, 89733527, 3, 640x360 
0x1382CA98, 37353946923708840, 89733568, 89733571, 3, 640x360 
0x1382CA98, 37353946924024408, 89733595, 89733597, 2, 640x360 
0x1382CA98, 37353946924349296, 89733621, 89733623, 2, 640x360 
0x1382CA98, 37353946924665944, 89733658, 89733660, 2, 640x360 
0x1382CA98, 37353946924985808, 89733691, 89733698, 7, 640x360 
0x1382CA98, 37353946925309568, 89733719, 89733721, 2, 640x360 
0x1382CA98, 37353946925629000, 89733750, 89733754, 4, 640x360 
0x1382CA98, 37353946925949512, 89733780, 89733789, 9, 640x360 
0x1382CA98, 37353946926267128, 89733824, 89733835, 11, 640x360 
0x1382CA98, 37353946926615320, 89733858, 89733865, 7, 640x360 
0x1382CA98, 37353946926908160, 89733892, 89733894, 2, 640x360 
0x1382CA98, 37353946927225456, 89733915, 89733927, 12, 640x360 
0x1382CA98, 37353946927708608, 89733968, 89733975, 7, 640x360 
0x1382CA98, 37353946928031800, 89734001, 89734010, 9, 640x360 
0x1382CA98, 37353946928356608, 89734035, 89734047, 12, 640x360 
0x1382CA98, 37353946928690472, 89734103, 89734118, 15, 640x360 
0x1382CA98, 37353946929017384, 89734119, 89734139, 20, 640x360 
0x1382CA98, 37353946929446368, 89734145, 89734167, 22, 640x360 
0x1382CA98, 37353946929653152, 89734168, 89734171, 3, 640x360 
0x1382CA98, 37353946929952520, 89734187, 89734191, 4, 640x360 
0x1382CA98, 37353946930283872, 89734216, 89734219, 3, 640x360 
0x1382CA98, 37353946930611640, 89734251, 89734261, 10, 640x360 
0x1382CA98, 37353946930905784, 89734278, 89734281, 3, 640x360 
0x1382CA98, 37353946931225016, 89734307, 89734310, 3, 640x360 
0x1382CA98, 37353946931708880, 89734368, 89734371, 3, 640x360 
0x1382CA98, 37353946932024440, 89734390, 89734393, 3, 640x360 
0x1382CA98, 37353946932346872, 89734424, 89734428, 4, 640x360 
0x1382CA98, 37353946932671880, 89734456, 89734458, 2, 640x360 
0x1382CA98, 37353946933002496, 89734490, 89734492, 2, 640x360 
0x1382CA98, 37353946933314632, 89734532, 89734543, 11, 640x360 
0x1382CA98, 37353946933627344, 89734561, 89734563, 2, 640x360 
0x1382CA98, 37353946933949960, 89734582, 89734586, 4, 640x360 
0x1382CA98, 37353946934265016, 89734618, 89734620, 2, 640x360 
0x1382CA98, 37353946934585544, 89734643, 89734645, 2, 640x360 
0x1382CA98, 37353946934906080, 89734680, 89734683, 3, 640x360 
0x1382CA98, 37353946935225920, 89734707, 89734710, 3, 640x360 
0x1382CA98, 37353946935705216, 89734764, 89734768, 4, 640x360 
0x1382CA98, 37353946936025544, 89734788, 89734791, 3, 640x360 
0x1382CA98, 37353946936347032, 89734826, 89734828, 2, 640x360 
0x1382CA98, 37353946936669016, 89734853, 89734856, 3, 640x360 
0x1382CA98, 37353946936984984, 89734890, 89734892, 2, 640x360 
0x1382CA98, 37353946937305512, 89734917, 89734919, 2, 640x360 
0x1382CA98, 37353946937625160, 89734948, 89734958, 10, 640x360 
0x1382CA98, 37353946937945400, 89734979, 89734983, 4, 640x360 
0x1382CA98, 37353946938265128, 89735012, 89735016, 4, 640x360 
0x1382CA98, 37353946938586272, 89735045, 89735048, 3, 640x360 
0x1382CA98, 37353946938909256, 89735084, 89735086, 2, 640x360 
0x1382CA98, 37353946939227992, 89735116, 89735120, 4, 640x360 
0x1382CA98, 37353946939704832, 89735163, 89735169, 6, 640x360 
0x1382CA98, 37353946940025200, 89735190, 89735194, 4, 640x360 
0x1382CA98, 37353946940345536, 89735222, 89735225, 3, 640x360 
0x1382CA98, 37353946940669016, 89735263, 89735268, 5, 640x360 
0x1382CA98, 37353946940984968, 89735290, 89735294, 4, 640x360 
0x1382CA98, 37353946941309328, 89735316, 89735332, 16, 640x360 
0x1382CA98, 37353946941628472, 89735349, 89735353, 4, 640x360 
0x1382CA98, 37353946941944936, 89735380, 89735387, 7, 640x360 
0x1382CA98, 37353946942268104, 89735411, 89735415, 4, 640x360 
0x1382CA98, 37353946942604056, 89735443, 89735450, 7, 640x360 
0x1382CA98, 37353946942906872, 89735475, 89735478, 3, 640x360 
0x1382CA98, 37353946943230408, 89735512, 89735520, 8, 640x360 
0x1382CA98, 37353946943703880, 89735565, 89735570, 5, 640x360 
0x1382CA98, 37353946944023952, 89735589, 89735596, 7, 640x360 
0x1382CA98, 37353946944348408, 89735629, 89735631, 2, 640x360 
0x1382CA98, 37353946944668384, 89735653, 89735659, 6, 640x360 
0x1382CA98, 37353946944984736, 89735686, 89735689, 3, 640x360 
0x1382CA98, 37353946945304848, 89735719, 89735721, 2, 640x360 
0x1382CA98, 37353946945625368, 89735751, 89735759, 8, 640x360 
0x1382CA98, 37353946945944856, 89735778, 89735781, 3, 640x360 
0x1382CA98, 37353946946266856, 89735812, 89735815, 3, 640x360 
0x1382CA98, 37353946946585320, 89735843, 89735845, 2, 640x360 
0x1382CA98, 37353946946912864, 89735881, 89735885, 4, 640x360 
0x1382CA98, 37353946947225680, 89735908, 89735910, 2, 640x360 
0x1382CA98, 37353946947556344, 89735946, 89735948, 2, 640x360 
0x1382CA98, 37353946948025144, 89735988, 89735994, 6, 640x360 
0x1382CA98, 37353946948345016, 89736021, 89736023, 2, 640x360 
0x1382CA98, 37353946948668824, 89736053, 89736060, 7, 640x360 
0x1382CA98, 37353946948984848, 89736090, 89736092, 2, 640x360 
0x1382CA98, 37353946949304808, 89736123, 89736125, 2, 640x360 
0x1382CA98, 37353946949625416, 89736153, 89736160, 7, 640x360 
0x1382CA98, 37353946949950936, 89736188, 89736190, 2, 640x360 
0x1382CA98, 37353946950265200, 89736214, 89736216, 2, 640x360 
0x1382CA98, 37353946950596160, 89736246, 89736248, 2, 640x360 
0x1382CA98, 37353946950906432, 89736277, 89736279, 2, 640x360 
0x1382CA98, 37353946951225408, 89736309, 89736311, 2, 640x360 
0x1382CA98, 37353946951581400, 89736343, 89736346, 3, 640x360 
0x1382CA98, 37353946952028712, 89736394, 89736400, 6, 640x360 
0x1382CA98, 37353946952344928, 89736428, 89736445, 17, 640x360 
0x1382CA98, 37353946952676200, 89736463, 89736467, 4, 640x360 
0x1382CA98, 37353946952987776, 89736498, 89736502, 4, 640x360 
0x1382CA98, 37353946953303984, 89736523, 89736525, 2, 640x360 
0x1382CA98, 37353946953625416, 89736549, 89736557, 8, 640x360 
0x1382CA98, 37353946953948576, 89736594, 89736598, 4, 640x360 
0x1382CA98, 37353946954279648, 89736613, 89736624, 11, 640x360 
0x1382CA98, 37353946954610760, 89736644, 89736646, 2, 640x360 
0x1382CA98, 37353946954930184, 89736695, 89736703, 8, 640x360 
0x1382CA98, 37353946955227560, 89736720, 89736729, 9, 640x360 
0x1382CA98, 37353946956023496, 89736793, 89736796, 3, 640x360 
0x1382CA98, 37353946956347416, 89736827, 89736833, 6, 640x360 
0x1382CA98, 37353946956663912, 89736863, 89736866, 3, 640x360 
0x1382CA98, 37353946956983736, 89736890, 89736892, 2, 640x360 
0x1382CA98, 37353946957306648, 89736916, 89736921, 5, 640x360 
0x1382CA98, 37353946957627960, 89736956, 89736959, 3, 640x360 
0x1382CA98, 37353946957945080, 89736982, 89736986, 4, 640x360 
0x1382CA98, 37353946958264528, 89737014, 89737018, 4, 640x360 
0x1382CA98, 37353946958585480, 89737050, 89737054, 4, 640x360 
0x1382CA98, 37353946958927200, 89737081, 89737084, 3, 640x360 
0x1382CA98, 37353946959231400, 89737112, 89737114, 2, 640x360 
0x1382CA98, 37353946959550816, 89737144, 89737147, 3, 640x360 
0x1382CA98, 37353946960025272, 89737196, 89737201, 5, 640x360 
0x1382CA98, 37353946960346736, 89737226, 89737228, 2, 640x360 
0x1382CA98, 37353946960672400, 89737261, 89737265, 4, 640x360 
0x1382CA98, 37353946960986544, 89737284, 89737295, 11, 640x360 
0x1382CA98, 37353946961304160, 89737312, 89737323, 11, 640x360 
0x1382CA98, 37353946961628160, 89737349, 89737363, 14, 640x360 
0x1382CA98, 37353946961966608, 89737380, 89737389, 9, 640x360 
0x1382CA98, 37353946962269056, 89737412, 89737416, 4, 640x360 
0x1382CA98, 37353946962590624, 89737446, 89737458, 12, 640x360 
0x1382CA98, 37353946962909528, 89737479, 89737482, 3, 640x360 
0x1382CA98, 37353946963224704, 89737511, 89737512, 1, 640x360 
0x1382CA98, 37353946963544200, 89737545, 89737548, 3, 640x360 
0x1382CA98, 37353946964023456, 89737595, 89737597, 2, 640x360 
0x1382CA98, 37353946964344872, 89737628, 89737630, 2, 640x360 
0x1382CA98, 37353946964668368, 89737657, 89737666, 9, 640x360 
0x1382CA98, 37353946964987640, 89737683, 89737688, 5, 640x360 
0x1382CA98, 37353946965311408, 89737715, 89737725, 10, 640x360 
0x1382CA98, 37353946965628424, 89737762, 89737764, 2, 640x360 
0x1382CA98, 37353946965950856, 89737787, 89737797, 10, 640x360 
0x1382CA98, 37353946966275736, 89737822, 89737824, 2, 640x360 
0x1382CA98, 37353946966596616, 89737844, 89737846, 2, 640x360 
0x1382CA98, 37353946966906960, 89737887, 89737894, 7, 640x360 
0x1382CA98, 37353946967224568, 89737919, 89737929, 10, 640x360 
0x1382CA98, 37353946967554304, 89737956, 89737962, 6, 640x360 
0x1382CA98, 37353946968028792, 89737995, 89737997, 2, 640x360 
0x1382CA98, 37353946968349848, 89738022, 89738024, 2, 640x360 
0x1382CA98, 37353946968679824, 89738057, 89738060, 3, 640x360 
0x1382CA98, 37353946968984088, 89738090, 89738096, 6, 640x360 
0x1382CA98, 37353946969304152, 89738128, 89738134, 6, 640x360 
0x1382CA98, 37353946969626232, 89738156, 89738160, 4, 640x360 
0x1382CA98, 37353946969950728, 89738179, 89738182, 3, 640x360 
0x1382CA98, 37353946970268784, 89738212, 89738215, 3, 640x360 
0x1382CA98, 37353946970593120, 89738243, 89738246, 3, 640x360 
0x1382CA98, 37353946970906456, 89738279, 89738286, 7, 640x360 
0x1382CA98, 37353946971224496, 89738314, 89738324, 10, 640x360 
0x1382CA98, 37353946971544520, 89738345, 89738347, 2, 640x360 
0x1382CA98, 37353946971868248, 89738372, 89738374, 2, 640x360 
0x1382CA98, 37353946972347680, 89738429, 89738432, 3, 640x360 
0x1382CA98, 37353946972666736, 89738455, 89738458, 3, 640x360 
0x1382CA98, 37353946972990616, 89738488, 89738491, 3, 640x360 
0x1382CA98, 37353946973307184, 89738520, 89738522, 2, 640x360 
0x1382CA98, 37353946973628152, 89738555, 89738563, 8, 640x360 
0x1382CA98, 37353946973947360, 89738583, 89738587, 4, 640x360 
0x1382CA98, 37353946974268384, 89738617, 89738619, 2, 640x360 
0x1382CA98, 37353946974592448, 89738648, 89738652, 4, 640x360 
0x1382CA98, 37353946974910864, 89738685, 89738688, 3, 640x360 
0x1382CA98, 37353946975229352, 89738709, 89738712, 3, 640x360 
0x1382CA98, 37353946975550888, 89738744, 89738746, 2, 640x360 
0x1382CA98, 37353946975864144, 89738772, 89738774, 2, 640x360 
0x1382CA98, 37353946976343208, 89738828, 89738830, 2, 640x360 
0x1382CA98, 37353946976665344, 89738857, 89738860, 3, 640x360 
0x1382CA98, 37353946976988088, 89738891, 89738893, 2, 640x360 
0x1382CA98, 37353946977306920, 89738924, 89738932, 8, 640x360 
0x1382CA98, 37353946977623920, 89738965, 89738976, 11, 640x360 
0x1382CA98, 37353946977956104, 89738991, 89738994, 3, 640x360 
0x1382CA98, 37353946978280120, 89739033, 89739036, 3, 640x360 
0x1382CA98, 37353946978612928, 89739063, 89739068, 5, 640x360 
0x1382CA98, 37353946978930840, 89739095, 89739099, 4, 640x360 
0x1382CA98, 37353946979224848, 89739123, 89739129, 6, 640x360 
0x1382CA98, 37353946979552536, 89739147, 89739161, 14, 640x360 
0x1382CA98, 37353946979873576, 89739195, 89739199, 4, 640x360 
0x1382CA98, 37353946980346184, 89739232, 89739244, 12, 640x360 
0x1382CA98, 37353946980713352, 89739285, 89739289, 4, 640x360 
0x1382CA98, 37353946981021184, 89739330, 89739363, 33, 640x360 
0x1382CA98, 37353946981318592, 89739368, 89739375, 7, 640x360 
0x1382CA98, 37353946981666464, 89739387, 89739395, 8, 640x360 
0x1382CA98, 37353946981980728, 89739412, 89739426, 14, 640x360 
0x1382CA98, 37353946982281992, 89739442, 89739460, 18, 640x360 
0x1382CA98, 37353946982642656, 89739479, 89739482, 3, 640x360 
0x1382CA98, 37353946982932480, 89739512, 89739518, 6, 640x360 
0x1382CA98, 37353946983252728, 89739525, 89739531, 6, 640x360 
0x1382CA98, 37353946983563248, 89739558, 89739572, 14, 640x360 
0x1382CA98, 37353946983919680, 89739592, 89739599, 7, 640x360 
0x1382CA98, 37353946984346944, 89739623, 89739625, 2, 640x360 
0x1382CA98, 37353946984666224, 89739663, 89739666, 3, 640x360 
0x1382CA98, 37353946984986344, 89739686, 89739693, 7, 640x360 
0x1382CA98, 37353946985303560, 89739725, 89739731, 6, 640x360 
0x1382CA98, 37353946985623368, 89739752, 89739756, 4, 640x360 
0x1382CA98, 37353946985948960, 89739787, 89739795, 8, 640x360 
0x1382CA98, 37353946986273120, 89739819, 89739826, 7, 640x360 
0x1382CA98, 37353946986589680, 89739851, 89739855, 4, 640x360 
0x1382CA98, 37353946986908168, 89739887, 89739890, 3, 640x360 
0x1382CA98, 37353946987224728, 89739916, 89739920, 4, 640x360 
0x1382CA98, 37353946987543640, 89739952, 89739954, 2, 640x360 
0x1382CA98, 37353946987863648, 89739985, 89739987, 2, 640x360 
0x1382CA98, 37353946988342792, 89740022, 89740025, 3, 640x360 
0x1382CA98, 37353946988668096, 89740057, 89740059, 2, 640x360 
0x1382CA98, 37353946988988280, 89740095, 89740099, 4, 640x360 
0x1382CA98, 37353946989320768, 89740125, 89740127, 2, 640x360 
0x1382CA98, 37353946989630696, 89740173, 89740180, 7, 640x360 
0x1382CA98, 37353946989983968, 89740204, 89740206, 2, 640x360 
0x1382CA98, 37353946990277888, 89740218, 89740222, 4, 640x360 
0x1382CA98, 37353946990588504, 89740245, 89740248, 3, 640x360 
0x1382CA98, 37353946990903344, 89740280, 89740283, 3, 640x360 
0x1382CA98, 37353946991223224, 89740310, 89740317, 7, 640x360 
0x1382CA98, 37353946991543416, 89740349, 89740353, 4, 640x360 
0x1382CA98, 37353946991866992, 89740379, 89740381, 2, 640x360 
0x1382CA98, 37353946992343288, 89740427, 89740437, 10, 640x360 
0x1382CA98, 37353946992663448, 89740457, 89740460, 3, 640x360 
0x1382CA98, 37353946992985664, 89740489, 89740492, 3, 640x360 
0x1382CA98, 37353946993302872, 89740516, 89740519, 3, 640x360 
0x1382CA98, 37353946993623584, 89740558, 89740563, 5, 640x360 
0x1382CA98, 37353946993948616, 89740596, 89740600, 4, 640x360 
0x1382CA98, 37353946994282448, 89740627, 89740629, 2, 640x360 
0x1382CA98, 37353946994585200, 89740653, 89740656, 3, 640x360 
0x1382CA98, 37353946994914760, 89740681, 89740683, 2, 640x360 
0x1382CA98, 37353946995226848, 89740712, 89740716, 4, 640x360 
0x1382CA98, 37353946995543928, 89740745, 89740750, 5, 640x360 
0x1382CA98, 37353946995864360, 89740782, 89740789, 7, 640x360 
0x1382CA98, 37353946996342536, 89740825, 89740833, 8, 640x360 
0x1382CA98, 37353946996663056, 89740862, 89740865, 3, 640x360 
0x1382CA98, 37353946996993024, 89740897, 89740908, 11, 640x360 
0x1382CA98, 37353946997306408, 89740922, 89740929, 7, 640x360 
0x1382CA98, 37353946997626632, 89740949, 89740954, 5, 640x360 
0x1382CA98, 37353946997943584, 89740980, 89740987, 7, 640x360 
0x1382CA98, 37353946998277360, 89741012, 89741016, 4, 640x360 
0x1382CA98, 37353946998591680, 89741051, 89741061, 10, 640x360 
0x1382CA98, 37353946998902960, 89741085, 89741088, 3, 640x360 
0x1382CA98, 37353946999223024, 89741109, 89741114, 5, 640x360 
0x1382CA98, 37353946999543216, 89741147, 89741152, 5, 640x360 
0x1382CA98, 37353946999863208, 89741173, 89741175, 2, 640x360 
0x1382CA98, 37353947000186912, 89741212, 89741215, 3, 640x360 
0x1382CA98, 37353947000669640, 89741255, 89741261, 6, 640x360 
0x1382CA98, 37353947000983712, 89741287, 89741290, 3, 640x360 
0x1382CA98, 37353947001314264, 89741323, 89741335, 12, 640x360 
0x1382CA98, 37353947001624080, 89741357, 89741360, 3, 640x360 
0x1382CA98, 37353947001948032, 89741396, 89741402, 6, 640x360 
0x1382CA98, 37353947002283792, 89741423, 89741426, 3, 640x360 
0x1382CA98, 37353947002602584, 89741447, 89741461, 14, 640x360 
0x1382CA98, 37353947002903656, 89741479, 89741483, 4, 640x360 
0x1382CA98, 37353947003224608, 89741512, 89741516, 4, 640x360 
0x1382CA98, 37353947003543672, 89741549, 89741559, 10, 640x360 
0x1382CA98, 37353947003862936, 89741573, 89741576, 3, 640x360 
0x1382CA98, 37353947004183112, 89741618, 89741625, 7, 640x360 
0x1382CA98, 37353947004669416, 89741667, 89741680, 13, 640x360 
0x1382CA98, 37353947005003296, 89741707, 89741713, 6, 640x360 
0x1382CA98, 37353947005307608, 89741727, 89741730, 3, 640x360 
0x1382CA98, 37353947005640408, 89741758, 89741760, 2, 640x360 
0x1382CA98, 37353947005947712, 89741799, 89741812, 13, 640x360 
0x1382CA98, 37353947006294568, 89741822, 89741830, 8, 640x360 
0x1382CA98, 37353947006594424, 89741856, 89741859, 3, 640x360 
0x1382CA98, 37353947006914280, 89741886, 89741896, 10, 640x360 
0x1382CA98, 37353947007256136, 89741919, 89741924, 5, 640x360 
0x1382CA98, 37353947007607456, 89741953, 89741955, 2, 640x360 
0x1382CA98, 37353947007866888, 89741980, 89741983, 3, 640x360 
0x1382CA98, 37353947008183720, 89742013, 89742022, 9, 640x360 
0x1382CA98, 37353947008666744, 89742063, 89742068, 5, 640x360 
0x1382CA98, 37353947008983304, 89742091, 89742095, 4, 640x360 
0x1382CA98, 37353947009317584, 89742129, 89742135, 6, 640x360 
0x1382CA98, 37353947009642480, 89742159, 89742161, 2, 640x360 
0x1382CA98, 37353947009956464, 89742193, 89742195, 2, 640x360 
0x1382CA98, 37353947010270616, 89742220, 89742228, 8, 640x360 
0x1382CA98, 37353947010586384, 89742257, 89742263, 6, 640x360 
0x1382CA98, 37353947010908112, 89742279, 89742283, 4, 640x360 
0x1382CA98, 37353947011223072, 89742319, 89742323, 4, 640x360 
0x1382CA98, 37353947011548744, 89742355, 89742358, 3, 640x360 
0x1382CA98, 37353947011866504, 89742379, 89742382, 3, 640x360 
0x1382CA98, 37353947012187432, 89742420, 89742423, 3, 640x360 
0x1382CA98, 37353947012673728, 89742457, 89742468, 11, 640x360 
0x1382CA98, 37353947012984872, 89742490, 89742498, 8, 640x360 
0x1382CA98, 37353947013302504, 89742524, 89742526, 2, 640x360 
0x1382CA98, 37353947013622392, 89742552, 89742563, 11, 640x360 
0x1382CA98, 37353947013973272, 89742593, 89742595, 2, 640x360 
0x1382CA98, 37353947014268120, 89742614, 89742620, 6, 640x360 
0x1382CA98, 37353947014604688, 89742646, 89742650, 4, 640x360 
0x1382CA98, 37353947014902584, 89742679, 89742684, 5, 640x360 
0x1382CA98, 37353947015227144, 89742714, 89742717, 3, 640x360 
0x1382CA98, 37353947015542688, 89742753, 89742768, 15, 640x360 
0x1382CA98, 37353947015889800, 89742781, 89742787, 6, 640x360 
0x1382CA98, 37353947016193328, 89742821, 89742830, 9, 640x360 
0x1382CA98, 37353947016664664, 89742857, 89742860, 3, 640x360 
0x1382CA98, 37353947016982624, 89742890, 89742893, 3, 640x360 
0x1382CA98, 37353947017302448, 89742925, 89742927, 2, 640x360 
0x1382CA98, 37353947017625584, 89742959, 89742961, 2, 640x360 
0x1382CA98, 37353947017944064, 89742978, 89742981, 3, 640x360 
0x1382CA98, 37353947018263088, 89743014, 89743019, 5, 640x360 
0x1382CA98, 37353947018583576, 89743045, 89743047, 2, 640x360 
0x1382CA98, 37353947019226976, 89743111, 89743115, 4, 320x180 
0x1382CA98, 37353947019863056, 89743177, 89743178, 1, 320x180 
0x1382CA98, 37353947020667280, 89743256, 89743261, 5, 320x180 
0x1382CA98, 37353947021302568, 89743315, 89743325, 10, 320x180 
0x1382CA98, 37353947021943376, 89743386, 89743393, 7, 320x180 
0x1382CA98, 37353947022587040, 89743447, 89743451, 4, 320x180 
0x1382CA98, 37353947023866800, 89743577, 89743578, 1, 320x180 
0x1382CA98, 37353947024676408, 89743672, 89743677, 5, 320x180 
0x1382CA98, 37353947025302248, 89743723, 89743725, 2, 320x180 
0x1382CA98, 37353947025948952, 89743788, 89743793, 5, 320x180 
0x1382CA98, 37353947026592296, 89743849, 89743858, 9, 320x180 
0x1382CA98, 37353947027225848, 89743922, 89743924, 2, 320x180 
0x1382CA98, 37353947027862864, 89743980, 89743986, 6, 320x180 
0x1382CA98, 37353947028503624, 89744040, 89744042, 2, 320x180 
0x1382CA98, 37353947029308960, 89744126, 89744132, 6, 320x180 
0x1382CA98, 37353947029942392, 89744185, 89744186, 1, 320x180 
0x1382CA98, 37353947030582592, 89744251, 89744255, 4, 320x180 
0x1382CA98, 37353947031222328, 89744325, 89744326, 1, 320x180 
0x1382CA98, 37353947031862256, 89744389, 89744391, 2, 320x180 
0x1382CA98, 37353947032502624, 89744443, 89744444, 1, 320x180 
0x1382CA98, 37353947033301928, 89744518, 89744526, 8, 320x180 
0x1382CA98, 37353947033953616, 89744596, 89744597, 1, 320x180 
0x1382CA98, 37353947034601584, 89744652, 89744654, 2, 320x180 
0x1382CA98, 37353947035228056, 89744720, 89744722, 2, 320x180 
0x1382CA98, 37353947035865984, 89744782, 89744794, 12, 320x180 
0x1382CA98, 37353947036508040, 89744842, 89744843, 1, 320x180 
0x1382CA98, 37353947037306088, 89744916, 89744920, 4, 320x180 
0x1382CA98, 37353947037942304, 89744980, 89744987, 7, 320x180 
0x1382CA98, 37353947038605288, 89745058, 89745068, 10, 320x180 
0x1382CA98, 37353947039226408, 89745119, 89745122, 3, 320x180 
0x1382CA98, 37353947039861880, 89745181, 89745186, 5, 320x180 
0x1382CA98, 37353947040507432, 89745239, 89745241, 2, 320x180 
0x1382CA98, 37353947041302456, 89745320, 89745321, 1, 320x180 
0x1382CA98, 37353947041946960, 89745384, 89745385, 1, 320x180 
0x1382CA98, 37353947042591080, 89745455, 89745458, 3, 320x180 
0x1382CA98, 37353947043224768, 89745509, 89745510, 1, 320x180 
0x1382CA98, 37353947043863280, 89745587, 89745595, 8, 320x180 
0x1382CA98, 37353947044502096, 89745647, 89745648, 1, 320x180 
0x1382CA98, 37353947045315568, 89745727, 89745728, 1, 320x180 
0x1382CA98, 37353947045942424, 89745785, 89745793, 8, 320x180 
0x1382CA98, 37353947046587960, 89745853, 89745856, 3, 320x180 
0x1382CA98, 37353947047225528, 89745915, 89745923, 8, 320x180 
0x1382CA98, 37353947047865576, 89745975, 89745977, 2, 320x180 
0x1382CA98, 37353947048502368, 89746039, 89746042, 3, 320x180 
0x1382CA98, 37353947049302224, 89746115, 89746117, 2, 320x180 
0x1382CA98, 37353947049945808, 89746178, 89746179, 1, 320x180 
0x1382CA98, 37353947050585656, 89746248, 89746258, 10, 320x180 
0x1382CA98, 37353947051221680, 89746315, 89746324, 9, 320x180 
0x1382CA98, 37353947051862032, 89746380, 89746382, 2, 320x180 
0x1382CA98, 37353947052505056, 89746439, 89746446, 7, 320x180 
0x1382CA98, 37353947053301984, 89746524, 89746534, 10, 320x180 
0x1382CA98, 37353947053942672, 89746581, 89746583, 2, 320x180 
0x1382CA98, 37353947054603600, 89746648, 89746650, 2, 320x180 
0x1382CA98, 37353947055222864, 89746720, 89746721, 1, 320x180 
0x1382CA98, 37353947055869448, 89746777, 89746787, 10, 320x180 
0x1382CA98, 37353947056510760, 89746844, 89746867, 23, 320x180 
0x1382CA98, 37353947057312128, 89746927, 89746930, 3, 320x180 
0x1382CA98, 37353947057947896, 89746991, 89746998, 7, 320x180 
0x1382CA98, 37353947058586304, 89747052, 89747053, 1, 320x180 
0x1382CA98, 37353947059226208, 89747125, 89747128, 3, 320x180 
0x1382CA98, 37353947059863312, 89747191, 89747193, 2, 320x180 
0x1382CA98, 37353947060518744, 89747247, 89747255, 8, 320x180 
0x1382CA98, 37353947061336800, 89747338, 89747345, 7, 320x180 
0x1382CA98, 37353947061947432, 89747395, 89747397, 2, 320x180 
0x1382CA98, 37353947062582840, 89747446, 89747447, 1, 320x180 
0x1382CA98, 37353947063220984, 89747508, 89747510, 2, 320x180 
0x1382CA98, 37353947063866464, 89747592, 89747596, 4, 320x180 
0x1382CA98, 37353947064501456, 89747646, 89747648, 2, 320x180 
0x1382CA98, 37353947065300904, 89747716, 89747724, 8, 320x180 
0x1382CA98, 37353947065942392, 89747785, 89747792, 7, 320x180 
0x1382CA98, 37353947066586192, 89747850, 89747859, 9, 320x180 
0x1382CA98, 37353947067221792, 89747921, 89747928, 7, 320x180 
0x1382CA98, 37353947067861152, 89747974, 89747975, 1, 320x180 
0x1382CA98, 37353947068506896, 89748041, 89748042, 1, 320x180 
0x1382CA98, 37353947069302424, 89748125, 89748134, 9, 320x180 
0x1382CA98, 37353947069942320, 89748186, 89748193, 7, 320x180 
0x1382CA98, 37353947070586832, 89748257, 89748258, 1, 320x180 
0x1382CA98, 37353947071226136, 89748313, 89748314, 1, 320x180 
0x1382CA98, 37353947071862048, 89748381, 89748386, 5, 320x180 
0x1382CA98, 37353947072505560, 89748440, 89748442, 2, 320x180 
0x1382CA98, 37353947073303080, 89748515, 89748519, 4, 320x180 
0x1382CA98, 37353947073945176, 89748581, 89748586, 5, 320x180 
0x1382CA98, 37353947074600464, 89748654, 89748661, 7, 320x180 
0x1382CA98, 37353947075220736, 89748713, 89748718, 5, 320x180 
0x1382CA98, 37353947075867344, 89748781, 89748790, 9, 320x180 
0x1382CA98, 37353947076501968, 89748851, 89748855, 4, 320x180 
0x1382CA98, 37353947077304680, 89748927, 89748933, 6, 320x180 
0x1382CA98, 37353947077940736, 89748984, 89748992, 8, 320x180 
0x1382CA98, 37353947078585624, 89749052, 89749053, 1, 320x180 
0x1382CA98, 37353947079233248, 89749124, 89749126, 2, 320x180 
0x1382CA98, 37353947079861168, 89749176, 89749183, 7, 320x180 
0x1382CA98, 37353947080505088, 89749238, 89749241, 3, 320x180 
0x1382CA98, 37353947081141288, 89749303, 89749304, 1, 320x180 
0x1382CA98, 37353947081947080, 89749381, 89749392, 11, 320x180 
0x1382CA98, 37353947082593512, 89749445, 89749446, 1, 320x180 
0x1382CA98, 37353947083226760, 89749513, 89749515, 2, 320x180 
0x1382CA98, 37353947083873472, 89749585, 89749587, 2, 320x180 
0x1382CA98, 37353947084502032, 89749651, 89749658, 7, 320x180 
0x1382CA98, 37353947085145856, 89749706, 89749707, 1, 320x180 
0x1382CA98, 37353947085950080, 89749789, 89749790, 1, 320x180 
0x1382CA98, 37353947086586952, 89749845, 89749846, 1, 320x180 
0x1382CA98, 37353947087221200, 89749911, 89749919, 8, 320x180 
0x1382CA98, 37353947087861216, 89749985, 89749987, 2, 320x180 
0x1382CA98, 37353947088502168, 89750046, 89750049, 3, 320x180 
0x1382CA98, 37353947089141768, 89750107, 89750108, 1, 320x180 
0x1382CA98, 37353947089943488, 89750187, 89750195, 8, 320x180 
0x1382CA98, 37353947090608136, 89750270, 89750279, 9, 320x180 
0x1382CA98, 37353947091221352, 89750324, 89750326, 2, 320x180 
0x1382CA98, 37353947091872096, 89750390, 89750392, 2, 320x180 
0x1382CA98, 37353947092501432, 89750440, 89750448, 8, 320x180 
0x1382CA98, 37353947093140928, 89750511, 89750518, 7, 320x180 
0x1382CA98, 37353947093944496, 89750586, 89750594, 8, 320x180 
0x1382CA98, 37353947094618744, 89750657, 89750662, 5, 320x180 
0x1382CA98, 37353947095220816, 89750713, 89750714, 1, 320x180 
0x1382CA98, 37353947095862048, 89750777, 89750778, 1, 320x180 
0x1382CA98, 37353947096501712, 89750846, 89750847, 1, 320x180 
0x1382CA98, 37353947097145704, 89750905, 89750908, 3, 320x180 
0x1382CA98, 37353947097943640, 89750983, 89750994, 11, 320x180 
0x1382CA98, 37353947098594184, 89751055, 89751062, 7, 320x180 
0x1382CA98, 37353947099224448, 89751117, 89751121, 4, 320x180 
0x1382CA98, 37353947099860784, 89751173, 89751175, 2, 320x180 
0x1382CA98, 37353947100500440, 89751250, 89751259, 9, 320x180 
0x1382CA98, 37353947101151456, 89751301, 89751310, 9, 320x180 
0x1382CA98, 37353947101946104, 89751379, 89751380, 1, 320x180 
0x1382CA98, 37353947102613680, 89751458, 89751460, 2, 320x180 
0x1382CA98, 37353947103229768, 89751524, 89751525, 1, 320x180 
0x1382CA98, 37353947103859976, 89751590, 89751596, 6, 320x180 
0x1382CA98, 37353947104502312, 89751639, 89751641, 2, 320x180 
0x1382CA98, 37353947105157344, 89751712, 89751713, 1, 320x180 
0x1382CA98, 37353947105941384, 89751779, 89751782, 3, 320x180 
0x1382CA98, 37353947106585488, 89751851, 89751858, 7, 320x180 
0x1382CA98, 37353947107220640, 89751920, 89751922, 2, 320x180 
0x1382CA98, 37353947107860440, 89751979, 89751981, 2, 320x180 
0x1382CA98, 37353947108504368, 89752042, 89752048, 6, 320x180 
0x1382CA98, 37353947109151040, 89752106, 89752113, 7, 320x180 
0x1382CA98, 37353947109940216, 89752185, 89752186, 1, 320x180 
0x1382CA98, 37353947110581848, 89752249, 89752259, 10, 320x180 
0x1382CA98, 37353947111220368, 89752314, 89752319, 5, 320x180 
0x1382CA98, 37353947111865184, 89752384, 89752386, 2, 320x180 
0x1382CA98, 37353947112499872, 89752438, 89752441, 3, 320x180 
0x1382CA98, 37353947113140608, 89752513, 89752514, 1, 320x180 
0x1382CA98, 37353947113941264, 89752579, 89752581, 2, 320x180 
0x1382CA98, 37353947114582136, 89752652, 89752656, 4, 320x180 
0x1382CA98, 37353947115220792, 89752718, 89752720, 2, 320x180 
0x1382CA98, 37353947115860504, 89752780, 89752781, 1, 320x180 
0x1382CA98, 37353947116505320, 89752844, 89752847, 3, 320x180 
0x1382CA98, 37353947117156920, 89752905, 89752918, 13, 320x180 
0x1382CA98, 37353947117940088, 89752982, 89752994, 12, 320x180 
0x1382CA98, 37353947118580976, 89753050, 89753054, 4, 320x180 
0x1382CA98, 37353947119219504, 89753117, 89753122, 5, 320x180 
0x1382CA98, 37353947119859560, 89753180, 89753184, 4, 320x180 
0x1382CA98, 37353947120500616, 89753247, 89753252, 5, 320x180 
0x1382CA98, 37353947121142008, 89753307, 89753308, 1, 320x180 
0x1382CA98, 37353947121962128, 89753384, 89753387, 3, 320x180 
0x1382CA98, 37353947122591832, 89753454, 89753456, 2, 320x180 
0x1382CA98, 37353947123219456, 89753515, 89753519, 4, 320x180 
0x1382CA98, 37353947123860888, 89753573, 89753575, 2, 320x180 
0x1382CA98, 37353947124499904, 89753652, 89753654, 2, 320x180 
0x1382CA98, 37353947125140984, 89753708, 89753711, 3, 320x180 
0x1382CA98, 37353947125939192, 89753784, 89753786, 2, 320x180 
0x1382CA98, 37353947126592632, 89753844, 89753845, 1, 320x180 
0x1382CA98, 37353947127227272, 89753919, 89753920, 1, 320x180 
0x1382CA98, 37353947127863472, 89753980, 89753983, 3, 320x180 
0x1382CA98, 37353947128500712, 89754044, 89754048, 4, 320x180 
0x1382CA98, 37353947129163808, 89754107, 89754109, 2, 320x180 
0x1382CA98, 37353947129942840, 89754184, 89754191, 7, 320x180 
0x1382CA98, 37353947130615544, 89754278, 89754292, 14, 320x180 
0x1382CA98, 37353947131222584, 89754340, 89754353, 13, 320x180 
0x1382CA98, 37353947131867000, 89754413, 89754417, 4, 320x180 
0x1382CA98, 37353947132503968, 89754459, 89754460, 1, 320x180 
0x1382CA98, 37353947133152688, 89754521, 89754528, 7, 320x180 
0x1382CA98, 37353947133784624, 89754580, 89754585, 5, 320x180 
0x1382CA98, 37353947134611688, 89754659, 89754661, 2, 320x180 
0x1382CA98, 37353947135263192, 89754729, 89754738, 9, 320x180 
0x1382CA98, 37353947135866096, 89754781, 89754785, 4, 320x180 
0x1382CA98, 37353947136499768, 89754838, 89754845, 7, 320x180 
0x1382CA98, 37353947137141912, 89754907, 89754914, 7, 320x180 
0x1382CA98, 37353947137780624, 89754966, 89754977, 11, 320x180 
0x1382CA98, 37353947138579480, 89755043, 89755044, 1, 320x180 
0x1382CA98, 37353947139223920, 89755115, 89755118, 3, 320x180 
0x1382CA98, 37353947139863376, 89755172, 89755182, 10, 320x180 
0x1382CA98, 37353947140500488, 89755246, 89755247, 1, 320x180 
0x1382CA98, 37353947141152848, 89755313, 89755315, 2, 320x180 
0x1382CA98, 37353947141785056, 89755369, 89755371, 2, 320x180 
0x1382CA98, 37353947142580176, 89755446, 89755449, 3, 320x180 
0x1382CA98, 37353947143223000, 89755515, 89755522, 7, 320x180 
0x1382CA98, 37353947143862608, 89755588, 89755590, 2, 320x180 
0x1382CA98, 37353947144503576, 89755637, 89755643, 6, 320x180 
0x1382CA98, 37353947145140648, 89755714, 89755720, 6, 320x180 
0x1382CA98, 37353947145782680, 89755767, 89755773, 6, 320x180 
0x1382CA98, 37353947146585608, 89755851, 89755854, 3, 320x180 
0x1382CA98, 37353947147224264, 89755914, 89755916, 2, 320x180 
0x1382CA98, 37353947147878552, 89755990, 89755991, 1, 320x180 
0x1382CA98, 37353947148504016, 89756052, 89756054, 2, 320x180 
0x1382CA98, 37353947149141216, 89756113, 89756118, 5, 320x180 
0x1382CA98, 37353947149779376, 89756165, 89756175, 10, 320x180 
0x1382CA98, 37353947150581968, 89756244, 89756245, 1, 320x180 
0x1382CA98, 37353947151242608, 89756308, 89756310, 2, 320x180 
0x1382CA98, 37353947151875752, 89756374, 89756376, 2, 320x180 
0x1382CA98, 37353947152499792, 89756443, 89756444, 1, 320x180 
0x1382CA98, 37353947153153008, 89756505, 89756507, 2, 320x180 
0x1382CA98, 37353947153780208, 89756570, 89756580, 10, 320x180 
0x1382CA98, 37353947154617376, 89756653, 89756655, 2, 320x180 
0x1382CA98, 37353947155218592, 89756714, 89756722, 8, 320x180 
0x1382CA98, 37353947155864504, 89756774, 89756779, 5, 320x180 
0x1382CA98, 37353947156502976, 89756839, 89756841, 2, 320x180 
0x1382CA98, 37353947157143912, 89756906, 89756915, 9, 320x180 
0x1382CA98, 37353947157782928, 89756963, 89756967, 4, 320x180 
0x1382CA98, 37353947158585064, 89757049, 89757051, 2, 320x180 
0x1382CA98, 37353947159219440, 89757116, 89757120, 4, 320x180 
0x1382CA98, 37353947159858552, 89757179, 89757180, 1, 320x180 
0x1382CA98, 37353947160502840, 89757234, 89757236, 2, 320x180 
0x1382CA98, 37353947161139184, 89757307, 89757312, 5, 320x180 
0x1382CA98, 37353947161782880, 89757363, 89757366, 3, 320x180 
0x1382CA98, 37353947162583760, 89757461, 89757467, 6, 320x180 
0x1382CA98, 37353947163275752, 89757520, 89757522, 2, 320x180 
0x1382CA98, 37353947163869152, 89757586, 89757588, 2, 320x180 
0x1382CA98, 37353947164498456, 89757640, 89757642, 2, 320x180 
0x1382CA98, 37353947165142952, 89757703, 89757705, 2, 320x180 
0x1382CA98, 37353947165778920, 89757763, 89757766, 3, 320x180 
0x1382CA98, 37353947166604656, 89757851, 89757853, 2, 320x180 
0x1382CA98, 37353947167220872, 89757912, 89757917, 5, 320x180 
0x1382CA98, 37353947167859224, 89757980, 89757982, 2, 320x180 
0x1382CA98, 37353947168499256, 89758046, 89758047, 1, 320x180 
0x1382CA98, 37353947169139120, 89758105, 89758107, 2, 320x180 
0x1382CA98, 37353947169779104, 89758172, 89758173, 1, 320x180 
0x1382CA98, 37353947170584272, 89758254, 89758255, 1, 320x180 
0x1382CA98, 37353947171219632, 89758307, 89758308, 1, 320x180 
0x1382CA98, 37353947171859400, 89758371, 89758378, 7, 320x180 
0x1382CA98, 37353947172499352, 89758438, 89758443, 5, 320x180 
0x1382CA98, 37353947173140992, 89758501, 89758503, 2, 320x180 
0x1382CA98, 37353947173779968, 89758565, 89758570, 5, 320x180 
0x1382CA98, 37353947174580600, 89758644, 89758646, 2, 320x180 
0x1382CA98, 37353947175217904, 89758726, 89758727, 1, 320x180 
0x1382CA98, 37353947175858064, 89758772, 89758773, 1, 320x180 
0x1382CA98, 37353947176498896, 89758840, 89758841, 1, 320x180 
0x1382CA98, 37353947177139208, 89758903, 89758910, 7, 320x180 
0x1382CA98, 37353947177778880, 89758966, 89758972, 6, 320x180 
0x1382CA98, 37353947178579232, 89759045, 89759046, 1, 320x180 
0x1382CA98, 37353947179234104, 89759108, 89759111, 3, 320x180 
0x1382CA98, 37353947179871128, 89759175, 89759176, 1, 320x180 
0x1382CA98, 37353947180499136, 89759242, 89759249, 7, 320x180 
0x1382CA98, 37353947181138888, 89759317, 89759322, 5, 320x180 
0x1382CA98, 37353947181783832, 89759370, 89759381, 11, 320x180 
0x1382CA98, 37353947182597280, 89759465, 89759473, 8, 320x180 
0x1382CA98, 37353947183219024, 89759546, 89759555, 9, 320x180 
0x1382CA98, 37353947183882440, 89759601, 89759603, 2, 320x180 
0x1382CA98, 37353947184509008, 89759653, 89759655, 2, 320x180 
0x1382CA98, 37353947185141240, 89759720, 89759728, 8, 320x180 
0x1382CA98, 37353947185782912, 89759766, 89759783, 17, 320x180 
0x1382CA98, 37353947186588256, 89759850, 89759853, 3, 320x180 
0x1382CA98, 37353947187229368, 89759912, 89759913, 1, 320x180 
0x1382CA98, 37353947187861432, 89759981, 89759987, 6, 320x180 
0x1382CA98, 37353947188501592, 89760040, 89760042, 2, 320x180 
0x1382CA98, 37353947189157848, 89760109, 89760110, 1, 320x180 
0x1382CA98, 37353947189779288, 89760174, 89760176, 2, 320x180 
0x1382CA98, 37353947190419072, 89760232, 89760241, 9, 320x180 
0x1382CA98, 37353947191248160, 89760324, 89760327, 3, 320x180 
0x1382CA98, 37353947191862896, 89760381, 89760382, 1, 320x180 
0x1382CA98, 37353947192503016, 89760447, 89760449, 2, 320x180 
0x1382CA98, 37353947193149472, 89760516, 89760520, 4, 320x180 
0x1382CA98, 37353947193781024, 89760571, 89760573, 2, 320x180 
0x1382CA98, 37353947194418184, 89760634, 89760637, 3, 320x180 
0x1382CA98, 37353947195217752, 89760719, 89760721, 2, 320x180 
0x1382CA98, 37353947195857592, 89760785, 89760787, 2, 320x180 
0x1382CA98, 37353947196502536, 89760844, 89760845, 1, 320x180 
0x1382CA98, 37353947197162456, 89760908, 89760910, 2, 320x180 
0x1382CA98, 37353947197786240, 89760965, 89760971, 6, 320x180 
0x1382CA98, 37353947198439120, 89761028, 89761030, 2, 320x180 
0x1382CA98, 37353947199231096, 89761121, 89761124, 3, 320x180 
0x1382CA98, 37353947199858080, 89761180, 89761186, 6, 320x180 
0x1382CA98, 37353947200497568, 89761252, 89761255, 3, 320x180 
0x1382CA98, 37353947201137576, 89761300, 89761313, 13, 320x180 
0x1382CA98, 37353947201783456, 89761366, 89761368, 2, 320x180 
0x1382CA98, 37353947202423992, 89761445, 89761446, 1, 320x180 
0x1382CA98, 37353947203250048, 89761513, 89761520, 7, 320x180 
0x1382CA98, 37353947203858176, 89761578, 89761579, 1, 320x180 
0x1382CA98, 37353947204497368, 89761654, 89761656, 2, 320x180 
0x1382CA98, 37353947205140792, 89761710, 89761711, 1, 320x180 
0x1382CA98, 37353947205777640, 89761773, 89761774, 1, 320x180 
0x1382CA98, 37353947206423936, 89761837, 89761839, 2, 320x180 
0x1382CA98, 37353947207218928, 89761921, 89761922, 1, 320x180 
0x1382CA98, 37353947207864424, 89761984, 89761986, 2, 320x180 
0x1382CA98, 37353947208502352, 89762039, 89762046, 7, 320x180 
0x1382CA98, 37353947209139768, 89762100, 89762102, 2, 320x180 
0x1382CA98, 37353947209778928, 89762167, 89762168, 1, 320x180 
0x1382CA98, 37353947210426856, 89762230, 89762231, 1, 320x180 
0x1382CA98, 37353947211221712, 89762325, 89762335, 10, 320x180 
0x1382CA98, 37353947211858080, 89762386, 89762393, 7, 320x180 
0x1382CA98, 37353947212497608, 89762448, 89762450, 2, 320x180 
0x1382CA98, 37353947213144480, 89762506, 89762513, 7, 320x180 
0x1382CA98, 37353947213778584, 89762571, 89762578, 7, 320x180 
0x1382CA98, 37353947214437640, 89762657, 89762659, 2, 320x180 
0x1382CA98, 37353947215222088, 89762717, 89762727, 10, 320x180 
0x1382CA98, 37353947215863568, 89762811, 89762813, 2, 320x180 
0x1382CA98, 37353947216501072, 89762848, 89762853, 5, 320x180 
0x1382CA98, 37353947217137136, 89762907, 89762908, 1, 320x180 
0x1382CA98, 37353947217777272, 89762962, 89762964, 2, 320x180 
0x1382CA98, 37353947218419856, 89763040, 89763042, 2, 320x180 
0x1382CA98, 37353947219216744, 89763111, 89763112, 1, 320x180 
0x1382CA98, 37353947219862032, 89763179, 89763181, 2, 320x180 
0x1382CA98, 37353947220501296, 89763244, 89763249, 5, 320x180 
0x1382CA98, 37353947221138064, 89763311, 89763312, 1, 320x180 
0x1382CA98, 37353947221777704, 89763362, 89763363, 1, 320x180 
0x1382CA98, 37353947222427584, 89763429, 89763437, 8, 320x180 
0x1382CA98, 37353947223217464, 89763515, 89763524, 9, 320x180 
0x1382CA98, 37353947223857824, 89763573, 89763583, 10, 320x180 
0x1382CA98, 37353947224496896, 89763646, 89763648, 2, 320x180 
0x1382CA98, 37353947225141872, 89763700, 89763702, 2, 320x180 
0x1382CA98, 37353947225782024, 89763764, 89763766, 2, 320x180 
0x1382CA98, 37353947226418144, 89763831, 89763837, 6, 320x180 
0x1382CA98, 37353947227217632, 89763921, 89763924, 3, 320x180 
0x1382CA98, 37353947227867352, 89763989, 89764003, 14, 320x180 
0x1382CA98, 37353947228500736, 89764041, 89764043, 2, 320x180 
0x1382CA98, 37353947229140568, 89764107, 89764109, 2, 320x180 
0x1382CA98, 37353947229789872, 89764179, 89764181, 2, 320x180 
0x1382CA98, 37353947230453592, 89764237, 89764240, 3, 320x180 
0x1382CA98, 37353947231216304, 89764312, 89764317, 5, 320x180 
0x1382CA98, 37353947231860344, 89764380, 89764386, 6, 320x180 
0x1382CA98, 37353947232510504, 89764446, 89764448, 2, 320x180 
0x1382CA98, 37353947233137608, 89764526, 89764537, 11, 320x180 
0x1382CA98, 37353947233789064, 89764580, 89764597, 17, 320x180 
0x1382CA98, 37353947234439832, 89764636, 89764644, 8, 320x180 
0x1382CA98, 37353947235216624, 89764715, 89764719, 4, 320x180 
0x1382CA98, 37353947235872600, 89764787, 89764788, 1, 320x180 
0x1382CA98, 37353947236497536, 89764841, 89764843, 2, 320x180 
0x1382CA98, 37353947237157624, 89764911, 89764912, 1, 320x180 
0x1382CA98, 37353947237786160, 89764980, 89764981, 1, 320x180 
0x1382CA98, 37353947238443704, 89765033, 89765041, 8, 320x180 
0x1382CA98, 37353947239222296, 89765112, 89765115, 3, 320x180 
0x1382CA98, 37353947239873312, 89765186, 89765194, 8, 320x180 
0x1382CA98, 37353947240496336, 89765240, 89765241, 1, 320x180 
0x1382CA98, 37353947241141280, 89765313, 89765316, 3, 320x180 
0x1382CA98, 37353947241781224, 89765368, 89765375, 7, 320x180 
0x1382CA98, 37353947242434496, 89765436, 89765438, 2, 320x180 
0x1382CA98, 37353947243056968, 89765504, 89765505, 1, 320x180 
0x1382CA98, 37353947243860416, 89765581, 89765586, 5, 320x180 
0x1382CA98, 37353947244507160, 89765642, 89765644, 2, 320x180 
0x1382CA98, 37353947245142944, 89765706, 89765707, 1, 320x180 
0x1382CA98, 37353947245779280, 89765762, 89765764, 2, 320x180 
0x1382CA98, 37353947246426440, 89765835, 89765839, 4, 320x180 
0x1382CA98, 37353947247062960, 89765901, 89765911, 10, 320x180 
0x1382CA98, 37353947247856312, 89765981, 89765982, 1, 320x180 
0x1382CA98, 37353947248496376, 89766048, 89766052, 4, 320x180 
0x1382CA98, 37353947249140080, 89766104, 89766106, 2, 320x180 
0x1382CA98, 37353947249783160, 89766164, 89766166, 2, 320x180 
0x1382CA98, 37353947250427512, 89766237, 89766239, 2, 320x180 
0x1382CA98, 37353947251058440, 89766303, 89766310, 7, 320x180 
0x1382CA98, 37353947251858920, 89766382, 89766385, 3, 320x180 
0x1382CA98, 37353947252504256, 89766448, 89766452, 4, 320x180 
0x1382CA98, 37353947253141672, 89766500, 89766505, 5, 320x180 
0x1382CA98, 37353947253782824, 89766566, 89766574, 8, 320x180 
0x1382CA98, 37353947254428680, 89766632, 89766637, 5, 320x180 
0x1382CA98, 37353947255060344, 89766702, 89766704, 2, 320x180 
0x1382CA98, 37353947255870168, 89766778, 89766779, 1, 320x180 
0x1382CA98, 37353947256500568, 89766843, 89766845, 2, 320x180 
0x1382CA98, 37353947257144280, 89766906, 89766908, 2, 320x180 
0x1382CA98, 37353947257779112, 89766965, 89766970, 5, 320x180 
0x1382CA98, 37353947258420328, 89767026, 89767028, 2, 320x180 
0x1382CA98, 37353947259091304, 89767103, 89767107, 4, 320x180 
0x1382CA98, 37353947259861240, 89767186, 89767188, 2, 320x180 
0x1382CA98, 37353947260499944, 89767246, 89767247, 1, 320x180 
0x1382CA98, 37353947261144160, 89767327, 89767329, 2, 320x180 
0x1382CA98, 37353947261777128, 89767363, 89767365, 2, 320x180 
0x1382CA98, 37353947262428264, 89767439, 89767446, 7, 320x180 
0x1382CA98, 37353947263063368, 89767495, 89767496, 1, 320x180 
0x1382CA98, 37353947263865984, 89767573, 89767578, 5, 320x180 
0x1382CA98, 37353947264496352, 89767641, 89767647, 6, 320x180 
0x1382CA98, 37353947265136360, 89767707, 89767708, 1, 320x180 
0x1382CA98, 37353947265777608, 89767764, 89767765, 1, 320x180 
0x1382CA98, 37353947266426800, 89767840, 89767846, 6, 320x180 
0x1382CA98, 37353947267056480, 89767906, 89767912, 6, 320x180 
0x1382CA98, 37353947267861616, 89767975, 89767977, 2, 320x180 
0x1382CA98, 37353947268500960, 89768042, 89768043, 1, 320x180 
0x1382CA98, 37353947269136256, 89768117, 89768121, 4, 320x180 
0x1382CA98, 37353947269778160, 89768162, 89768164, 2, 320x180 
0x1382CA98, 37353947270420992, 89768231, 89768233, 2, 320x180 
0x1382CA98, 37353947271062432, 89768294, 89768296, 2, 320x180 
0x1382CA98, 37353947271860744, 89768391, 89768393, 2, 320x180 
0x1382CA98, 37353947272498544, 89768447, 89768455, 8, 320x180 
0x1382CA98, 37353947273157112, 89768522, 89768523, 1, 320x180 
0x1382CA98, 37353947273780888, 89768571, 89768572, 1, 320x180 
0x1382CA98, 37353947274425784, 89768636, 89768643, 7, 320x180 
0x1382CA98, 37353947275056560, 89768701, 89768703, 2, 320x180 
0x1382CA98, 37353947275855568, 89768786, 89768795, 9, 320x180 
0x1382CA98, 37353947276514984, 89768852, 89768855, 3, 320x180 
0x1382CA98, 37353947277136024, 89768907, 89768908, 1, 320x180 
0x1382CA98, 37353947277778656, 89768973, 89768975, 2, 320x180 
0x1382CA98, 37353947278449400, 89769036, 89769043, 7, 320x180 
0x1382CA98, 37353947279056440, 89769096, 89769097, 1, 320x180 
0x1382CA98, 37353947280175120, 89769212, 89769213, 1, 320x180 
0x1382CA98, 37353947280819224, 89769275, 89769276, 1, 320x180 
0x1382CA98, 37353947281456480, 89769345, 89769346, 1, 320x180 
0x1382CA98, 37353947282096600, 89769405, 89769408, 3, 320x180 
0x1382CA98, 37353947282736320, 89769464, 89769470, 6, 320x180 
0x1382CA98, 37353947283381216, 89769525, 89769536, 11, 320x180 
0x1382CA98, 37353947284175056, 89769605, 89769607, 2, 320x180 
0x1382CA98, 37353947284815104, 89769673, 89769678, 5, 320x180 
0x1382CA98, 37353947285458768, 89769740, 89769741, 1, 320x180 
0x1382CA98, 37353947286113184, 89769796, 89769798, 2, 320x180 
0x1382CA98, 37353947286742480, 89769876, 89769877, 1, 320x180 
0x1382CA98, 37353947287375864, 89769936, 89769938, 2, 320x180 
0x1382CA98, 37353947288175368, 89770013, 89770015, 2, 320x180 
0x1382CA98, 37353947288821888, 89770074, 89770075, 1, 320x180 
0x1382CA98, 37353947289455768, 89770146, 89770147, 1, 320x180 
0x1382CA98, 37353947290095008, 89770197, 89770201, 4, 320x180 
0x1382CA98, 37353947290736144, 89770265, 89770268, 3, 320x180 
0x1382CA98, 37353947291388400, 89770329, 89770330, 1, 320x180 
0x1382CA98, 37353947292179096, 89770404, 89770412, 8, 320x180 
0x1382CA98, 37353947292816024, 89770467, 89770469, 2, 320x180 
0x1382CA98, 37353947293459720, 89770541, 89770555, 14, 320x180 
0x1382CA98, 37353947294113376, 89770596, 89770597, 1, 320x180 
0x1382CA98, 37353947294736408, 89770664, 89770666, 2, 320x180 
0x1382CA98, 37353947295375584, 89770725, 89770726, 1, 320x180 
0x1382CA98, 37353947296175360, 89770804, 89770810, 6, 320x180 
0x1382CA98, 37353947296815808, 89770880, 89770883, 3, 320x180 
0x1382CA98, 37353947297456008, 89770934, 89770937, 3, 320x180 
0x1382CA98, 37353947298095232, 89771004, 89771005, 1, 320x180 
0x1382CA98, 37353947298738768, 89771059, 89771061, 2, 320x180 
0x1382CA98, 37353947299376584, 89771127, 89771130, 3, 320x180 
0x1382CA98, 37353947300179424, 89771204, 89771210, 6, 320x180 
0x1382CA98, 37353947300815712, 89771273, 89771274, 1, 320x180 
0x1382CA98, 37353947301455984, 89771333, 89771335, 2, 320x180 
0x1382CA98, 37353947302098232, 89771400, 89771402, 2, 320x180 
0x1382CA98, 37353947302750048, 89771467, 89771472, 5, 320x180 
0x1382CA98, 37353947303375824, 89771526, 89771529, 3, 320x180 
0x1382CA98, 37353947304175816, 89771607, 89771608, 1, 320x180 
0x1382CA98, 37353947304815264, 89771675, 89771676, 1, 320x180 
0x1382CA98, 37353947305455496, 89771740, 89771742, 2, 320x180 
0x1382CA98, 37353947306095640, 89771795, 89771796, 1, 320x180 
0x1382CA98, 37353947306736768, 89771873, 89771877, 4, 320x180 
0x1382CA98, 37353947307378832, 89771935, 89771937, 2, 320x180 
0x1382CA98, 37353947308178624, 89772015, 89772019, 4, 320x180 
0x1382CA98, 37353947308833088, 89772093, 89772095, 2, 320x180 
0x1382CA98, 37353947309461632, 89772152, 89772161, 9, 320x180 
0x1382CA98, 37353947310100720, 89772207, 89772209, 2, 320x180 
0x1382CA98, 37353947310736168, 89772270, 89772272, 2, 320x180 
0x1382CA98, 37353947311374888, 89772338, 89772341, 3, 320x180 
0x1382CA98, 37353947312203528, 89772420, 89772421, 1, 320x180 
0x1382CA98, 37353947312814544, 89772473, 89772475, 2, 320x180 
0x1382CA98, 37353947313456544, 89772542, 89772543, 1, 320x180 
0x1382CA98, 37353947314098488, 89772602, 89772604, 2, 320x180 
0x1382CA98, 37353947314781480, 89772673, 89772674, 1, 320x180 
0x1382CA98, 37353947315378744, 89772736, 89772737, 1, 320x180 
0x1382CA98, 37353947316174200, 89772813, 89772819, 6, 320x180 
0x1382CA98, 37353947316818416, 89772875, 89772877, 2, 320x180 
0x1382CA98, 37353947317455160, 89772938, 89772941, 3, 320x180 
0x1382CA98, 37353947318100520, 89773002, 89773004, 2, 320x180 
0x1382CA98, 37353947318743784, 89773069, 89773072, 3, 320x180 
0x1382CA98, 37353947319375248, 89773123, 89773126, 3, 320x180 
0x1382CA98, 37353947320186920, 89773216, 89773219, 3, 320x180 
0x1382CA98, 37353947320817624, 89773282, 89773285, 3, 320x180 
0x1382CA98, 37353947321455944, 89773337, 89773339, 2, 320x180 
0x1382CA98, 37353947322101392, 89773396, 89773400, 4, 320x180 
0x1382CA98, 37353947322734744, 89773471, 89773477, 6, 320x180 
0x1382CA98, 37353947323418136, 89773543, 89773554, 11, 320x180 
0x1382CA98, 37353947324020128, 89773593, 89773594, 1, 320x180 
0x1382CA98, 37353947324814576, 89773678, 89773680, 2, 320x180 
0x1382CA98, 37353947325459344, 89773731, 89773736, 5, 320x180 
0x1382CA98, 37353947326098344, 89773795, 89773796, 1, 320x180 
0x1382CA98, 37353947326737216, 89773867, 89773870, 3, 320x180 
0x1382CA98, 37353947327375328, 89773924, 89773930, 6, 320x180 
0x1382CA98, 37353947328016728, 89773987, 89773989, 2, 320x180 
0x1382CA98, 37353947328823360, 89774073, 89774091, 18, 320x180 
0x1382CA98, 37353947329454944, 89774139, 89774141, 2, 320x180 
0x1382CA98, 37353947330098416, 89774213, 89774221, 8, 320x180 
0x1382CA98, 37353947330736104, 89774272, 89774277, 5, 320x180 
0x1382CA98, 37353947331383520, 89774336, 89774352, 16, 320x180 
0x1382CA98, 37353947332015560, 89774401, 89774404, 3, 320x180 
0x1382CA98, 37353947332843712, 89774503, 89774507, 4, 320x180 
0x1382CA98, 37353947333476816, 89774571, 89774578, 7, 320x180 
0x1382CA98, 37353947334105440, 89774615, 89774624, 9, 320x180 
0x1382CA98, 37353947334748992, 89774669, 89774679, 10, 320x180 
0x1382CA98, 37353947335383232, 89774740, 89774747, 7, 320x180 
0x1382CA98, 37353947336016480, 89774791, 89774798, 7, 320x180 
0x1382CA98, 37353947336814440, 89774877, 89774883, 6, 320x180 
0x1382CA98, 37353947337470824, 89774940, 89774942, 2, 320x180 
0x1382CA98, 37353947338129984, 89775012, 89775013, 1, 320x180 
0x1382CA98, 37353947338761488, 89775079, 89775088, 9, 320x180 
0x1382CA98, 37353947339378800, 89775144, 89775151, 7, 320x180 
0x1382CA98, 37353947340030400, 89775198, 89775200, 2, 320x180 
0x1382CA98, 37353947340819248, 89775289, 89775292, 3, 320x180 
0x1382CA98, 37353947341456960, 89775340, 89775341, 1, 320x180 
0x1382CA98, 37353947342113008, 89775418, 89775425, 7, 320x180 
0x1382CA98, 37353947342734128, 89775467, 89775475, 8, 320x180 
0x1382CA98, 37353947343383992, 89775538, 89775540, 2, 320x180 
0x1382CA98, 37353947344014648, 89775597, 89775602, 5, 320x180 
0x1382CA98, 37353947344817296, 89775687, 89775693, 6, 320x180 
0x1382CA98, 37353947345462128, 89775745, 89775757, 12, 320x180 
0x1382CA98, 37353947346104600, 89775819, 89775839, 20, 320x180 
0x1382CA98, 37353947346766744, 89775877, 89775879, 2, 320x180 
0x1382CA98, 37353947347377680, 89775934, 89775943, 9, 320x180 
0x1382CA98, 37353947348020528, 89776005, 89776013, 8, 320x180 
0x1382CA98, 37353947348819152, 89776079, 89776085, 6, 320x180 
0x1382CA98, 37353947349458752, 89776168, 89776171, 3, 320x180 
0x1382CA98, 37353947350097600, 89776203, 89776212, 9, 320x180 
0x1382CA98, 37353947350739160, 89776271, 89776279, 8, 320x180 
0x1382CA98, 37353947351373720, 89776335, 89776337, 2, 320x180 
0x1382CA98, 37353947352020136, 89776400, 89776403, 3, 320x180 
0x1382CA98, 37353947352817000, 89776474, 89776475, 1, 320x180 
0x1382CA98, 37353947353458096, 89776539, 89776541, 2, 320x180 
0x1382CA98, 37353947354100216, 89776597, 89776604, 7, 320x180 
0x1382CA98, 37353947354735136, 89776666, 89776672, 6, 320x180 
0x1382CA98, 37353947355387096, 89776732, 89776734, 2, 320x180 
0x1382CA98, 37353947356014304, 89776791, 89776794, 3, 320x180 
0x1382CA98, 37353947356813472, 89776875, 89776883, 8, 320x180 
0x1382CA98, 37353947357454320, 89776944, 89776946, 2, 320x180 
0x1382CA98, 37353947358432224, 89777045, 89777047, 2, 640x360 
0x1382CA98, 37353947358742008, 89777065, 89777072, 7, 640x360 
0x1382CA98, 37353947359057064, 89777099, 89777105, 6, 640x360 
0x1382CA98, 37353947359376544, 89777132, 89777135, 3, 640x360 
0x1382CA98, 37353947359696752, 89777164, 89777166, 2, 640x360 
0x1382CA98, 37353947360018416, 89777191, 89777198, 7, 640x360 
0x1382CA98, 37353947360351200, 89777233, 89777237, 4, 640x360 
0x1382CA98, 37353947360817456, 89777268, 89777273, 5, 640x360 
0x1382CA98, 37353947361138680, 89777311, 89777320, 9, 640x360 
0x1382CA98, 37353947361455856, 89777348, 89777363, 15, 640x360 
0x1382CA98, 37353947361808224, 89777384, 89777397, 13, 640x360 
0x1382CA98, 37353947362117400, 89777410, 89777413, 3, 640x360 
0x1382CA98, 37353947362421768, 89777434, 89777444, 10, 640x360 
0x1382CA98, 37353947362764392, 89777486, 89777489, 3, 640x360 
0x1382CA98, 37353947363054568, 89777508, 89777511, 3, 640x360 
0x1382CA98, 37353947363373184, 89777528, 89777531, 3, 640x360 
0x1382CA98, 37353947363698624, 89777572, 89777574, 2, 640x360 
0x1382CA98, 37353947364013488, 89777595, 89777602, 7, 640x360 
0x1382CA98, 37353947364337392, 89777626, 89777628, 2, 640x360 
0x1382CA98, 37353947364816904, 89777681, 89777685, 4, 640x360 
0x1382CA98, 37353947365138664, 89777707, 89777716, 9, 640x360 
0x1382CA98, 37353947365456032, 89777742, 89777744, 2, 640x360 
0x1382CA98, 37353947365791192, 89777773, 89777779, 6, 640x360 
0x1382CA98, 37353947366103088, 89777803, 89777805, 2, 640x360 
0x1382CA98, 37353947366414512, 89777833, 89777836, 3, 640x360 
0x1382CA98, 37353947366750800, 89777869, 89777874, 5, 640x360 
0x1382CA98, 37353947367054248, 89777896, 89777902, 6, 640x360 
0x1382CA98, 37353947367374824, 89777931, 89777940, 9, 640x360 
0x1382CA98, 37353947367704432, 89777960, 89777963, 3, 640x360 
0x1382CA98, 37353947368018632, 89777990, 89777993, 3, 640x360 
0x1382CA98, 37353947368333608, 89778024, 89778027, 3, 640x360 
0x1382CA98, 37353947368812600, 89778079, 89778081, 2, 640x360 
0x1382CA98, 37353947369133448, 89778101, 89778110, 9, 640x360 
0x1382CA98, 37353947369458112, 89778137, 89778147, 10, 640x360 
0x1382CA98, 37353947369783736, 89778170, 89778176, 6, 640x360 
0x1382CA98, 37353947370095432, 89778197, 89778200, 3, 640x360 
0x1382CA98, 37353947370426616, 89778229, 89778233, 4, 640x360 
0x1382CA98, 37353947370734128, 89778266, 89778275, 9, 640x360 
0x1382CA98, 37353947371053808, 89778304, 89778306, 2, 640x360 
0x1382CA98, 37353947371392008, 89778339, 89778342, 3, 640x360 
0x1382CA98, 37353947371693600, 89778369, 89778374, 5, 640x360 
0x1382CA98, 37353947372013984, 89778402, 89778407, 5, 640x360 
0x1382CA98, 37353947372337232, 89778429, 89778434, 5, 640x360 
0x1382CA98, 37353947372812640, 89778484, 89778488, 4, 640x360 
0x1382CA98, 37353947373133264, 89778512, 89778518, 6, 640x360 
0x1382CA98, 37353947373453472, 89778547, 89778550, 3, 640x360 
0x1382CA98, 37353947373807632, 89778567, 89778575, 8, 640x360 
0x1382CA98, 37353947374099176, 89778602, 89778611, 9, 640x360 
0x1382CA98, 37353947374437880, 89778629, 89778632, 3, 640x360 
0x1382CA98, 37353947374733584, 89778663, 89778665, 2, 640x360 
0x1382CA98, 37353947375053864, 89778695, 89778698, 3, 640x360 
0x1382CA98, 37353947375376664, 89778730, 89778732, 2, 640x360 
0x1382CA98, 37353947375692768, 89778756, 89778764, 8, 640x360 
0x1382CA98, 37353947376015392, 89778798, 89778801, 3, 640x360 
0x1382CA98, 37353947376341936, 89778826, 89778827, 1, 640x360 
0x1382CA98, 37353947376812512, 89778876, 89778878, 2, 640x360 
0x1382CA98, 37353947377133496, 89778906, 89778908, 2, 640x360 
0x1382CA98, 37353947377459416, 89778935, 89778939, 4, 640x360 
0x1382CA98, 37353947377783296, 89778973, 89778975, 2, 640x360 
0x1382CA98, 37353947378096864, 89778999, 89779006, 7, 640x360 
0x1382CA98, 37353947378423880, 89779039, 89779041, 2, 640x360 
0x1382CA98, 37353947378737032, 89779068, 89779071, 3, 640x360 
0x1382CA98, 37353947379062616, 89779094, 89779097, 3, 640x360 
0x1382CA98, 37353947379379824, 89779132, 89779135, 3, 640x360 
0x1382CA98, 37353947379693160, 89779155, 89779158, 3, 640x360 
0x1382CA98, 37353947380016544, 89779189, 89779198, 9, 640x360 
0x1382CA98, 37353947380337144, 89779223, 89779226, 3, 640x360 
0x1382CA98, 37353947380658176, 89779265, 89779269, 4, 640x360 
0x1382CA98, 37353947381137216, 89779305, 89779312, 7, 640x360 
0x1382CA98, 37353947381456400, 89779340, 89779346, 6, 640x360 
0x1382CA98, 37353947381772632, 89779367, 89779372, 5, 640x360 
0x1382CA98, 37353947382099928, 89779398, 89779404, 6, 640x360 
0x1382CA98, 37353947382418352, 89779443, 89779445, 2, 640x360 
0x1382CA98, 37353947382733336, 89779476, 89779479, 3, 640x360 
0x1382CA98, 37353947383059376, 89779509, 89779512, 3, 640x360 
0x1382CA98, 37353947383373952, 89779538, 89779547, 9, 640x360 
0x1382CA98, 37353947383704464, 89779577, 89779586, 9, 640x360 
0x1382CA98, 37353947384013280, 89779606, 89779622, 16, 640x360 
0x1382CA98, 37353947384361136, 89779662, 89779670, 8, 640x360 
0x1382CA98, 37353947384715800, 89779687, 89779703, 16, 640x360 
0x1382CA98, 37353947385232184, 89779720, 89779741, 21, 640x360 
0x1382CA98, 37353947385486032, 89779756, 89779760, 4, 640x360 
0x1382CA98, 37353947385773192, 89779778, 89779780, 2, 640x360 
0x1382CA98, 37353947386137488, 89779846, 89779852, 6, 640x360 
0x1382CA98, 37353947386466704, 89779853, 89779878, 25, 640x360 
0x1382CA98, 37353947386768024, 89779890, 89779922, 32, 640x360 
0x1382CA98, 37353947387060264, 89779922, 89779941, 19, 640x360 
0x1382CA98, 37353947387378992, 89779978, 89779991, 13, 640x360 
0x1382CA98, 37353947387905296, 89780044, 89780047, 3, 640x360 
0x1382CA98, 37353947388477080, 89780078, 89780081, 3, 640x360 
0x1382CA98, 37353947388877680, 89780104, 89780108, 4, 640x360 
0x1382CA98, 37353947389104528, 89780120, 89780128, 8, 640x360 
0x1382CA98, 37353947389343720, 89780163, 89780172, 9, 640x360 
0x1382CA98, 37353947389615512, 89780172, 89780175, 3, 640x360 
0x1382CA98, 37353947390113880, 89780208, 89780211, 3, 640x360 
0x1382CA98, 37353947390492328, 89780242, 89780244, 2, 640x360 
0x1382CA98, 37353947390736744, 89780266, 89780273, 7, 640x360 
0x1382CA98, 37353947391052400, 89780297, 89780301, 4, 640x360 
0x1382CA98, 37353947391372368, 89780333, 89780338, 5, 640x360 
0x1382CA98, 37353947391699464, 89780360, 89780368, 8, 640x360 
0x1382CA98, 37353947392016248, 89780402, 89780405, 3, 640x360 
0x1382CA98, 37353947392334800, 89780427, 89780429, 2, 640x360 
0x1382CA98, 37353947392667000, 89780458, 89780464, 6, 640x360 
0x1382CA98, 37353947393132344, 89780515, 89780521, 6, 640x360 
0x1382CA98, 37353947393452832, 89780534, 89780542, 8, 640x360 
0x1382CA98, 37353947393776064, 89780573, 89780575, 2, 640x360 
0x1382CA98, 37353947394098832, 89780601, 89780605, 4, 640x360 
0x1382CA98, 37353947394415952, 89780636, 89780638, 2, 640x360 
0x1382CA98, 37353947394732384, 89780669, 89780673, 4, 640x360 
0x1382CA98, 37353947395052376, 89780702, 89780706, 4, 640x360 
0x1382CA98, 37353947395372368, 89780737, 89780740, 3, 640x360 
0x1382CA98, 37353947395692432, 89780758, 89780766, 8, 640x360 
0x1382CA98, 37353947396016128, 89780791, 89780793, 2, 640x360 
0x1382CA98, 37353947396339192, 89780828, 89780836, 8, 640x360 
0x1382CA98, 37353947396653760, 89780859, 89780862, 3, 640x360 
0x1382CA98, 37353947397180136, 89780915, 89780918, 3, 640x360 
0x1382CA98, 37353947397457544, 89780943, 89780948, 5, 640x360 
0x1382CA98, 37353947397783504, 89780975, 89780983, 8, 640x360 
0x1382CA98, 37353947398092640, 89780997, 89781000, 3, 640x360 
0x1382CA98, 37353947398430368, 89781035, 89781038, 3, 640x360 
0x1382CA98, 37353947398743704, 89781064, 89781066, 2, 640x360 
0x1382CA98, 37353947399052160, 89781096, 89781098, 2, 640x360 
0x1382CA98, 37353947399388272, 89781127, 89781131, 4, 640x360 
0x1382CA98, 37353947399693432, 89781158, 89781161, 3, 640x360 
0x1382CA98, 37353947400018144, 89781198, 89781204, 6, 640x360 
0x1382CA98, 37353947400337840, 89781221, 89781228, 7, 640x360 
0x1382CA98, 37353947400653688, 89781257, 89781260, 3, 640x360 
0x1382CA98, 37353947401132856, 89781303, 89781305, 2, 640x360 
0x1382CA98, 37353947401452584, 89781339, 89781341, 2, 640x360 
0x1382CA98, 37353947401776248, 89781365, 89781368, 3, 640x360 
0x1382CA98, 37353947402097304, 89781397, 89781401, 4, 640x360 
0x1382CA98, 37353947402416912, 89781433, 89781440, 7, 640x360 
0x1382CA98, 37353947402737800, 89781470, 89781478, 8, 640x360 
0x1382CA98, 37353947403052096, 89781503, 89781511, 8, 640x360 
0x1382CA98, 37353947403377848, 89781538, 89781546, 8, 640x360 
0x1382CA98, 37353947403706344, 89781572, 89781578, 6, 640x360 
0x1382CA98, 37353947404015600, 89781602, 89781605, 3, 640x360 
0x1382CA98, 37353947404332416, 89781624, 89781629, 5, 640x360 
0x1382CA98, 37353947404658120, 89781657, 89781660, 3, 640x360 
0x1382CA98, 37353947404982216, 89781698, 89781700, 2, 640x360 
0x1382CA98, 37353947405456552, 89781737, 89781744, 7, 640x360 
0x1382CA98, 37353947405773728, 89781781, 89781783, 2, 640x360 
0x1382CA98, 37353947406099352, 89781799, 89781804, 5, 640x360 
0x1382CA98, 37353947406412296, 89781826, 89781829, 3, 640x360 
0x1382CA98, 37353947406732328, 89781868, 89781876, 8, 640x360 
0x1382CA98, 37353947407052760, 89781899, 89781904, 5, 640x360 
0x1382CA98, 37353947407380216, 89781938, 89781945, 7, 640x360 
0x1382CA98, 37353947407693264, 89781965, 89781971, 6, 640x360 
0x1382CA98, 37353947408020480, 89781992, 89781995, 3, 640x360 
0x1382CA98, 37353947408332224, 89782024, 89782026, 2, 640x360 
0x1382CA98, 37353947408656128, 89782055, 89782057, 2, 640x360 
0x1382CA98, 37353947408977120, 89782091, 89782098, 7, 640x360 
0x1382CA98, 37353947409455008, 89782133, 89782138, 5, 640x360 
0x1382CA98, 37353947409772616, 89782164, 89782166, 2, 640x360 
0x1382CA98, 37353947410092800, 89782195, 89782198, 3, 640x360 
0x1382CA98, 37353947410414576, 89782226, 89782229, 3, 640x360 
0x1382CA98, 37353947410733080, 89782262, 89782264, 2, 640x360 
0x1382CA98, 37353947411059304, 89782303, 89782305, 2, 640x360 
0x1382CA98, 37353947411372672, 89782331, 89782336, 5, 640x360 
0x1382CA98, 37353947411697152, 89782371, 89782373, 2, 640x360 
0x1382CA98, 37353947412013464, 89782391, 89782395, 4, 640x360 
0x1382CA98, 37353947412338408, 89782436, 89782439, 3, 640x360 
0x1382CA98, 37353947412653352, 89782458, 89782461, 3, 640x360 
0x1382CA98, 37353947412983816, 89782500, 89782512, 12, 640x360 
0x1382CA98, 37353947413454624, 89782548, 89782554, 6, 640x360 
0x1382CA98, 37353947413780600, 89782577, 89782583, 6, 640x360 
0x1382CA98, 37353947414096024, 89782607, 89782609, 2, 640x360 
0x1382CA98, 37353947414415288, 89782638, 89782644, 6, 640x360 
0x1382CA98, 37353947414732664, 89782681, 89782686, 5, 640x360 
0x1382CA98, 37353947415061176, 89782698, 89782702, 4, 640x360 
0x1382CA98, 37353947415383456, 89782731, 89782740, 9, 640x360 
0x1382CA98, 37353947415710608, 89782770, 89782782, 12, 640x360 
0x1382CA98, 37353947416021536, 89782824, 89782842, 18, 640x360 
0x1382CA98, 37353947416361816, 89782842, 89782852, 10, 640x360 
0x1382CA98, 37353947416669376, 89782886, 89782900, 14, 640x360 
0x1382CA98, 37353947417012144, 89782908, 89782941, 33, 640x360 
0x1382CA98, 37353947417496120, 89782965, 89782982, 17, 640x360 
0x1382CA98, 37353947417780864, 89782982, 89782991, 9, 640x360 
0x1382CA98, 37353947418126688, 89783019, 89783022, 3, 640x360 
0x1382CA98, 37353947418416008, 89783045, 89783048, 3, 640x360 
0x1382CA98, 37353947418732520, 89783066, 89783073, 7, 640x360 
0x1382CA98, 37353947419051520, 89783092, 89783094, 2, 640x360 
0x1382CA98, 37353947419372896, 89783130, 89783132, 2, 640x360 
0x1382CA98, 37353947419695296, 89783164, 89783180, 16, 640x360 
0x1382CA98, 37353947420020304, 89783197, 89783201, 4, 640x360 
0x1382CA98, 37353947420339752, 89783246, 89783256, 10, 640x360 
0x1382CA98, 37353947420652808, 89783263, 89783265, 2, 640x360 
0x1382CA98, 37353947420979376, 89783297, 89783299, 2, 640x360 
0x1382CA98, 37353947421456480, 89783334, 89783338, 4, 640x360 
0x1382CA98, 37353947421772440, 89783368, 89783378, 10, 640x360 
0x1382CA98, 37353947422101328, 89783403, 89783410, 7, 640x360 
0x1382CA98, 37353947422414640, 89783429, 89783433, 4, 640x360 
0x1382CA98, 37353947422765152, 89783466, 89783475, 9, 640x360 
0x1382CA98, 37353947423051496, 89783493, 89783496, 3, 640x360 
0x1382CA98, 37353947423372552, 89783525, 89783528, 3, 640x360 
0x1382CA98, 37353947423695536, 89783557, 89783567, 10, 640x360 
0x1382CA98, 37353947424012000, 89783597, 89783599, 2, 640x360 
0x1382CA98, 37353947424331992, 89783630, 89783633, 3, 640x360 
0x1382CA98, 37353947424655568, 89783658, 89783665, 7, 640x360 
0x1382CA98, 37353947424987968, 89783694, 89783695, 1, 640x360 
0x1382CA98, 37353947425451056, 89783738, 89783745, 7, 640x360 
0x1382CA98, 37353947425780168, 89783781, 89783784, 3, 640x360 
0x1382CA98, 37353947426096488, 89783809, 89783811, 2, 640x360 
0x1382CA98, 37353947426426896, 89783835, 89783845, 10, 640x360 
0x1382CA98, 37353947426732016, 89783865, 89783878, 13, 640x360 
0x1382CA98, 37353947427056104, 89783897, 89783901, 4, 640x360 
0x1382CA98, 37353947427374360, 89783925, 89783928, 3, 640x360 
0x1382CA98, 37353947427691640, 89783974, 89783987, 13, 640x360 
0x1382CA98, 37353947428017648, 89784008, 89784011, 3, 640x360 
0x1382CA98, 37353947428338272, 89784023, 89784028, 5, 640x360 
0x1382CA98, 37353947428656576, 89784069, 89784071, 2, 640x360 
0x1382CA98, 37353947428971504, 89784094, 89784096, 2, 640x360 
0x1382CA98, 37353947429451448, 89784141, 89784146, 5, 640x360 
0x1382CA98, 37353947429781344, 89784165, 89784173, 8, 640x360 
0x1382CA98, 37353947430103312, 89784203, 89784211, 8, 640x360 
0x1382CA98, 37353947430414376, 89784229, 89784233, 4, 640x360 
0x1382CA98, 37353947430731112, 89784272, 89784280, 8, 640x360 
0x1382CA98, 37353947431052152, 89784306, 89784314, 8, 640x360 
0x1382CA98, 37353947431376376, 89784338, 89784341, 3, 640x360 
0x1382CA98, 37353947431691360, 89784358, 89784369, 11, 640x360 
0x1382CA98, 37353947432015136, 89784397, 89784402, 5, 640x360 
0x1382CA98, 37353947432331384, 89784421, 89784424, 3, 640x360 
0x1382CA98, 37353947432657256, 89784465, 89784469, 4, 640x360 
0x1382CA98, 37353947432972840, 89784494, 89784496, 2, 640x360 
0x1382CA98, 37353947433293064, 89784524, 89784527, 3, 640x360 
0x1382CA98, 37353947433774080, 89784576, 89784583, 7, 640x360 
0x1382CA98, 37353947434097520, 89784607, 89784610, 3, 640x360 
0x1382CA98, 37353947434430936, 89784633, 89784642, 9, 640x360 
0x1382CA98, 37353947434737840, 89784668, 89784671, 3, 640x360 
0x1382CA98, 37353947435064200, 89784693, 89784695, 2, 640x360 
0x1382CA98, 37353947435374120, 89784731, 89784734, 3, 640x360 
0x1382CA98, 37353947435695656, 89784772, 89784782, 10, 640x360 
0x1382CA98, 37353947436015984, 89784792, 89784804, 12, 640x360 
0x1382CA98, 37353947436334416, 89784826, 89784831, 5, 640x360 
0x1382CA98, 37353947436654024, 89784854, 89784856, 2, 640x360 
0x1382CA98, 37353947436971416, 89784885, 89784887, 2, 640x360 
0x1382CA98, 37353947437292488, 89784918, 89784928, 10, 640x360 
0x1382CA98, 37353947437778192, 89784973, 89784990, 17, 640x360 
0x1382CA98, 37353947438115640, 89785007, 89785020, 13, 640x360 
0x1382CA98, 37353947438433680, 89785041, 89785053, 12, 640x360 
0x1382CA98, 37353947438781752, 89785074, 89785077, 3, 640x360 
0x1382CA98, 37353947439055176, 89785103, 89785111, 8, 640x360 
0x1382CA98, 37353947439380744, 89785138, 89785143, 5, 640x360 
0x1382CA98, 37353947439692440, 89785172, 89785175, 3, 640x360 
0x1382CA98, 37353947440012312, 89785195, 89785198, 3, 640x360 
0x1382CA98, 37353947440332008, 89785226, 89785230, 4, 640x360 
0x1382CA98, 37353947440696896, 89785272, 89785278, 6, 640x360 
0x1382CA98, 37353947440978136, 89785292, 89785295, 3, 640x360 
0x1382CA98, 37353947441305584, 89785328, 89785333, 5, 640x360 
0x1382CA98, 37353947441779336, 89785387, 89785390, 3, 640x360 
0x1382CA98, 37353947442103664, 89785423, 89785436, 13, 640x360 
0x1382CA98, 37353947442418328, 89785436, 89785440, 4, 640x360 
0x1382CA98, 37353947442733112, 89785475, 89785478, 3, 640x360 
0x1382CA98, 37353947443050984, 89785496, 89785498, 2, 640x360 
0x1382CA98, 37353947443375576, 89785530, 89785538, 8, 640x360 
0x1382CA98, 37353947443722912, 89785568, 89785578, 10, 640x360 
0x1382CA98, 37353947444015424, 89785595, 89785597, 2, 640x360 
0x1382CA98, 37353947444334512, 89785630, 89785632, 2, 640x360 
0x1382CA98, 37353947444660480, 89785657, 89785666, 9, 640x360 
0x1382CA98, 37353947444982504, 89785702, 89785705, 3, 640x360 
0x1382CA98, 37353947445292832, 89785726, 89785736, 10, 640x360 
0x1382CA98, 37353947445786560, 89785769, 89785772, 3, 640x360 
0x1382CA98, 37353947446106584, 89785796, 89785799, 3, 640x360 
0x1382CA98, 37353947446413864, 89785836, 89785856, 20, 640x360 
0x1382CA98, 37353947446805352, 89785895, 89785905, 10, 640x360 
0x1382CA98, 37353947447102424, 89785930, 89785939, 9, 640x360 
0x1382CA98, 37353947447401080, 89785939, 89785946, 7, 640x360 
0x1382CA98, 37353947447701432, 89785963, 89786001, 38, 640x360 
0x1382CA98, 37353947448019936, 89786024, 89786031, 7, 640x360 
0x1382CA98, 37353947448346464, 89786056, 89786059, 3, 640x360 
0x1382CA98, 37353947448663736, 89786074, 89786078, 4, 640x360 
0x1382CA98, 37353947448983112, 89786090, 89786092, 2, 640x360 
0x1382CA98, 37353947449334792, 89786123, 89786127, 4, 640x360 
0x1382CA98, 37353947449778240, 89786177, 89786180, 3, 640x360 
0x1382CA98, 37353947450098520, 89786198, 89786211, 13, 640x360 
0x1382CA98, 37353947450416496, 89786231, 89786246, 15, 640x360 
0x1382CA98, 37353947450755432, 89786274, 89786281, 7, 640x360 
0x1382CA98, 37353947451058024, 89786305, 89786311, 6, 640x360 
0x1382CA98, 37353947451372296, 89786328, 89786332, 4, 640x360 
0x1382CA98, 37353947451692336, 89786357, 89786360, 3, 640x360 
0x1382CA98, 37353947452015216, 89786392, 89786395, 3, 640x360 
0x1382CA98, 37353947452331768, 89786425, 89786427, 2, 640x360 
0x1382CA98, 37353947452659120, 89786466, 89786472, 6, 640x360 
0x1382CA98, 37353947452982392, 89786493, 89786496, 3, 640x360 
0x1382CA98, 37353947453313960, 89786529, 89786539, 10, 640x360 
0x1382CA98, 37353947453792080, 89786581, 89786586, 5, 640x360 
0x1382CA98, 37353947454107024, 89786606, 89786608, 2, 640x360 
0x1382CA98, 37353947454423496, 89786634, 89786640, 6, 640x360 
0x1382CA98, 37353947454733952, 89786681, 89786684, 3, 640x360 
0x1382CA98, 37353947455051544, 89786709, 89786724, 15, 640x360 
0x1382CA98, 37353947455384088, 89786732, 89786741, 9, 640x360 
0x1382CA98, 37353947455691128, 89786770, 89786779, 9, 640x360 
0x1382CA98, 37353947456031360, 89786804, 89786814, 10, 640x360 
0x1382CA98, 37353947456335808, 89786836, 89786838, 2, 640x360 
0x1382CA98, 37353947456657616, 89786857, 89786861, 4, 640x360 
0x1382CA98, 37353947456984472, 89786903, 89786908, 5, 640x360 
0x1382CA98, 37353947457304176, 89786938, 89786940, 2, 640x360 
0x1382CA98, 37353947457784600, 89786972, 89786977, 5, 640x360 
0x1382CA98, 37353947458097960, 89787001, 89787005, 4, 640x360 
0x1382CA98, 37353947458420664, 89787028, 89787033, 5, 640x360 
0x1382CA98, 37353947458731008, 89787071, 89787074, 3, 640x360 
0x1382CA98, 37353947459055952, 89787103, 89787106, 3, 640x360 
0x1382CA98, 37353947459377496, 89787137, 89787142, 5, 640x360 
0x1382CA98, 37353947459698240, 89787161, 89787163, 2, 640x360 
0x1382CA98, 37353947460010768, 89787193, 89787202, 9, 640x360 
0x1382CA98, 37353947460336872, 89787226, 89787229, 3, 640x360 
0x1382CA98, 37353947460668960, 89787256, 89787264, 8, 640x360 
0x1382CA98, 37353947460996544, 89787289, 89787292, 3, 640x360 
0x1382CA98, 37353947461301216, 89787336, 89787346, 10, 640x360 
0x1382CA98, 37353947461623320, 89787367, 89787378, 11, 640x360 
0x1382CA98, 37353947462097400, 89787403, 89787405, 2, 640x360 
0x1382CA98, 37353947462414584, 89787429, 89787432, 3, 640x360 
0x1382CA98, 37353947462730560, 89787472, 89787474, 2, 640x360 
0x1382CA98, 37353947463053176, 89787500, 89787503, 3, 640x360 
0x1382CA98, 37353947463390392, 89787530, 89787533, 3, 640x360 
0x1382CA98, 37353947463698720, 89787573, 89787585, 12, 640x360 
0x1382CA98, 37353947464063288, 89787603, 89787610, 7, 640x360 
0x1382CA98, 37353947464333288, 89787625, 89787632, 7, 640x360 
0x1382CA98, 37353947464660040, 89787664, 89787668, 4, 640x360 
0x1382CA98, 37353947464971552, 89787696, 89787698, 2, 640x360 
0x1382CA98, 37353947465295480, 89787730, 89787734, 4, 640x360 
0x1382CA98, 37353947465622232, 89787757, 89787760, 3, 640x360 
0x1382CA98, 37353947466183048, 89787806, 89787808, 2, 640x360 
0x1382CA98, 37353947466437632, 89787833, 89787845, 12, 640x360 
0x1382CA98, 37353947466768216, 89787876, 89787881, 5, 640x360 
0x1382CA98, 37353947467056376, 89787908, 89787924, 16, 640x360 
0x1382CA98, 37353947467376696, 89787936, 89787939, 3, 640x360 
0x1382CA98, 37353947467691048, 89787961, 89787963, 2, 640x360 
0x1382CA98, 37353947468020472, 89788005, 89788012, 7, 640x360 
0x1382CA98, 37353947468335120, 89788024, 89788028, 4, 640x360 
0x1382CA98, 37353947468651192, 89788058, 89788061, 3, 640x360 
0x1382CA98, 37353947468976168, 89788091, 89788093, 2, 640x360 
0x1382CA98, 37353947469307856, 89788140, 89788147, 7, 640x360 
0x1382CA98, 37353947469627968, 89788164, 89788170, 6, 640x360 
0x1382CA98, 37353947470095328, 89788204, 89788212, 8, 640x360 
0x1382CA98, 37353947470432160, 89788234, 89788241, 7, 640x360 
0x1382CA98, 37353947470734408, 89788274, 89788277, 3, 640x360 
0x1382CA98, 37353947471050328, 89788306, 89788314, 8, 640x360 
0x1382CA98, 37353947471378496, 89788330, 89788336, 6, 640x360 
0x1382CA98, 37353947471690880, 89788362, 89788365, 3, 640x360 
0x1382CA98, 37353947472014176, 89788397, 89788402, 5, 640x360 
0x1382CA98, 37353947472344920, 89788428, 89788430, 2, 640x360 
0x1382CA98, 37353947472658960, 89788458, 89788461, 3, 640x360 
0x1382CA98, 37353947473012552, 89788496, 89788498, 2, 640x360 
0x1382CA98, 37353947473305728, 89788524, 89788533, 9, 640x360 
0x1382CA98, 37353947473634168, 89788559, 89788562, 3, 640x360 
0x1382CA98, 37353947474097208, 89788603, 89788611, 8, 640x360 
0x1382CA98, 37353947474440560, 89788638, 89788644, 6, 640x360 
0x1382CA98, 37353947474729752, 89788670, 89788677, 7, 640x360 
0x1382CA98, 37353947475050752, 89788704, 89788707, 3, 640x360 
0x1382CA98, 37353947475392544, 89788741, 89788748, 7, 640x360 
0x1382CA98, 37353947475694352, 89788772, 89788774, 2, 640x360 
0x1382CA98, 37353947476011296, 89788799, 89788805, 6, 640x360 
0x1382CA98, 37353947476330896, 89788825, 89788828, 3, 640x360 
0x1382CA98, 37353947476651784, 89788865, 89788868, 3, 640x360 
0x1382CA98, 37353947476971120, 89788902, 89788904, 2, 640x360 
0x1382CA98, 37353947477291888, 89788925, 89788927, 2, 640x360 
0x1382CA98, 37353947477618688, 89788957, 89788964, 7, 640x360 
0x1382CA98, 37353947478093824, 89789005, 89789008, 3, 640x360 
0x1382CA98, 37353947478413840, 89789028, 89789031, 3, 640x360 
0x1382CA98, 37353947478734288, 89789069, 89789077, 8, 640x360 
0x1382CA98, 37353947479050312, 89789097, 89789111, 14, 640x360 
0x1382CA98, 37353947479372976, 89789138, 89789141, 3, 640x360 
0x1382CA98, 37353947479695240, 89789159, 89789162, 3, 640x360 
0x1382CA98, 37353947480020312, 89789210, 89789229, 19, 640x360 
0x1382CA98, 37353947480335984, 89789236, 89789242, 6, 640x360 
0x1382CA98, 37353947480666144, 89789270, 89789286, 16, 640x360 
0x1382CA98, 37353947481008360, 89789318, 89789338, 20, 640x360 
0x1382CA98, 37353947481389128, 89789343, 89789372, 29, 640x360 
0x1382CA98, 37353947481643640, 89789389, 89789407, 18, 640x360 
0x1382CA98, 37353947482122328, 89789422, 89789425, 3, 640x360 
0x1382CA98, 37353947482438984, 89789445, 89789476, 31, 640x360 
0x1382CA98, 37353947482765600, 89789478, 89789495, 17, 640x360 
0x1382CA98, 37353947483084256, 89789525, 89789529, 4, 640x360 
0x1382CA98, 37353947483491456, 89789547, 89789563, 16, 640x360 
0x1382CA98, 37353947483712408, 89789575, 89789581, 6, 640x360 
0x1382CA98, 37353947484012112, 89789598, 89789613, 15, 640x360 
0x1382CA98, 37353947484337888, 89789635, 89789644, 9, 640x360 
0x1382CA98, 37353947484655160, 89789657, 89789663, 6, 640x360 
0x1382CA98, 37353947484972488, 89789685, 89789690, 5, 640x360 
0x1382CA98, 37353947485290528, 89789729, 89789731, 2, 640x360 
0x1382CA98, 37353947485611336, 89789750, 89789753, 3, 640x360 
0x1382CA98, 37353947486089816, 89789796, 89789802, 6, 640x360 
0x1382CA98, 37353947486413880, 89789833, 89789842, 9, 640x360 
0x1382CA98, 37353947486748856, 89789868, 89789875, 7, 640x360 
0x1382CA98, 37353947487050984, 89789897, 89789899, 2, 640x360 
0x1382CA98, 37353947487384536, 89789929, 89789931, 2, 640x360 
0x1382CA98, 37353947487718144, 89789968, 89789971, 3, 640x360 
0x1382CA98, 37353947488014008, 89789996, 89789999, 3, 640x360 
0x1382CA98, 37353947488329944, 89790025, 89790028, 3, 640x360 
0x1382CA98, 37353947488654104, 89790057, 89790067, 10, 640x360 
0x1382CA98, 37353947488971608, 89790082, 89790088, 6, 640x360 
0x1382CA98, 37353947489290680, 89790115, 89790128, 13, 640x360 
0x1382CA98, 37353947489628216, 89790156, 89790161, 5, 640x360 
0x1382CA98, 37353947489937960, 89790186, 89790193, 7, 640x360 
0x1382CA98, 37353947490412232, 89790234, 89790237, 3, 640x360 
0x1382CA98, 37353947490729896, 89790263, 89790266, 3, 640x360 
0x1382CA98, 37353947491078552, 89790295, 89790298, 3, 640x360 
0x1382CA98, 37353947491386216, 89790336, 89790338, 2, 640x360 
0x1382CA98, 37353947491694880, 89790371, 89790385, 14, 640x360 
0x1382CA98, 37353947492025704, 89790393, 89790397, 4, 640x360 
0x1382CA98, 37353947492335688, 89790431, 89790433, 2, 640x360 
0x1382CA98, 37353947492653232, 89790458, 89790461, 3, 640x360 
0x1382CA98, 37353947492978944, 89790492, 89790494, 2, 640x360 
0x1382CA98, 37353947493290640, 89790523, 89790532, 9, 640x360 
0x1382CA98, 37353947493617248, 89790560, 89790562, 2, 640x360 
0x1382CA98, 37353947493959080, 89790597, 89790601, 4, 640x360 
0x1382CA98, 37353947494416648, 89790639, 89790642, 3, 640x360 
0x1382CA98, 37353947494729944, 89790668, 89790672, 4, 640x360 
0x1382CA98, 37353947495085432, 89790698, 89790705, 7, 640x360 
0x1382CA98, 37353947495371400, 89790729, 89790732, 3, 640x360 
0x1382CA98, 37353947495693968, 89790760, 89790762, 2, 640x360 
0x1382CA98, 37353947496018440, 89790794, 89790797, 3, 640x360 
0x1382CA98, 37353947496329496, 89790825, 89790828, 3, 640x360 
0x1382CA98, 37353947496654136, 89790856, 89790864, 8, 640x360 
0x1382CA98, 37353947496978168, 89790889, 89790895, 6, 640x360 
0x1382CA98, 37353947497292232, 89790915, 89790924, 9, 640x360 
0x1382CA98, 37353947497615880, 89790949, 89790962, 13, 640x360 
0x1382CA98, 37353947497955096, 89790997, 89790999, 2, 640x360 
0x1382CA98, 37353947498409928, 89791041, 89791057, 16, 640x360 
0x1382CA98, 37353947498736560, 89791094, 89791103, 9, 640x360 
0x1382CA98, 37353947499056304, 89791106, 89791113, 7, 640x360 
0x1382CA98, 37353947499387736, 89791132, 89791145, 13, 640x360 
0x1382CA98, 37353947499691936, 89791180, 89791185, 5, 640x360 
0x1382CA98, 37353947500014272, 89791203, 89791212, 9, 640x360 
0x1382CA98, 37353947500349576, 89791237, 89791245, 8, 640x360 
0x1382CA98, 37353947500656672, 89791257, 89791263, 6, 640x360 
0x1382CA98, 37353947500974048, 89791295, 89791298, 3, 640x360 
0x1382CA98, 37353947501291760, 89791327, 89791335, 8, 640x360 
0x1382CA98, 37353947501612400, 89791355, 89791357, 2, 640x360 
0x1382CA98, 37353947501930752, 89791389, 89791395, 6, 640x360 
0x1382CA98, 37353947502411512, 89791428, 89791430, 2, 640x360 
0x1382CA98, 37353947502733592, 89791465, 89791467, 2, 640x360 
0x1382CA98, 37353947503052096, 89791495, 89791498, 3, 640x360 
0x1382CA98, 37353947503385920, 89791531, 89791533, 2, 640x360 
0x1382CA98, 37353947503694880, 89791567, 89791571, 4, 640x360 
0x1382CA98, 37353947504009280, 89791590, 89791592, 2, 640x360 
0x1382CA98, 37353947504334208, 89791622, 89791625, 3, 640x360 
0x1382CA98, 37353947504655168, 89791658, 89791661, 3, 640x360 
0x1382CA98, 37353947504970464, 89791690, 89791693, 3, 640x360 
0x1382CA98, 37353947505290040, 89791725, 89791737, 12, 640x360 
0x1382CA98, 37353947505617008, 89791756, 89791759, 3, 640x360 
0x1382CA98, 37353947505932504, 89791781, 89791785, 4, 640x360 
0x1382CA98, 37353947506413912, 89791827, 89791830, 3, 640x360 
0x1382CA98, 37353947506751416, 89791864, 89791867, 3, 640x360 
0x1382CA98, 37353947507057648, 89791896, 89791898, 2, 640x360 
0x1382CA98, 37353947507387576, 89791936, 89791938, 2, 640x360 
0x1382CA98, 37353947507688984, 89791955, 89791958, 3, 640x360 
0x1382CA98, 37353947508013960, 89791992, 89791995, 3, 640x360 
0x1382CA98, 37353947508336512, 89792024, 89792027, 3, 640x360 
0x1382CA98, 37353947508650576, 89792056, 89792059, 3, 640x360 
0x1382CA98, 37353947508969256, 89792090, 89792097, 7, 640x360 
0x1382CA98, 37353947509289928, 89792126, 89792130, 4, 640x360 
0x1382CA98, 37353947509611080, 89792152, 89792162, 10, 640x360 
0x1382CA98, 37353947509937616, 89792185, 89792189, 4, 640x360 
0x1382CA98, 37353947510409312, 89792230, 89792232, 2, 640x360 
0x1382CA98, 37353947510728928, 89792261, 89792264, 3, 640x360 
0x1382CA98, 37353947511049368, 89792293, 89792296, 3, 640x360 
0x1382CA98, 37353947511375256, 89792334, 89792337, 3, 640x360 
0x1382CA98, 37353947511688952, 89792363, 89792365, 2, 640x360 
0x1382CA98, 37353947512009448, 89792389, 89792391, 2, 640x360 
0x1382CA98, 37353947512332168, 89792425, 89792431, 6, 640x360 
0x1382CA98, 37353947512649920, 89792456, 89792462, 6, 640x360 
0x1382CA98, 37353947512974704, 89792489, 89792492, 3, 640x360 
0x1382CA98, 37353947513292856, 89792521, 89792523, 2, 640x360 
0x1382CA98, 37353947513609736, 89792548, 89792553, 5, 640x360 
0x1382CA98, 37353947513930304, 89792580, 89792583, 3, 640x360 
0x1382CA98, 37353947514251496, 89792617, 89792620, 3, 640x360 
0x1382CA98, 37353947514733360, 89792663, 89792666, 3, 640x360 
0x1382CA98, 37353947515057336, 89792697, 89792700, 3, 640x360 
0x1382CA98, 37353947515378616, 89792730, 89792732, 2, 640x360 
0x1382CA98, 37353947515700008, 89792761, 89792763, 2, 640x360 
0x1382CA98, 37353947516013776, 89792792, 89792794, 2, 640x360 
0x1382CA98, 37353947516334224, 89792826, 89792827, 1, 640x360 
0x1382CA98, 37353947516654488, 89792857, 89792860, 3, 640x360 
0x1382CA98, 37353947516969120, 89792889, 89792892, 3, 640x360 
0x1382CA98, 37353947517290264, 89792923, 89792930, 7, 640x360 
0x1382CA98, 37353947517611384, 89792947, 89792952, 5, 640x360 
0x1382CA98, 37353947517933208, 89792979, 89792982, 3, 640x360 
0x1382CA98, 37353947518253832, 89793018, 89793022, 4, 640x360 
0x1382CA98, 37353947518729152, 89793067, 89793070, 3, 640x360 
0x1382CA98, 37353947519088872, 89793099, 89793105, 6, 640x360 
0x1382CA98, 37353947519368936, 89793143, 89793145, 2, 640x360 
0x1382CA98, 37353947519689952, 89793165, 89793186, 21, 640x360 
0x1382CA98, 37353947520026304, 89793196, 89793200, 4, 640x360 
0x1382CA98, 37353947520351712, 89793225, 89793230, 5, 640x360 
0x1382CA98, 37353947520665960, 89793261, 89793263, 2, 640x360 
0x1382CA98, 37353947520992536, 89793293, 89793295, 2, 640x360 
0x1382CA98, 37353947521296576, 89793331, 89793333, 2, 640x360 
0x1382CA98, 37353947521617968, 89793363, 89793366, 3, 640x360 
0x1382CA98, 37353947521959808, 89793396, 89793401, 5, 640x360 
0x1382CA98, 37353947522267400, 89793418, 89793422, 4, 640x360 
0x1382CA98, 37353947522728512, 89793471, 89793473, 2, 640x360 
0x1382CA98, 37353947523053720, 89793501, 89793504, 3, 640x360 
0x1382CA98, 37353947523372456, 89793532, 89793536, 4, 640x360 
0x1382CA98, 37353947523696928, 89793563, 89793564, 1, 640x360 
0x1382CA98, 37353947524009000, 89793590, 89793595, 5, 640x360 
0x1382CA98, 37353947524332536, 89793629, 89793633, 4, 640x360 
0x1382CA98, 37353947524649424, 89793654, 89793662, 8, 640x360 
0x1382CA98, 37353947524974456, 89793688, 89793691, 3, 640x360 
0x1382CA98, 37353947525309344, 89793726, 89793739, 13, 640x360 
0x1382CA98, 37353947525619464, 89793752, 89793755, 3, 640x360 
0x1382CA98, 37353947525932376, 89793786, 89793788, 2, 640x360 
0x1382CA98, 37353947526254864, 89793816, 89793818, 2, 640x360 
0x1382CA98, 37353947526732936, 89793864, 89793869, 5, 640x360 
0x1382CA98, 37353947527052224, 89793903, 89793906, 3, 640x360 
0x1382CA98, 37353947527387664, 89793935, 89793938, 3, 640x360 
0x1382CA98, 37353947527692920, 89793964, 89793966, 2, 640x360 
0x1382CA98, 37353947528012344, 89793990, 89793992, 2, 640x360 
0x1382CA98, 37353947528332552, 89794023, 89794025, 2, 640x360 
0x1382CA98, 37353947528648672, 89794060, 89794062, 2, 640x360 
0x1382CA98, 37353947528971672, 89794089, 89794101, 12, 640x360 
0x1382CA98, 37353947529310008, 89794139, 89794145, 6, 640x360 
0x1382CA98, 37353947529614320, 89794163, 89794174, 11, 640x360 
0x1382CA98, 37353947529953640, 89794193, 89794199, 6, 640x360 
0x1382CA98, 37353947530269224, 89794221, 89794229, 8, 640x360 
0x1382CA98, 37353947530728792, 89794270, 89794277, 7, 640x360 
0x1382CA98, 37353947531052680, 89794312, 89794325, 13, 640x360 
0x1382CA98, 37353947531387552, 89794364, 89794370, 6, 640x360 
0x1382CA98, 37353947531705000, 89794372, 89794374, 2, 640x360 
0x1382CA98, 37353947532014424, 89794405, 89794413, 8, 640x360 
0x1382CA98, 37353947532342080, 89794438, 89794447, 9, 640x360 
0x1382CA98, 37353947532654704, 89794470, 89794482, 12, 640x360 
0x1382CA98, 37353947532997536, 89794512, 89794526, 14, 640x360 
0x1382CA98, 37353947533297264, 89794527, 89794536, 9, 640x360 
0x1382CA98, 37353947533617904, 89794571, 89794586, 15, 640x360 
0x1382CA98, 37353947533946488, 89794604, 89794613, 9, 640x360 
0x1382CA98, 37353947534263496, 89794632, 89794645, 13, 640x360 
0x1382CA98, 37353947534729008, 89794675, 89794682, 7, 640x360 
0x1382CA98, 37353947535054520, 89794697, 89794705, 8, 640x360 
0x1382CA98, 37353947535373448, 89794735, 89794747, 12, 640x360 
0x1382CA98, 37353947535703304, 89794772, 89794774, 2, 640x360 
0x1382CA98, 37353947536013736, 89794794, 89794797, 3, 640x360 
0x1382CA98, 37353947536381984, 89794838, 89794847, 9, 640x360 
0x1382CA98, 37353947536654776, 89794883, 89794896, 13, 640x360 
0x1382CA98, 37353947537035104, 89794903, 89794915, 12, 640x360 
0x1382CA98, 37353947537327776, 89794940, 89794943, 3, 640x360 
0x1382CA98, 37353947537612552, 89794965, 89794976, 11, 640x360 
0x1382CA98, 37353947537955328, 89794995, 89794998, 3, 640x360 
0x1382CA98, 37353947538265232, 89795026, 89795029, 3, 640x360 
0x1382CA98, 37353947538731024, 89795062, 89795065, 3, 640x360 
0x1382CA98, 37353947539052280, 89795108, 89795109, 1, 640x360 
0x1382CA98, 37353947539368648, 89795141, 89795144, 3, 640x360 
0x1382CA98, 37353947539693536, 89795167, 89795174, 7, 640x360 
0x1382CA98, 37353947540015168, 89795204, 89795208, 4, 640x360 
0x1382CA98, 37353947540332784, 89795235, 89795239, 4, 640x360 
0x1382CA98, 37353947540653528, 89795269, 89795278, 9, 640x360 
0x1382CA98, 37353947540980224, 89795293, 89795297, 4, 640x360 
0x1382CA98, 37353947541298088, 89795326, 89795342, 16, 640x360 
0x1382CA98, 37353947541640864, 89795369, 89795376, 7, 640x360 
0x1382CA98, 37353947541935328, 89795399, 89795411, 12, 640x360 
0x1382CA98, 37353947542315024, 89795437, 89795454, 17, 640x360 
0x1382CA98, 37353947542572640, 89795458, 89795462, 4, 640x360 
0x1382CA98, 37353947543124856, 89795530, 89795533, 3, 640x360 
0x1382CA98, 37353947543691520, 89795564, 89795568, 4, 640x360 
0x1382CA98, 37353947544025280, 89795601, 89795606, 5, 640x360 
0x1382CA98, 37353947544341352, 89795629, 89795632, 3, 640x360 
0x1382CA98, 37353947544681304, 89795671, 89795678, 7, 640x360 
0x1382CA98, 37353947544980440, 89795694, 89795696, 2, 640x360 
0x1382CA98, 37353947545292416, 89795719, 89795732, 13, 640x360 
0x1382CA98, 37353947545617048, 89795758, 89795760, 2, 640x360 
0x1382CA98, 37353947545929256, 89795786, 89795790, 4, 640x360 
0x1382CA98, 37353947546266552, 89795818, 89795822, 4, 640x360 
0x1382CA98, 37353947546585184, 89795859, 89795862, 3, 640x360 
0x1382CA98, 37353947547052152, 89795903, 89795913, 10, 640x360 
0x1382CA98, 37353947547371856, 89795937, 89795941, 4, 640x360 
0x1382CA98, 37353947547697992, 89795973, 89795975, 2, 640x360 
0x1382CA98, 37353947548009064, 89796008, 89796015, 7, 640x360 
0x1382CA98, 37353947548331296, 89796026, 89796030, 4, 640x360 
0x1382CA98, 37353947548654280, 89796059, 89796061, 2, 640x360 
0x1382CA98, 37353947548987264, 89796101, 89796107, 6, 640x360 
0x1382CA98, 37353947549292144, 89796116, 89796119, 3, 640x360 
0x1382CA98, 37353947549609008, 89796158, 89796164, 6, 640x360 
0x1382CA98, 37353947549948064, 89796186, 89796194, 8, 640x360 
0x1382CA98, 37353947550273720, 89796225, 89796236, 11, 640x360 
0x1382CA98, 37353947550571936, 89796256, 89796259, 3, 640x360 
0x1382CA98, 37353947551049256, 89796300, 89796305, 5, 640x360 
0x1382CA98, 37353947551373448, 89796336, 89796343, 7, 640x360 
0x1382CA98, 37353947551692136, 89796367, 89796377, 10, 640x360 
0x1382CA98, 37353947552008496, 89796403, 89796405, 2, 640x360 
0x1382CA98, 37353947552328800, 89796427, 89796429, 2, 640x360 
0x1382CA98, 37353947552652232, 89796458, 89796465, 7, 640x360 
0x1382CA98, 37353947552973864, 89796490, 89796492, 2, 640x360 
0x1382CA98, 37353947553289168, 89796524, 89796526, 2, 640x360 
0x1382CA98, 37353947553614784, 89796557, 89796564, 7, 640x360 
0x1382CA98, 37353947553933416, 89796589, 89796597, 8, 640x360 
0x1382CA98, 37353947554256136, 89796614, 89796619, 5, 640x360 
0x1382CA98, 37353947554570504, 89796647, 89796651, 4, 640x360 
0x1382CA98, 37353947555047600, 89796699, 89796704, 5, 640x360 
0x1382CA98, 37353947555378176, 89796736, 89796739, 3, 640x360 
0x1382CA98, 37353947555693328, 89796758, 89796761, 3, 640x360 
0x1382CA98, 37353947556013168, 89796792, 89796799, 7, 640x360 
0x1382CA98, 37353947556331872, 89796826, 89796828, 2, 640x360 
0x1382CA98, 37353947556657784, 89796858, 89796860, 2, 640x360 
0x1382CA98, 37353947556969736, 89796902, 89796905, 3, 640x360 
0x1382CA98, 37353947557288848, 89796920, 89796926, 6, 640x360 
0x1382CA98, 37353947557609920, 89796946, 89796949, 3, 640x360 
0x1382CA98, 37353947557933384, 89796980, 89796982, 2, 640x360 
0x1382CA98, 37353947558254936, 89797014, 89797018, 4, 640x360 
0x1382CA98, 37353947558573384, 89797048, 89797062, 14, 640x360 
0x1382CA98, 37353947559047392, 89797105, 89797114, 9, 640x360 
0x1382CA98, 37353947559376680, 89797133, 89797137, 4, 640x360 
0x1382CA98, 37353947559687952, 89797162, 89797164, 2, 640x360 
0x1382CA98, 37353947560010104, 89797189, 89797192, 3, 640x360 
0x1382CA98, 37353947560327944, 89797220, 89797223, 3, 640x360 
0x1382CA98, 37353947560652888, 89797264, 89797266, 2, 640x360 
0x1382CA98, 37353947560968672, 89797298, 89797301, 3, 640x360 
0x1382CA98, 37353947561293496, 89797325, 89797328, 3, 640x360 
0x1382CA98, 37353947561608872, 89797352, 89797356, 4, 640x360 
0x1382CA98, 37353947561928864, 89797383, 89797392, 9, 640x360 
0x1382CA98, 37353947562248968, 89797420, 89797425, 5, 640x360 
0x1382CA98, 37353947562575248, 89797454, 89797456, 2, 640x360 
0x1382CA98, 37353947563048928, 89797494, 89797502, 8, 640x360 
0x1382CA98, 37353947563369880, 89797525, 89797535, 10, 640x360 
0x1382CA98, 37353947563692944, 89797560, 89797566, 6, 640x360 
0x1382CA98, 37353947564008864, 89797593, 89797602, 9, 640x360 
0x1382CA98, 37353947564329424, 89797626, 89797628, 2, 640x360 
0x1382CA98, 37353947564664952, 89797659, 89797681, 22, 640x360 
0x1382CA98, 37353947564976688, 89797694, 89797696, 2, 640x360 
0x1382CA98, 37353947565299560, 89797731, 89797735, 4, 640x360 
0x1382CA98, 37353947565613704, 89797749, 89797755, 6, 640x360 
0x1382CA98, 37353947565936792, 89797785, 89797795, 10, 640x360 
0x1382CA98, 37353947566254728, 89797816, 89797828, 12, 640x360 
0x1382CA98, 37353947566568760, 89797853, 89797863, 10, 640x360 
0x1382CA98, 37353947566888352, 89797887, 89797891, 4, 640x360 
0x1382CA98, 37353947567374808, 89797934, 89797937, 3, 640x360 
0x1382CA98, 37353947567690768, 89797957, 89797960, 3, 640x360 
0x1382CA98, 37353947568017472, 89797999, 89798001, 2, 640x360 
0x1382CA98, 37353947568332032, 89798021, 89798029, 8, 640x360 
0x1382CA98, 37353947568650432, 89798058, 89798067, 9, 640x360 
0x1382CA98, 37353947568967824, 89798086, 89798097, 11, 640x360 
0x1382CA98, 37353947569290376, 89798120, 89798129, 9, 640x360 
0x1382CA98, 37353947569608768, 89798153, 89798161, 8, 640x360 
0x1382CA98, 37353947569938688, 89798185, 89798193, 8, 640x360 
0x1382CA98, 37353947570257808, 89798215, 89798219, 4, 640x360 
0x1382CA98, 37353947570568768, 89798252, 89798261, 9, 640x360 
0x1382CA98, 37353947570893056, 89798282, 89798286, 4, 640x360 
0x1382CA98, 37353947571368088, 89798333, 89798337, 4, 640x360 
0x1382CA98, 37353947571691344, 89798361, 89798363, 2, 640x360 
0x1382CA98, 37353947572010280, 89798394, 89798402, 8, 640x360 
0x1382CA98, 37353947572331784, 89798426, 89798428, 2, 640x360 
0x1382CA98, 37353947572649440, 89798469, 89798473, 4, 640x360 
0x1382CA98, 37353947572980248, 89798490, 89798498, 8, 640x360 
0x1382CA98, 37353947573288584, 89798525, 89798534, 9, 640x360 
0x1382CA98, 37353947573616048, 89798558, 89798560, 2, 640x360 
0x1382CA98, 37353947573934264, 89798582, 89798586, 4, 640x360 
0x1382CA98, 37353947574249296, 89798615, 89798619, 4, 640x360 
0x1382CA98, 37353947574576696, 89798646, 89798653, 7, 640x360 
0x1382CA98, 37353947574892344, 89798685, 89798689, 4, 640x360 
0x1382CA98, 37353947575368296, 89798724, 89798739, 15, 640x360 
0x1382CA98, 37353947575690680, 89798764, 89798773, 9, 640x360 
0x1382CA98, 37353947576008024, 89798791, 89798798, 7, 640x360 
0x1382CA98, 37353947576331680, 89798826, 89798833, 7, 640x360 
0x1382CA98, 37353947576648320, 89798859, 89798862, 3, 640x360 
0x1382CA98, 37353947576971600, 89798888, 89798900, 12, 640x360 
0x1382CA98, 37353947577288264, 89798930, 89798933, 3, 640x360 
0x1382CA98, 37353947577622768, 89798950, 89798963, 13, 640x360 
0x1382CA98, 37353947577934480, 89798996, 89798998, 2, 640x360 
0x1382CA98, 37353947578261784, 89799016, 89799030, 14, 640x360 
0x1382CA98, 37353947578569416, 89799063, 89799069, 6, 640x360 
0x1382CA98, 37353947578889904, 89799082, 89799085, 3, 640x360 
0x1382CA98, 37353947579368072, 89799131, 89799135, 4, 640x360 
0x1382CA98, 37353947579692792, 89799166, 89799172, 6, 640x360 
0x1382CA98, 37353947580012464, 89799193, 89799198, 5, 640x360 
0x1382CA98, 37353947580331928, 89799230, 89799232, 2, 640x360 
0x1382CA98, 37353947580653496, 89799259, 89799265, 6, 640x360 
0x1382CA98, 37353947580967680, 89799286, 89799294, 8, 640x360 
0x1382CA98, 37353947581292240, 89799323, 89799331, 8, 640x360 
0x1382CA98, 37353947581611520, 89799355, 89799364, 9, 640x360 
0x1382CA98, 37353947581955112, 89799389, 89799393, 4, 640x360 
0x1382CA98, 37353947582254128, 89799413, 89799415, 2, 640x360 
0x1382CA98, 37353947582567952, 89799447, 89799451, 4, 640x360 
0x1382CA98, 37353947582891696, 89799481, 89799484, 3, 640x360 
0x1382CA98, 37353947583367384, 89799535, 89799544, 9, 640x360 
0x1382CA98, 37353947583687672, 89799569, 89799572, 3, 640x360 
0x1382CA98, 37353947584012376, 89799603, 89799605, 2, 640x360 
0x1382CA98, 37353947584331160, 89799626, 89799628, 2, 640x360 
0x1382CA98, 37353947584660400, 89799671, 89799684, 13, 640x360 
0x1382CA98, 37353947585057968, 89799708, 89799712, 4, 640x360 
0x1382CA98, 37353947585289232, 89799725, 89799728, 3, 640x360 
0x1382CA98, 37353947585615792, 89799762, 89799769, 7, 640x360 
0x1382CA98, 37353947585934392, 89799788, 89799796, 8, 640x360 
0x1382CA98, 37353947586275272, 89799821, 89799828, 7, 640x360 
0x1382CA98, 37353947586617600, 89799871, 89799877, 6, 640x360 
0x1382CA98, 37353947586889120, 89799893, 89799895, 2, 640x360 
0x1382CA98, 37353947587367632, 89799936, 89799946, 10, 640x360 
0x1382CA98, 37353947587701112, 89799975, 89799980, 5, 640x360 
0x1382CA98, 37353947588029912, 89799998, 89800022, 24, 640x360 
0x1382CA98, 37353947588341400, 89800036, 89800062, 26, 640x360 
0x1382CA98, 37353947588667272, 89800081, 89800089, 8, 640x360 
0x1382CA98, 37353947588971384, 89800097, 89800163, 66, 640x360 
0x1382CA98, 37353947589293712, 89800163, 89800181, 18, 640x360 
0x1382CA98, 37353947589964832, 89800224, 89800229, 5, 640x360 
0x1382CA98, 37353947590291528, 89800241, 89800246, 5, 640x360 
0x1382CA98, 37353947590610600, 89800272, 89800280, 8, 640x360 
0x1382CA98, 37353947590894552, 89800310, 89800313, 3, 640x360 
0x1382CA98, 37353947591368168, 89800332, 89800341, 9, 640x360 
0x1382CA98, 37353947591686888, 89800364, 89800378, 14, 640x360 
0x1382CA98, 37353947592020480, 89800408, 89800421, 13, 640x360 
0x1382CA98, 37353947592369640, 89800440, 89800447, 7, 640x360 
0x1382CA98, 37353947592652448, 89800477, 89800481, 4, 640x360 
0x1382CA98, 37353947592970072, 89800501, 89800507, 6, 640x360 
0x1382CA98, 37353947593304512, 89800527, 89800530, 3, 640x360 
0x1382CA98, 37353947593624632, 89800571, 89800574, 3, 640x360 
0x1382CA98, 37353947593957496, 89800595, 89800601, 6, 640x360 
0x1382CA98, 37353947594248720, 89800614, 89800617, 3, 640x360 
0x1382CA98, 37353947594568680, 89800653, 89800657, 4, 640x360 
0x1382CA98, 37353947594891480, 89800679, 89800682, 3, 640x360 
0x1382CA98, 37353947595210000, 89800720, 89800723, 3, 640x360 
0x1382CA98, 37353947595686496, 89800768, 89800772, 4, 640x360 
0x1382CA98, 37353947596011024, 89800795, 89800797, 2, 640x360 
0x1382CA98, 37353947596337088, 89800833, 89800843, 10, 640x360 
0x1382CA98, 37353947596657800, 89800864, 89800866, 2, 640x360 
0x1382CA98, 37353947596975312, 89800904, 89800906, 2, 640x360 
0x1382CA98, 37353947597297800, 89800927, 89800932, 5, 640x360 
0x1382CA98, 37353947597620232, 89800962, 89800964, 2, 640x360 
0x1382CA98, 37353947597954424, 89800997, 89800999, 2, 640x360 
0x1382CA98, 37353947598258208, 89801014, 89801018, 4, 640x360 
0x1382CA98, 37353947598568688, 89801055, 89801058, 3, 640x360 
0x1382CA98, 37353947598891416, 89801090, 89801093, 3, 640x360 
0x1382CA98, 37353947599212232, 89801122, 89801124, 2, 640x360 
0x1382CA98, 37353947599690528, 89801160, 89801162, 2, 640x360 
0x1382CA98, 37353947600012360, 89801191, 89801194, 3, 640x360 
0x1382CA98, 37353947600337328, 89801223, 89801226, 3, 640x360 
0x1382CA98, 37353947600647616, 89801261, 89801268, 7, 640x360 
0x1382CA98, 37353947600967192, 89801285, 89801297, 12, 640x360 
0x1382CA98, 37353947601288352, 89801315, 89801328, 13, 640x360 
0x1382CA98, 37353947601607656, 89801354, 89801361, 7, 640x360 
0x1382CA98, 37353947601939072, 89801380, 89801385, 5, 640x360 
0x1382CA98, 37353947602263448, 89801422, 89801429, 7, 640x360 
0x1382CA98, 37353947602571120, 89801458, 89801460, 2, 640x360 
0x1382CA98, 37353947602886920, 89801485, 89801489, 4, 640x360 
0x1382CA98, 37353947603215816, 89801521, 89801524, 3, 640x360 
0x1382CA98, 37353947603690304, 89801565, 89801568, 3, 640x360 
0x1382CA98, 37353947604006528, 89801588, 89801590, 2, 640x360 
0x1382CA98, 37353947604333088, 89801629, 89801631, 2, 640x360 
0x1382CA98, 37353947604648656, 89801653, 89801656, 3, 640x360 
0x1382CA98, 37353947604969360, 89801687, 89801690, 3, 640x360 
0x1382CA98, 37353947605287648, 89801714, 89801716, 2, 640x360 
0x1382CA98, 37353947605610272, 89801753, 89801755, 2, 640x360 
0x1382CA98, 37353947605934432, 89801783, 89801790, 7, 640x360 
0x1382CA98, 37353947606249480, 89801820, 89801824, 4, 640x360 
0x1382CA98, 37353947606571832, 89801855, 89801857, 2, 640x360 
0x1382CA98, 37353947606890800, 89801893, 89801895, 2, 640x360 
0x1382CA98, 37353947607207736, 89801921, 89801923, 2, 640x360 
0x1382CA98, 37353947607686824, 89801969, 89801972, 3, 640x360 
0x1382CA98, 37353947608011944, 89801991, 89801994, 3, 640x360 
0x1382CA98, 37353947608332264, 89802037, 89802039, 2, 640x360 
0x1382CA98, 37353947608646904, 89802056, 89802058, 2, 640x360 
0x1382CA98, 37353947608968216, 89802092, 89802096, 4, 640x360 
0x1382CA98, 37353947609295904, 89802131, 89802140, 9, 640x360 
0x1382CA98, 37353947609625528, 89802163, 89802165, 2, 640x360 
0x1382CA98, 37353947609932632, 89802186, 89802193, 7, 640x360 
0x1382CA98, 37353947610256952, 89802212, 89802215, 3, 640x360 
0x1382CA98, 37353947610584168, 89802246, 89802250, 4, 640x360 
0x1382CA98, 37353947610886912, 89802291, 89802300, 9, 640x360 
0x1382CA98, 37353947611225584, 89802320, 89802323, 3, 640x360 
0x1382CA98, 37353947611697424, 89802360, 89802362, 2, 640x360 
0x1382CA98, 37353947612008592, 89802392, 89802400, 8, 640x360 
0x1382CA98, 37353947612331288, 89802428, 89802429, 1, 640x360 
0x1382CA98, 37353947612651592, 89802457, 89802465, 8, 640x360 
0x1382CA98, 37353947612967184, 89802492, 89802494, 2, 640x360 
0x1382CA98, 37353947613288208, 89802516, 89802531, 15, 640x360 
0x1382CA98, 37353947613618352, 89802548, 89802552, 4, 640x360 
0x1382CA98, 37353947613931248, 89802579, 89802587, 8, 640x360 
0x1382CA98, 37353947614247200, 89802625, 89802628, 3, 640x360 
0x1382CA98, 37353947614571904, 89802645, 89802647, 2, 640x360 
0x1382CA98, 37353947614887240, 89802679, 89802682, 3, 640x360 
0x1382CA98, 37353947615207344, 89802712, 89802714, 2, 640x360 
0x1382CA98, 37353947615690776, 89802761, 89802763, 2, 640x360 
0x1382CA98, 37353947616010648, 89802790, 89802796, 6, 640x360 
0x1382CA98, 37353947616336512, 89802826, 89802837, 11, 640x360 
0x1382CA98, 37353947616647752, 89802860, 89802862, 2, 640x360 
0x1382CA98, 37353947616968472, 89802894, 89802905, 11, 640x360 
0x1382CA98, 37353947617288104, 89802926, 89802932, 6, 640x360 
0x1382CA98, 37353947617620032, 89802958, 89802960, 2, 640x360 
0x1382CA98, 37353947617933192, 89802986, 89802996, 10, 640x360 
0x1382CA98, 37353947618250544, 89803021, 89803030, 9, 640x360 
0x1382CA98, 37353947618567448, 89803047, 89803052, 5, 640x360 
0x1382CA98, 37353947618891472, 89803080, 89803084, 4, 640x360 
0x1382CA98, 37353947619207768, 89803122, 89803132, 10, 640x360 
0x1382CA98, 37353947619685848, 89803164, 89803166, 2, 640x360 
0x1382CA98, 37353947620006456, 89803191, 89803201, 10, 640x360 
0x1382CA98, 37353947620331336, 89803223, 89803230, 7, 640x360 
0x1382CA98, 37353947620648280, 89803256, 89803258, 2, 640x360 
0x1382CA98, 37353947620973472, 89803282, 89803285, 3, 640x360 
0x1382CA98, 37353947621286504, 89803313, 89803320, 7, 640x360 
0x1382CA98, 37353947621613784, 89803363, 89803365, 2, 640x360 
0x1382CA98, 37353947621932904, 89803382, 89803394, 12, 640x360 
0x1382CA98, 37353947622262584, 89803420, 89803426, 6, 640x360 
0x1382CA98, 37353947622566944, 89803446, 89803452, 6, 640x360 
0x1382CA98, 37353947622890120, 89803480, 89803485, 5, 640x360 
0x1382CA98, 37353947623213048, 89803521, 89803523, 2, 640x360 
0x1382CA98, 37353947623526624, 89803548, 89803552, 4, 640x360 
0x1382CA98, 37353947624009976, 89803595, 89803597, 2, 640x360 
0x1382CA98, 37353947624329728, 89803623, 89803625, 2, 640x360 
0x1382CA98, 37353947624647088, 89803661, 89803666, 5, 640x360 
0x1382CA98, 37353947624968560, 89803690, 89803693, 3, 640x360 
0x1382CA98, 37353947625288096, 89803723, 89803726, 3, 640x360 
0x1382CA98, 37353947625625952, 89803753, 89803762, 9, 640x360 
0x1382CA98, 37353947625950352, 89803786, 89803794, 8, 640x360 
0x1382CA98, 37353947626248816, 89803823, 89803830, 7, 640x360 
0x1382CA98, 37353947626567128, 89803853, 89803863, 10, 640x360 
0x1382CA98, 37353947626890952, 89803881, 89803884, 3, 640x360 
0x1382CA98, 37353947627206808, 89803911, 89803913, 2, 640x360 
0x1382CA98, 37353947627541296, 89803952, 89803959, 7, 640x360 
0x1382CA98, 37353947628005720, 89803999, 89804004, 5, 640x360 
0x1382CA98, 37353947628325760, 89804023, 89804029, 6, 640x360 
0x1382CA98, 37353947628648160, 89804053, 89804055, 2, 640x360 
0x1382CA98, 37353947628966088, 89804085, 89804097, 12, 640x360 
0x1382CA98, 37353947629286560, 89804130, 89804132, 2, 640x360 
0x1382CA98, 37353947629613096, 89804151, 89804158, 7, 640x360 
0x1382CA98, 37353947629933792, 89804190, 89804191, 1, 640x360 
0x1382CA98, 37353947630251064, 89804216, 89804233, 17, 640x360 
0x1382CA98, 37353947630569800, 89804261, 89804263, 2, 640x360 
0x1382CA98, 37353947630890200, 89804287, 89804295, 8, 640x360 
0x1382CA98, 37353947631207056, 89804315, 89804318, 3, 640x360 
0x1382CA98, 37353947631531032, 89804347, 89804351, 4, 640x360 
0x1382CA98, 37353947632006488, 89804402, 89804414, 12, 640x360 
0x1382CA98, 37353947632350160, 89804430, 89804433, 3, 640x360 
0x1382CA98, 37353947632652464, 89804461, 89804464, 3, 640x360 
0x1382CA98, 37353947633009904, 89804496, 89804503, 7, 640x360 
0x1382CA98, 37353947633291536, 89804524, 89804526, 2, 640x360 
0x1382CA98, 37353947633653648, 89804560, 89804562, 2, 640x360 
0x1382CA98, 37353947633927248, 89804583, 89804597, 14, 640x360 
0x1382CA98, 37353947634258344, 89804621, 89804624, 3, 640x360 
0x1382CA98, 37353947634572568, 89804658, 89804660, 2, 640x360 
0x1382CA98, 37353947634886296, 89804686, 89804688, 2, 640x360 
0x1382CA98, 37353947635206240, 89804709, 89804711, 2, 640x360 
0x1382CA98, 37353947635529328, 89804748, 89804761, 13, 640x360 
0x1382CA98, 37353947636005944, 89804804, 89804812, 8, 640x360 
0x1382CA98, 37353947636332328, 89804827, 89804830, 3, 640x360 
0x1382CA98, 37353947636657736, 89804864, 89804866, 2, 640x360 
0x1382CA98, 37353947636975336, 89804903, 89804906, 3, 640x360 
0x1382CA98, 37353947637290784, 89804919, 89804922, 3, 640x360 
0x1382CA98, 37353947637606760, 89804946, 89804949, 3, 640x360 
0x1382CA98, 37353947637930568, 89804979, 89804982, 3, 640x360 
0x1382CA98, 37353947638246968, 89805013, 89805018, 5, 640x360 
0x1382CA98, 37353947638588248, 89805061, 89805062, 1, 640x360 
0x1382CA98, 37353947638886096, 89805077, 89805085, 8, 640x360 
0x1382CA98, 37353947639206080, 89805113, 89805115, 2, 640x360 
0x1382CA98, 37353947639526160, 89805142, 89805147, 5, 640x360 
0x1382CA98, 37353947640006032, 89805184, 89805191, 7, 640x360 
0x1382CA98, 37353947640328912, 89805220, 89805223, 3, 640x360 
0x1382CA98, 37353947640646528, 89805257, 89805260, 3, 640x360 
0x1382CA98, 37353947640968888, 89805290, 89805293, 3, 640x360 
0x1382CA98, 37353947641291376, 89805326, 89805331, 5, 640x360 
0x1382CA98, 37353947641626592, 89805354, 89805358, 4, 640x360 
0x1382CA98, 37353947641926960, 89805382, 89805384, 2, 640x360 
0x1382CA98, 37353947642253720, 89805413, 89805415, 2, 640x360 
0x1382CA98, 37353947642586912, 89805463, 89805474, 11, 640x360 
0x1382CA98, 37353947642886616, 89805478, 89805480, 2, 640x360 
0x1382CA98, 37353947643261696, 89805517, 89805523, 6, 640x360 
0x1382CA98, 37353947643527336, 89805543, 89805547, 4, 640x360 
0x1382CA98, 37353947644005264, 89805589, 89805595, 6, 640x360 
0x1382CA98, 37353947644325992, 89805621, 89805629, 8, 640x360 
0x1382CA98, 37353947644651128, 89805659, 89805669, 10, 640x360 
0x1382CA98, 37353947645019024, 89805692, 89805695, 3, 640x360 
0x1382CA98, 37353947645295408, 89805746, 89805749, 3, 640x360 
0x1382CA98, 37353947645618664, 89805757, 89805763, 6, 640x360 
0x1382CA98, 37353947645956216, 89805795, 89805797, 2, 640x360 
0x1382CA98, 37353947646271488, 89805826, 89805831, 5, 640x360 
0x1382CA98, 37353947646568328, 89805864, 89805876, 12, 640x360 
0x1382CA98, 37353947646893848, 89805891, 89805897, 6, 640x360 
0x1382CA98, 37353947647210848, 89805918, 89805922, 4, 640x360 
0x1382CA98, 37353947647529832, 89805958, 89805961, 3, 640x360 
0x1382CA98, 37353947647856664, 89805985, 89805989, 4, 640x360 
0x1382CA98, 37353947648327736, 89806024, 89806034, 10, 640x360 
0x1382CA98, 37353947648648984, 89806057, 89806061, 4, 640x360 
0x1382CA98, 37353947648968800, 89806091, 89806094, 3, 640x360 
0x1382CA98, 37353947649294464, 89806130, 89806144, 14, 640x360 
0x1382CA98, 37353947649651896, 89806160, 89806163, 3, 640x360 
0x1382CA98, 37353947649928568, 89806193, 89806204, 11, 640x360 
0x1382CA98, 37353947650274560, 89806221, 89806227, 6, 640x360 
0x1382CA98, 37353947650566576, 89806257, 89806267, 10, 640x360 
0x1382CA98, 37353947650889560, 89806292, 89806295, 3, 640x360 
0x1382CA98, 37353947651217720, 89806324, 89806334, 10, 640x360 
0x1382CA98, 37353947651531536, 89806348, 89806356, 8, 640x360 
0x1382CA98, 37353947651854624, 89806386, 89806397, 11, 640x360 
0x1382CA98, 37353947652351536, 89806442, 89806446, 4, 640x360 
0x1382CA98, 37353947652682192, 89806464, 89806468, 4, 640x360 
0x1382CA98, 37353947652973976, 89806494, 89806496, 2, 640x360 
0x1382CA98, 37353947653303752, 89806527, 89806529, 2, 640x360 
0x1382CA98, 37353947653608488, 89806559, 89806567, 8, 640x360 
0x1382CA98, 37353947653929744, 89806595, 89806597, 2, 640x360 
0x1382CA98, 37353947654259416, 89806626, 89806628, 2, 640x360 
0x1382CA98, 37353947654570888, 89806658, 89806661, 3, 640x360 
0x1382CA98, 37353947654886496, 89806690, 89806693, 3, 640x360 
0x1382CA98, 37353947655206560, 89806721, 89806724, 3, 640x360 
0x1382CA98, 37353947655534328, 89806758, 89806761, 3, 640x360 
0x1382CA98, 37353947655846344, 89806778, 89806781, 3, 640x360 
0x1382CA98, 37353947656336616, 89806830, 89806834, 4, 640x360 
0x1382CA98, 37353947656645432, 89806867, 89806873, 6, 640x360 
0x1382CA98, 37353947656966376, 89806889, 89806893, 4, 640x360 
0x1382CA98, 37353947657285640, 89806923, 89806926, 3, 640x360 
0x1382CA98, 37353947657613176, 89806957, 89806960, 3, 640x360 
0x1382CA98, 37353947657933968, 89806991, 89806997, 6, 640x360 
0x1382CA98, 37353947658269136, 89807028, 89807030, 2, 640x360 
0x1382CA98, 37353947658565312, 89807052, 89807062, 10, 640x360 
0x1382CA98, 37353947658891808, 89807092, 89807094, 2, 640x360 
0x1382CA98, 37353947659206320, 89807121, 89807130, 9, 640x360 
0x1382CA98, 37353947659528760, 89807147, 89807149, 2, 640x360 
0x1382CA98, 37353947659849736, 89807180, 89807182, 2, 640x360 
0x1382CA98, 37353947660324888, 89807234, 89807239, 5, 640x360 
0x1382CA98, 37353947660645648, 89807261, 89807263, 2, 640x360 
0x1382CA98, 37353947660970040, 89807289, 89807293, 4, 640x360 
0x1382CA98, 37353947661285904, 89807324, 89807328, 4, 640x360 
0x1382CA98, 37353947661624776, 89807366, 89807372, 6, 640x360 
0x1382CA98, 37353947661931880, 89807386, 89807393, 7, 640x360 
0x1382CA98, 37353947662253272, 89807426, 89807428, 2, 640x360 
0x1382CA98, 37353947662566768, 89807453, 89807469, 16, 640x360 
0x1382CA98, 37353947662903872, 89807505, 89807508, 3, 640x360 
0x1382CA98, 37353947663243824, 89807537, 89807539, 2, 640x360 
0x1382CA98, 37353947663539888, 89807557, 89807559, 2, 640x360 
0x1382CA98, 37353947663855488, 89807581, 89807584, 3, 640x360 
0x1382CA98, 37353947664327368, 89807638, 89807642, 4, 640x360 
0x1382CA98, 37353947664651168, 89807662, 89807664, 2, 640x360 
0x1382CA98, 37353947664966640, 89807700, 89807705, 5, 640x360 
0x1382CA98, 37353947665285864, 89807738, 89807742, 4, 640x360 
0x1382CA98, 37353947665617168, 89807758, 89807764, 6, 640x360 
0x1382CA98, 37353947665954968, 89807788, 89807791, 3, 640x360 
0x1382CA98, 37353947666249312, 89807824, 89807826, 2, 640x360 
0x1382CA98, 37353947666569800, 89807845, 89807848, 3, 640x360 
0x1382CA98, 37353947666885344, 89807885, 89807887, 2, 640x360 
0x1382CA98, 37353947667209128, 89807910, 89807912, 2, 640x360 
0x1382CA98, 37353947667526536, 89807948, 89807954, 6, 640x360 
0x1382CA98, 37353947667850496, 89807985, 89807994, 9, 640x360 
0x1382CA98, 37353947668329368, 89808037, 89808041, 4, 640x360 
0x1382CA98, 37353947668657088, 89808058, 89808061, 3, 640x360 
0x1382CA98, 37353947668966808, 89808085, 89808089, 4, 640x360 
0x1382CA98, 37353947669290632, 89808118, 89808130, 12, 640x360 
0x1382CA98, 37353947669635192, 89808149, 89808153, 4, 640x360 
0x1382CA98, 37353947669941216, 89808180, 89808185, 5, 640x360 
0x1382CA98, 37353947670247296, 89808215, 89808226, 11, 640x360 
0x1382CA98, 37353947670572456, 89808254, 89808262, 8, 640x360 
0x1382CA98, 37353947670884912, 89808287, 89808295, 8, 640x360 
0x1382CA98, 37353947671206688, 89808315, 89808318, 3, 640x360 
0x1382CA98, 37353947671528808, 89808343, 89808345, 2, 640x360 
0x1382CA98, 37353947671849264, 89808383, 89808392, 9, 640x360 
0x1382CA98, 37353947672328872, 89808434, 89808438, 4, 640x360 
0x1382CA98, 37353947672645872, 89808457, 89808459, 2, 640x360 
0x1382CA98, 37353947672965320, 89808501, 89808505, 4, 640x360 
0x1382CA98, 37353947673287560, 89808529, 89808531, 2, 640x360 
0x1382CA98, 37353947673609688, 89808548, 89808554, 6, 640x360 
0x1382CA98, 37353947673933024, 89808588, 89808596, 8, 640x360 
0x1382CA98, 37353947674249048, 89808621, 89808623, 2, 640x360 
0x1382CA98, 37353947674565120, 89808657, 89808660, 3, 640x360 
0x1382CA98, 37353947674889136, 89808684, 89808688, 4, 640x360 
0x1382CA98, 37353947675204848, 89808719, 89808723, 4, 640x360 
0x1382CA98, 37353947675525096, 89808740, 89808747, 7, 640x360 
0x1382CA98, 37353947675845336, 89808777, 89808781, 4, 640x360 
0x1382CA98, 37353947676165368, 89808810, 89808812, 2, 640x360 
0x1382CA98, 37353947676645144, 89808861, 89808867, 6, 640x360 
0x1382CA98, 37353947676969768, 89808890, 89808892, 2, 640x360 
0x1382CA98, 37353947677298720, 89808916, 89808924, 8, 640x360 
0x1382CA98, 37353947677607600, 89808949, 89808962, 13, 640x360 
0x1382CA98, 37353947677934776, 89808998, 89809002, 4, 640x360 
0x1382CA98, 37353947678248032, 89809033, 89809042, 9, 640x360 
0x1382CA98, 37353947678614912, 89809059, 89809062, 3, 640x360 
0x1382CA98, 37353947678885576, 89809081, 89809103, 22, 640x360 
0x1382CA98, 37353947679218432, 89809117, 89809120, 3, 640x360 
0x1382CA98, 37353947679540680, 89809148, 89809152, 4, 640x360 
0x1382CA98, 37353947679852360, 89809180, 89809184, 4, 640x360 
0x1382CA98, 37353947680190528, 89809213, 89809215, 2, 640x360 
0x1382CA98, 37353947680644584, 89809262, 89809271, 9, 640x360 
0x1382CA98, 37353947680980576, 89809292, 89809314, 22, 640x360 
0x1382CA98, 37353947681298664, 89809326, 89809330, 4, 640x360 
0x1382CA98, 37353947681621952, 89809353, 89809364, 11, 640x360 
0x1382CA98, 37353947681949136, 89809394, 89809401, 7, 640x360 
0x1382CA98, 37353947682251376, 89809420, 89809431, 11, 640x360 
0x1382CA98, 37353947682565176, 89809455, 89809458, 3, 640x360 
0x1382CA98, 37353947682902096, 89809481, 89809483, 2, 640x360 
0x1382CA98, 37353947683225120, 89809521, 89809524, 3, 640x360 
0x1382CA98, 37353947683550064, 89809545, 89809547, 2, 640x360 
0x1382CA98, 37353947683853560, 89809585, 89809590, 5, 640x360 
0x1382CA98, 37353947684183688, 89809609, 89809612, 3, 640x360 
0x1382CA98, 37353947684644472, 89809661, 89809663, 2, 640x360 
0x1382CA98, 37353947684964760, 89809687, 89809696, 9, 640x360 
0x1382CA98, 37353947685288528, 89809715, 89809729, 14, 640x360 
0x1382CA98, 37353947685617288, 89809748, 89809755, 7, 640x360 
0x1382CA98, 37353947685929832, 89809779, 89809781, 2, 640x360 
0x1382CA98, 37353947686245648, 89809820, 89809822, 2, 640x360 
0x1382CA98, 37353947686564760, 89809846, 89809848, 2, 640x360 
0x1382CA98, 37353947686884696, 89809884, 89809889, 5, 640x360 
0x1382CA98, 37353947687206048, 89809924, 89809926, 2, 640x360 
0x1382CA98, 37353947687524880, 89809944, 89809951, 7, 640x360 
0x1382CA98, 37353947687846240, 89809990, 89809993, 3, 640x360 
0x1382CA98, 37353947688170048, 89810015, 89810028, 13, 640x360 
0x1382CA98, 37353947688651872, 89810058, 89810061, 3, 640x360 
0x1382CA98, 37353947688973440, 89810103, 89810106, 3, 640x360 
0x1382CA98, 37353947689298112, 89810130, 89810133, 3, 640x360 
0x1382CA98, 37353947689644192, 89810151, 89810161, 10, 640x360 
0x1382CA98, 37353947689936552, 89810179, 89810181, 2, 640x360 
0x1382CA98, 37353947690247480, 89810221, 89810224, 3, 640x360 
0x1382CA98, 37353947690564632, 89810247, 89810258, 11, 640x360 
0x1382CA98, 37353947690888992, 89810285, 89810292, 7, 640x360 
0x1382CA98, 37353947691204904, 89810325, 89810328, 3, 640x360 
0x1382CA98, 37353947691526432, 89810351, 89810355, 4, 640x360 
0x1382CA98, 37353947691844696, 89810373, 89810381, 8, 640x360 
0x1382CA98, 37353947692169208, 89810408, 89810410, 2, 640x360 
0x1382CA98, 37353947692644056, 89810450, 89810454, 4, 640x360 
0x1382CA98, 37353947692967904, 89810487, 89810489, 2, 640x360 
0x1382CA98, 37353947693284800, 89810519, 89810523, 4, 640x360 
0x1382CA98, 37353947693604752, 89810551, 89810558, 7, 640x360 
0x1382CA98, 37353947693925088, 89810585, 89810590, 5, 640x360 
0x1382CA98, 37353947694250048, 89810614, 89810622, 8, 640x360 
0x1382CA98, 37353947694578480, 89810647, 89810656, 9, 640x360 
0x1382CA98, 37353947694888768, 89810690, 89810693, 3, 640x360 
0x1382CA98, 37353947695204560, 89810721, 89810723, 2, 640x360 
0x1382CA98, 37353947695524760, 89810748, 89810755, 7, 640x360 
0x1382CA98, 37353947695848976, 89810774, 89810777, 3, 640x360 
0x1382CA98, 37353947696170520, 89810814, 89810819, 5, 640x360 
0x1382CA98, 37353947696652440, 89810859, 89810866, 7, 640x360 
0x1382CA98, 37353947696974288, 89810888, 89810891, 3, 640x360 
0x1382CA98, 37353947697284976, 89810919, 89810922, 3, 640x360 
0x1382CA98, 37353947697604536, 89810950, 89810960, 10, 640x360 
0x1382CA98, 37353947697930576, 89810981, 89810985, 4, 640x360 
0x1382CA98, 37353947698245080, 89811014, 89811016, 2, 640x360 
0x1382CA98, 37353947698564960, 89811042, 89811044, 2, 640x360 
0x1382CA98, 37353947698888984, 89811088, 89811092, 4, 640x360 
0x1382CA98, 37353947699205080, 89811127, 89811130, 3, 640x360 
0x1382CA98, 37353947699534184, 89811145, 89811147, 2, 640x360 
0x1382CA98, 37353947699845208, 89811174, 89811176, 2, 640x360 
0x1382CA98, 37353947700167816, 89811207, 89811215, 8, 640x360 
0x1382CA98, 37353947700485248, 89811250, 89811256, 6, 640x360 
0x1382CA98, 37353947700964280, 89811283, 89811287, 4, 640x360 
0x1382CA98, 37353947701286072, 89811324, 89811331, 7, 640x360 
0x1382CA98, 37353947701613608, 89811359, 89811365, 6, 640x360 
0x1382CA98, 37353947701943368, 89811391, 89811394, 3, 640x360 
0x1382CA98, 37353947702250056, 89811414, 89811420, 6, 640x360 
0x1382CA98, 37353947702576080, 89811456, 89811459, 3, 640x360 
0x1382CA98, 37353947702884192, 89811481, 89811483, 2, 640x360 
0x1382CA98, 37353947703208608, 89811520, 89811523, 3, 640x360 
0x1382CA98, 37353947703526456, 89811550, 89811555, 5, 640x360 
0x1382CA98, 37353947703844600, 89811582, 89811584, 2, 640x360 
0x1382CA98, 37353947704169192, 89811611, 89811616, 5, 640x360 
0x1382CA98, 37353947704488296, 89811638, 89811643, 5, 640x360 
0x1382CA98, 37353947704964680, 89811698, 89811701, 3, 640x360 
0x1382CA98, 37353947705331616, 89811730, 89811741, 11, 640x360 
0x1382CA98, 37353947705621008, 89811764, 89811766, 2, 640x360 
0x1382CA98, 37353947705952584, 89811798, 89811804, 6, 640x360 
0x1382CA98, 37353947706245272, 89811839, 89811842, 3, 640x360 
0x1382CA98, 37353947706569928, 89811859, 89811869, 10, 640x360 
0x1382CA98, 37353947706891800, 89811895, 89811898, 3, 640x360 
0x1382CA98, 37353947707205280, 89811925, 89811930, 5, 640x360 
0x1382CA98, 37353947707531648, 89811954, 89811963, 9, 640x360 
0x1382CA98, 37353947707859056, 89811990, 89812004, 14, 640x360 
0x1382CA98, 37353947708187008, 89812024, 89812029, 5, 640x360 
0x1382CA98, 37353947708500480, 89812047, 89812053, 6, 640x360 
0x1382CA98, 37353947708963496, 89812088, 89812099, 11, 640x360 
0x1382CA98, 37353947709292888, 89812116, 89812128, 12, 640x360 
0x1382CA98, 37353947709605552, 89812150, 89812163, 13, 640x360 
0x1382CA98, 37353947709929464, 89812184, 89812190, 6, 640x360 
0x1382CA98, 37353947710244400, 89812216, 89812219, 3, 640x360 
0x1382CA98, 37353947710563968, 89812255, 89812259, 4, 640x360 
0x1382CA98, 37353947710883896, 89812288, 89812291, 3, 640x360 
0x1382CA98, 37353947711203920, 89812322, 89812324, 2, 640x360 
0x1382CA98, 37353947711527912, 89812351, 89812356, 5, 640x360 
0x1382CA98, 37353947711844432, 89812387, 89812389, 2, 640x360 
0x1382CA98, 37353947712164712, 89812406, 89812410, 4, 640x360 
0x1382CA98, 37353947712488272, 89812452, 89812455, 3, 640x360 
0x1382CA98, 37353947712963592, 89812487, 89812491, 4, 640x360 
0x1382CA98, 37353947713284064, 89812519, 89812530, 11, 640x360 
0x1382CA98, 37353947713607480, 89812564, 89812566, 2, 640x360 
0x1382CA98, 37353947713940480, 89812589, 89812598, 9, 640x360 
0x1382CA98, 37353947714253352, 89812618, 89812626, 8, 640x360 
0x1382CA98, 37353947714568880, 89812648, 89812653, 5, 640x360 
0x1382CA98, 37353947714889152, 89812682, 89812684, 2, 640x360 
0x1382CA98, 37353947715206056, 89812709, 89812711, 2, 640x360 
0x1382CA98, 37353947715527848, 89812742, 89812745, 3, 640x360 
0x1382CA98, 37353947715843872, 89812778, 89812780, 2, 640x360 
0x1382CA98, 37353947716167256, 89812817, 89812819, 2, 640x360 
0x1382CA98, 37353947716484616, 89812844, 89812846, 2, 640x360 
0x1382CA98, 37353947716968360, 89812888, 89812890, 2, 640x360 
0x1382CA98, 37353947717283952, 89812921, 89812928, 7, 640x360 
0x1382CA98, 37353947717624912, 89812948, 89812951, 3, 640x360 
0x1382CA98, 37353947717938448, 89812990, 89812997, 7, 640x360 
0x1382CA98, 37353947718245320, 89813015, 89813018, 3, 640x360 
0x1382CA98, 37353947718564144, 89813046, 89813049, 3, 640x360 
0x1382CA98, 37353947718884592, 89813081, 89813084, 3, 640x360 
0x1382CA98, 37353947719205024, 89813122, 89813131, 9, 640x360 
0x1382CA98, 37353947719527232, 89813158, 89813165, 7, 640x360 
0x1382CA98, 37353947719860440, 89813191, 89813195, 4, 640x360 
0x1382CA98, 37353947720173176, 89813223, 89813227, 4, 640x360 
0x1382CA98, 37353947720507768, 89813255, 89813263, 8, 640x360 
0x1382CA98, 37353947720964064, 89813298, 89813303, 5, 640x360 
0x1382CA98, 37353947721321320, 89813334, 89813339, 5, 640x360 
0x1382CA98, 37353947721618768, 89813350, 89813363, 13, 640x360 
0x1382CA98, 37353947721930904, 89813386, 89813395, 9, 640x360 
0x1382CA98, 37353947722244296, 89813414, 89813416, 2, 640x360 
0x1382CA98, 37353947722567832, 89813448, 89813451, 3, 640x360 
0x1382CA98, 37353947722883640, 89813481, 89813483, 2, 640x360 
0x1382CA98, 37353947723203680, 89813509, 89813511, 2, 640x360 
0x1382CA98, 37353947723524192, 89813543, 89813549, 6, 640x360 
0x1382CA98, 37353947723869680, 89813579, 89813580, 1, 640x360 
0x1382CA98, 37353947724164688, 89813610, 89813612, 2, 640x360 
0x1382CA98, 37353947724484608, 89813653, 89813656, 3, 640x360 
0x1382CA98, 37353947724974912, 89813697, 89813699, 2, 640x360 
0x1382CA98, 37353947725292392, 89813724, 89813733, 9, 640x360 
0x1382CA98, 37353947725609976, 89813758, 89813768, 10, 640x360 
0x1382CA98, 37353947725925032, 89813785, 89813791, 6, 640x360 
0x1382CA98, 37353947726251104, 89813816, 89813819, 3, 640x360 
0x1382CA98, 37353947726567568, 89813856, 89813863, 7, 640x360 
0x1382CA98, 37353947726883624, 89813880, 89813888, 8, 640x360 
0x1382CA98, 37353947727207840, 89813924, 89813932, 8, 640x360 
0x1382CA98, 37353947727537544, 89813961, 89813965, 4, 640x360 
0x1382CA98, 37353947727875968, 89813983, 89813990, 7, 640x360 
0x1382CA98, 37353947728164472, 89814013, 89814015, 2, 640x360 
0x1382CA98, 37353947728486208, 89814041, 89814049, 8, 640x360 
0x1382CA98, 37353947728804464, 89814083, 89814090, 7, 640x360 
0x1382CA98, 37353947729283264, 89814121, 89814127, 6, 640x360 
0x1382CA98, 37353947729609696, 89814150, 89814159, 9, 640x360 
0x1382CA98, 37353947729929856, 89814182, 89814190, 8, 640x360 
0x1382CA98, 37353947730253872, 89814212, 89814215, 3, 640x360 
0x1382CA98, 37353947730570440, 89814247, 89814251, 4, 640x360 
0x1382CA98, 37353947730887592, 89814289, 89814293, 4, 640x360 
0x1382CA98, 37353947731204968, 89814315, 89814318, 3, 640x360 
0x1382CA98, 37353947731524456, 89814342, 89814348, 6, 640x360 
0x1382CA98, 37353947731844144, 89814374, 89814380, 6, 640x360 
0x1382CA98, 37353947732167424, 89814407, 89814409, 2, 640x360 
0x1382CA98, 37353947732489144, 89814445, 89814452, 7, 640x360 
0x1382CA98, 37353947732805144, 89814477, 89814479, 2, 640x360 
0x1382CA98, 37353947733283696, 89814525, 89814534, 9, 640x360 
0x1382CA98, 37353947733608728, 89814547, 89814550, 3, 640x360 
0x1382CA98, 37353947733930800, 89814599, 89814602, 3, 640x360 
0x1382CA98, 37353947734244224, 89814625, 89814628, 3, 640x360 
0x1382CA98, 37353947734567000, 89814662, 89814664, 2, 640x360 
0x1382CA98, 37353947734887320, 89814687, 89814691, 4, 640x360 
0x1382CA98, 37353947735203688, 89814722, 89814726, 4, 640x360 
0x1382CA98, 37353947735523392, 89814758, 89814761, 3, 640x360 
0x1382CA98, 37353947735844336, 89814779, 89814781, 2, 640x360 
0x1382CA98, 37353947736163488, 89814808, 89814811, 3, 640x360 
0x1382CA98, 37353947736495352, 89814852, 89814858, 6, 640x360 
0x1382CA98, 37353947736842456, 89814877, 89814879, 2, 640x360 
0x1382CA98, 37353947737282960, 89814915, 89814918, 3, 640x360 
0x1382CA98, 37353947737609608, 89814949, 89814960, 11, 640x360 
0x1382CA98, 37353947737929432, 89814981, 89814984, 3, 640x360 
0x1382CA98, 37353947738247896, 89815014, 89815016, 2, 640x360 
0x1382CA98, 37353947738563024, 89815049, 89815055, 6, 640x360 
0x1382CA98, 37353947738889336, 89815077, 89815080, 3, 640x360 
0x1382CA98, 37353947739203824, 89815120, 89815135, 15, 640x360 
0x1382CA98, 37353947739592904, 89815162, 89815182, 20, 640x360 
0x1382CA98, 37353947739851752, 89815228, 89815231, 3, 640x360 
0x1382CA98, 37353947740250344, 89815246, 89815249, 3, 640x360 
0x1382CA98, 37353947740517776, 89815264, 89815278, 14, 640x360 
0x1382CA98, 37353947740821400, 89815285, 89815290, 5, 640x360 
0x1382CA98, 37353947741282736, 89815322, 89815329, 7, 640x360 
0x1382CA98, 37353947741608136, 89815348, 89815352, 4, 640x360 
0x1382CA98, 37353947741931080, 89815385, 89815394, 9, 640x360 
0x1382CA98, 37353947742243192, 89815425, 89815428, 3, 640x360 
0x1382CA98, 37353947742567016, 89815447, 89815450, 3, 640x360 
0x1382CA98, 37353947742905880, 89815481, 89815484, 3, 640x360 
0x1382CA98, 37353947743203944, 89815507, 89815513, 6, 640x360 
0x1382CA98, 37353947743526744, 89815555, 89815558, 3, 640x360 
0x1382CA98, 37353947743854696, 89815579, 89815581, 2, 640x360 
0x1382CA98, 37353947744164160, 89815607, 89815613, 6, 640x360 
0x1382CA98, 37353947744483496, 89815638, 89815642, 4, 640x360 
0x1382CA98, 37353947744807256, 89815667, 89815673, 6, 640x360 
0x1382CA98, 37353947745282688, 89815720, 89815723, 3, 640x360 
0x1382CA98, 37353947745603440, 89815748, 89815751, 3, 640x360 
0x1382CA98, 37353947745924072, 89815780, 89815783, 3, 640x360 
0x1382CA98, 37353947746243472, 89815817, 89815821, 4, 640x360 
0x1382CA98, 37353947746573352, 89815845, 89815848, 3, 640x360 
0x1382CA98, 37353947746889080, 89815877, 89815881, 4, 640x360 
0x1382CA98, 37353947747204032, 89815910, 89815913, 3, 640x360 
0x1382CA98, 37353947747528736, 89815941, 89815943, 2, 640x360 
0x1382CA98, 37353947747851544, 89815977, 89815980, 3, 640x360 
0x1382CA98, 37353947748167232, 89816009, 89816013, 4, 640x360 
0x1382CA98, 37353947748483936, 89816040, 89816043, 3, 640x360 
0x1382CA98, 37353947748804048, 89816074, 89816076, 2, 640x360 
0x1382CA98, 37353947749283528, 89816112, 89816115, 3, 640x360 
0x1382CA98, 37353947749607320, 89816144, 89816146, 2, 640x360 
0x1382CA98, 37353947749923648, 89816180, 89816183, 3, 640x360 
0x1382CA98, 37353947750243576, 89816211, 89816214, 3, 640x360 
0x1382CA98, 37353947750563464, 89816243, 89816245, 2, 640x360 
0x1382CA98, 37353947750883376, 89816274, 89816277, 3, 640x360 
0x1382CA98, 37353947751204032, 89816315, 89816323, 8, 640x360 
0x1382CA98, 37353947751523896, 89816341, 89816347, 6, 640x360 
0x1382CA98, 37353947751844024, 89816375, 89816382, 7, 640x360 
0x1382CA98, 37353947752163520, 89816407, 89816409, 2, 640x360 
0x1382CA98, 37353947752483824, 89816434, 89816437, 3, 640x360 
0x1382CA98, 37353947752807632, 89816470, 89816473, 3, 640x360 
0x1382CA98, 37353947753283664, 89816517, 89816520, 3, 640x360 
0x1382CA98, 37353947753604032, 89816557, 89816559, 2, 640x360 
0x1382CA98, 37353947753929688, 89816594, 89816595, 1, 640x360 
0x1382CA98, 37353947754258040, 89816621, 89816623, 2, 640x360 
0x1382CA98, 37353947754562720, 89816648, 89816656, 8, 640x360 
0x1382CA98, 37353947754890328, 89816686, 89816689, 3, 640x360 
0x1382CA98, 37353947755209152, 89816714, 89816715, 1, 640x360 
0x1382CA98, 37353947755526944, 89816746, 89816752, 6, 640x360 
0x1382CA98, 37353947755843792, 89816783, 89816790, 7, 640x360 
0x1382CA98, 37353947756166600, 89816809, 89816811, 2, 640x360 
0x1382CA98, 37353947756488568, 89816853, 89816862, 9, 640x360 
0x1382CA98, 37353947756803848, 89816874, 89816885, 11, 640x360 
0x1382CA98, 37353947757123392, 89816898, 89816900, 2, 640x360 
0x1382CA98, 37353947757629360, 89816953, 89816960, 7, 640x360 
0x1382CA98, 37353947757936184, 89816988, 89816990, 2, 640x360 
0x1382CA98, 37353947758258616, 89817016, 89817022, 6, 640x360 
0x1382CA98, 37353947758565240, 89817047, 89817061, 14, 640x360 
0x1382CA98, 37353947758882856, 89817093, 89817095, 2, 640x360 
0x1382CA98, 37353947759204152, 89817135, 89817148, 13, 640x360 
0x1382CA98, 37353947759527064, 89817166, 89817171, 5, 640x360 
0x1382CA98, 37353947759851808, 89817183, 89817190, 7, 640x360 
0x1382CA98, 37353947760163960, 89817216, 89817220, 4, 640x360 
0x1382CA98, 37353947760483840, 89817241, 89817244, 3, 640x360 
0x1382CA98, 37353947760805832, 89817279, 89817282, 3, 640x360 
0x1382CA98, 37353947761123232, 89817303, 89817312, 9, 640x360 
0x1382CA98, 37353947761606976, 89817353, 89817355, 2, 640x360 
0x1382CA98, 37353947761931560, 89817380, 89817383, 3, 640x360 
0x1382CA98, 37353947762251120, 89817421, 89817424, 3, 640x360 
0x1382CA98, 37353947762574232, 89817451, 89817462, 11, 640x360 
0x1382CA98, 37353947762888424, 89817482, 89817484, 2, 640x360 
0x1382CA98, 37353947763206360, 89817513, 89817516, 3, 640x360 
0x1382CA98, 37353947763527264, 89817546, 89817548, 2, 640x360 
0x1382CA98, 37353947763848936, 89817574, 89817577, 3, 640x360 
0x1382CA98, 37353947764173256, 89817606, 89817610, 4, 640x360 
0x1382CA98, 37353947764488368, 89817643, 89817645, 2, 640x360 
0x1382CA98, 37353947764803712, 89817675, 89817678, 3, 640x360 
0x1382CA98, 37353947765127448, 89817703, 89817707, 4, 640x360 
0x1382CA98, 37353947765602672, 89817748, 89817753, 5, 640x360 
0x1382CA98, 37353947765922768, 89817783, 89817788, 5, 640x360 
0x1382CA98, 37353947766247600, 89817823, 89817825, 2, 640x360 
0x1382CA98, 37353947766566328, 89817844, 89817846, 2, 640x360 
0x1382CA98, 37353947766886560, 89817882, 89817888, 6, 640x360 
0x1382CA98, 37353947767224528, 89817914, 89817916, 2, 640x360 
0x1382CA98, 37353947767527208, 89817948, 89817951, 3, 640x360 
0x1382CA98, 37353947767843248, 89817971, 89817974, 3, 640x360 
0x1382CA98, 37353947768172432, 89818007, 89818010, 3, 640x360 
0x1382CA98, 37353947768483336, 89818043, 89818045, 2, 640x360 
0x1382CA98, 37353947768803560, 89818077, 89818084, 7, 640x360 
0x1382CA98, 37353947769123512, 89818109, 89818111, 2, 640x360 
0x1382CA98, 37353947769607064, 89818154, 89818156, 2, 640x360 
0x1382CA98, 37353947769922256, 89818183, 89818191, 8, 640x360 
0x1382CA98, 37353947770247528, 89818219, 89818224, 5, 640x360 
0x1382CA98, 37353947770562544, 89818252, 89818255, 3, 640x360 
0x1382CA98, 37353947770883328, 89818281, 89818284, 3, 640x360 
0x1382CA98, 37353947771206648, 89818308, 89818313, 5, 640x360 
0x1382CA98, 37353947771522608, 89818341, 89818347, 6, 640x360 
0x1382CA98, 37353947771842880, 89818374, 89818385, 11, 640x360 
0x1382CA98, 37353947772163448, 89818409, 89818411, 2, 640x360 
0x1382CA98, 37353947772483336, 89818436, 89818441, 5, 640x360 
0x1382CA98, 37353947772806000, 89818468, 89818480, 12, 640x360 
0x1382CA98, 37353947773123368, 89818498, 89818501, 3, 640x360 
0x1382CA98, 37353947773603000, 89818550, 89818554, 4, 640x360 
0x1382CA98, 37353947773926264, 89818583, 89818592, 9, 640x360 
0x1382CA98, 37353947774255144, 89818625, 89818627, 2, 640x360 
0x1382CA98, 37353947774562936, 89818653, 89818655, 2, 640x360 
0x1382CA98, 37353947774882936, 89818678, 89818683, 5, 640x360 
0x1382CA98, 37353947775207000, 89818714, 89818717, 3, 640x360 
0x1382CA98, 37353947775522024, 89818750, 89818752, 2, 640x360 
0x1382CA98, 37353947775845920, 89818777, 89818779, 2, 640x360 
0x1382CA98, 37353947776162976, 89818806, 89818809, 3, 640x360 
0x1382CA98, 37353947776482288, 89818841, 89818843, 2, 640x360 
0x1382CA98, 37353947776803224, 89818867, 89818871, 4, 640x360 
0x1382CA98, 37353947777123048, 89818905, 89818907, 2, 640x360 
0x1382CA98, 37353947777604600, 89818953, 89818955, 2, 640x360 
0x1382CA98, 37353947777922952, 89818979, 89818982, 3, 640x360 
0x1382CA98, 37353947778262576, 89819033, 89819048, 15, 640x360 
0x1382CA98, 37353947778593072, 89819066, 89819070, 4, 640x360 
0x1382CA98, 37353947778885040, 89819105, 89819110, 5, 640x360 
0x1382CA98, 37353947779211808, 89819117, 89819122, 5, 640x360 
0x1382CA98, 37353947779533624, 89819165, 89819169, 4, 640x360 
0x1382CA98, 37353947779857944, 89819213, 89819221, 8, 640x360 
0x1382CA98, 37353947780183384, 89819231, 89819246, 15, 640x360 
0x1382CA98, 37353947780502672, 89819260, 89819262, 2, 640x360 
0x1382CA98, 37353947780820112, 89819282, 89819285, 3, 640x360 
0x1382CA98, 37353947781161720, 89819313, 89819314, 1, 640x360 
0x1382CA98, 37353947781609072, 89819346, 89819351, 5, 640x360 
0x1382CA98, 37353947781936360, 89819380, 89819385, 5, 640x360 
0x1382CA98, 37353947782249560, 89819412, 89819415, 3, 640x360 
0x1382CA98, 37353947782562480, 89819452, 89819455, 3, 640x360 
0x1382CA98, 37353947782883336, 89819478, 89819481, 3, 640x360 
0x1382CA98, 37353947783218536, 89819520, 89819522, 2, 640x360 
0x1382CA98, 37353947783522616, 89819544, 89819554, 10, 640x360 
0x1382CA98, 37353947783847816, 89819583, 89819586, 3, 640x360 
0x1382CA98, 37353947784162144, 89819606, 89819609, 3, 640x360 
0x1382CA98, 37353947784494880, 89819643, 89819646, 3, 640x360 
0x1382CA98, 37353947784808056, 89819671, 89819676, 5, 640x360 
0x1382CA98, 37353947785127360, 89819703, 89819707, 4, 640x360 
0x1382CA98, 37353947785442240, 89819736, 89819740, 4, 640x360 
0x1382CA98, 37353947785927536, 89819791, 89819793, 2, 640x360 
0x1382CA98, 37353947786245280, 89819841, 89819844, 3, 640x360 
0x1382CA98, 37353947786585784, 89819859, 89819862, 3, 640x360 
0x1382CA98, 37353947786882784, 89819904, 89819920, 16, 640x360 
0x1382CA98, 37353947787221280, 89819938, 89819953, 15, 640x360 
0x1382CA98, 37353947787537280, 89819957, 89820015, 58, 640x360 
0x1382CA98, 37353947787886544, 89820015, 89820022, 7, 640x360 
0x1382CA98, 37353947788191512, 89820038, 89820043, 5, 640x360 
0x1382CA98, 37353947788514480, 89820054, 89820060, 6, 640x360 
0x1382CA98, 37353947788827848, 89820081, 89820093, 12, 640x360 
0x1382CA98, 37353947789126728, 89820118, 89820131, 13, 640x360 
0x1382CA98, 37353947789474472, 89820165, 89820178, 13, 640x360 
0x1382CA98, 37353947789969760, 89820199, 89820203, 4, 640x360 
0x1382CA98, 37353947790244168, 89820246, 89820253, 7, 640x360 
0x1382CA98, 37353947790583992, 89820273, 89820295, 22, 640x360 
0x1382CA98, 37353947790913672, 89820310, 89820315, 5, 640x360 
0x1382CA98, 37353947791220920, 89820346, 89820357, 11, 640x360 
0x1382CA98, 37353947791530968, 89820378, 89820390, 12, 640x360 
0x1382CA98, 37353947791850240, 89820404, 89820442, 38, 640x360 
0x1382CA98, 37353947792189560, 89820443, 89820451, 8, 640x360 
0x1382CA98, 37353947792492768, 89820452, 89820497, 45, 640x360 
0x1382CA98, 37353947792820048, 89820506, 89820514, 8, 640x360 
0x1382CA98, 37353947793148088, 89820526, 89820529, 3, 640x360 
0x1382CA98, 37353947793458888, 89820551, 89820561, 10, 640x360 
0x1382CA98, 37353947793939232, 89820586, 89820591, 5, 640x360 
0x1382CA98, 37353947794289864, 89820632, 89820638, 6, 640x360 
0x1382CA98, 37353947794565488, 89820659, 89820661, 2, 640x360 
0x1382CA98, 37353947794882024, 89820684, 89820688, 4, 640x360 
0x1382CA98, 37353947795215248, 89820720, 89820725, 5, 640x360 
0x1382CA98, 37353947795535408, 89820753, 89820761, 8, 640x360 
0x1382CA98, 37353947795851440, 89820798, 89820806, 8, 640x360 
0x1382CA98, 37353947796205528, 89820828, 89820831, 3, 640x360 
0x1382CA98, 37353947796499672, 89820848, 89820854, 6, 640x360 
0x1382CA98, 37353947796823400, 89820881, 89820891, 10, 640x360 
0x1382CA98, 37353947797133664, 89820911, 89820913, 2, 640x360 
0x1382CA98, 37353947797450672, 89820940, 89820948, 8, 640x360 
0x1382CA98, 37353947797930968, 89820984, 89820995, 11, 640x360 
0x1382CA98, 37353947798245072, 89821016, 89821026, 10, 640x360 
0x1382CA98, 37353947798568752, 89821052, 89821062, 10, 640x360 
0x1382CA98, 37353947798897432, 89821091, 89821097, 6, 640x360 
0x1382CA98, 37353947799213744, 89821147, 89821196, 49, 640x360 
0x1382CA98, 37353947799522232, 89821209, 89821215, 6, 640x360 
0x1382CA98, 37353947799872632, 89821230, 89821238, 8, 640x360 
0x1382CA98, 37353947800242896, 89821245, 89821248, 3, 640x360 
0x1382CA98, 37353947800634440, 89821288, 89821292, 4, 640x360 
0x1382CA98, 37353947800890304, 89821306, 89821309, 3, 640x360 
0x1382CA98, 37353947801141856, 89821315, 89821318, 3, 640x360 
0x1382CA98, 37353947801460952, 89821350, 89821355, 5, 640x360 
0x1382CA98, 37353947801925184, 89821383, 89821389, 6, 640x360 
0x1382CA98, 37353947802245064, 89821429, 89821437, 8, 640x360 
0x1382CA98, 37353947802569888, 89821448, 89821468, 20, 640x360 
0x1382CA98, 37353947802882992, 89821482, 89821494, 12, 640x360 
0x1382CA98, 37353947803205560, 89821523, 89821525, 2, 640x360 
0x1382CA98, 37353947803527880, 89821550, 89821554, 4, 640x360 
0x1382CA98, 37353947803847240, 89821583, 89821600, 17, 640x360 
0x1382CA98, 37353947804166472, 89821610, 89821615, 5, 640x360 
0x1382CA98, 37353947804484696, 89821639, 89821643, 4, 640x360 
0x1382CA98, 37353947804806696, 89821669, 89821673, 4, 640x360 
0x1382CA98, 37353947805128776, 89821704, 89821715, 11, 640x360 
0x1382CA98, 37353947805454688, 89821747, 89821751, 4, 640x360 
0x1382CA98, 37353947805952272, 89821796, 89821802, 6, 640x360 
0x1382CA98, 37353947806248552, 89821816, 89821822, 6, 640x360 
0x1382CA98, 37353947806562080, 89821849, 89821855, 6, 640x360 
0x1382CA98, 37353947806881328, 89821888, 89821894, 6, 640x360 
0x1382CA98, 37353947807201328, 89821920, 89821930, 10, 640x360 
0x1382CA98, 37353947807523464, 89821955, 89821970, 15, 640x360 
0x1382CA98, 37353947807850096, 89821982, 89821985, 3, 640x360 
0x1382CA98, 37353947808178136, 89822011, 89822014, 3, 640x360 
0x1382CA98, 37353947808488712, 89822039, 89822047, 8, 640x360 
0x1382CA98, 37353947808808624, 89822078, 89822081, 3, 640x360 
0x1382CA98, 37353947809124096, 89822103, 89822115, 12, 640x360 
0x1382CA98, 37353947809453344, 89822143, 89822145, 2, 640x360 
0x1382CA98, 37353947809769208, 89822163, 89822165, 2, 640x360 
0x1382CA98, 37353947810247872, 89822219, 89822228, 9, 640x360 
0x1382CA98, 37353947810562392, 89822282, 89822298, 16, 640x360 
0x1382CA98, 37353947810888224, 89822298, 89822317, 19, 640x360 
0x1382CA98, 37353947811212928, 89822317, 89822325, 8, 640x360 
0x1382CA98, 37353947811521408, 89822349, 89822352, 3, 640x360 
0x1382CA98, 37353947811853872, 89822381, 89822392, 11, 640x360 
0x1382CA98, 37353947812168432, 89822413, 89822415, 2, 640x360 
0x1382CA98, 37353947812489072, 89822449, 89822455, 6, 640x360 
0x1382CA98, 37353947812807576, 89822478, 89822480, 2, 640x360 
0x1382CA98, 37353947813122832, 89822520, 89822525, 5, 640x360 
0x1382CA98, 37353947813450624, 89822542, 89822551, 9, 640x360 
0x1382CA98, 37353947813790664, 89822570, 89822573, 3, 640x360 
0x1382CA98, 37353947814241456, 89822622, 89822625, 3, 640x360 
0x1382CA98, 37353947814565064, 89822650, 89822661, 11, 640x360 
0x1382CA98, 37353947814884216, 89822682, 89822693, 11, 640x360 
0x1382CA98, 37353947815205216, 89822716, 89822721, 5, 640x360 
0x1382CA98, 37353947815522096, 89822750, 89822757, 7, 640x360 
0x1382CA98, 37353947815884784, 89822793, 89822795, 2, 640x360 
0x1382CA98, 37353947816167392, 89822820, 89822826, 6, 640x360 
0x1382CA98, 37353947816486832, 89822859, 89822864, 5, 640x360 
0x1382CA98, 37353947816802776, 89822890, 89822903, 13, 640x360 
0x1382CA98, 37353947817135688, 89822925, 89822927, 2, 640x360 
0x1382CA98, 37353947817458488, 89822947, 89822953, 6, 640x360 
0x1382CA98, 37353947817789888, 89822977, 89822980, 3, 640x360 
0x1382CA98, 37353947818247280, 89823042, 89823053, 11, 640x360 
0x1382CA98, 37353947818614816, 89823063, 89823078, 15, 640x360 
0x1382CA98, 37353947818881632, 89823091, 89823095, 4, 640x360 
0x1382CA98, 37353947819205128, 89823116, 89823125, 9, 640x360 
0x1382CA98, 37353947819531904, 89823163, 89823165, 2, 640x360 
0x1382CA98, 37353947819859008, 89823186, 89823189, 3, 640x360 
0x1382CA98, 37353947820171208, 89823223, 89823225, 2, 640x360 
0x1382CA98, 37353947820483672, 89823247, 89823253, 6, 640x360 
0x1382CA98, 37353947820807896, 89823290, 89823293, 3, 640x360 
0x1382CA98, 37353947821147928, 89823311, 89823315, 4, 640x360 
0x1382CA98, 37353947821522096, 89823356, 89823363, 7, 640x360 
0x1382CA98, 37353947821789104, 89823374, 89823383, 9, 640x360 
0x1382CA98, 37353947822260624, 89823417, 89823423, 6, 640x360 
0x1382CA98, 37353947822566872, 89823457, 89823461, 4, 640x360 
0x1382CA98, 37353947822936224, 89823504, 89823511, 7, 640x360 
0x1382CA98, 37353947823225408, 89823522, 89823524, 2, 640x360 
0x1382CA98, 37353947823552624, 89823555, 89823563, 8, 640x360 
0x1382CA98, 37353947823872752, 89823580, 89823583, 3, 640x360 
0x1382CA98, 37353947824184920, 89823616, 89823623, 7, 640x360 
0x1382CA98, 37353947824485800, 89823644, 89823646, 2, 640x360 
0x1382CA98, 37353947824806200, 89823684, 89823691, 7, 640x360 
0x1382CA98, 37353947825141072, 89823716, 89823723, 7, 640x360 
0x1382CA98, 37353947825456336, 89823745, 89823747, 2, 640x360 
0x1382CA98, 37353947825801904, 89823780, 89823782, 2, 640x360 
0x1382CA98, 37353947826240584, 89823815, 89823824, 9, 640x360 
0x1382CA98, 37353947826562488, 89823850, 89823872, 22, 640x360 
0x1382CA98, 37353947826882968, 89823882, 89823887, 5, 640x360 
0x1382CA98, 37353947827202456, 89823917, 89823923, 6, 640x360 
0x1382CA98, 37353947827537080, 89823951, 89823961, 10, 640x360 
0x1382CA98, 37353947827844712, 89823988, 89823993, 5, 640x360 
0x1382CA98, 37353947828170496, 89824010, 89824016, 6, 640x360 
0x1382CA98, 37353947828483064, 89824045, 89824047, 2, 640x360 
0x1382CA98, 37353947828807272, 89824088, 89824094, 6, 640x360 
0x1382CA98, 37353947829128232, 89824130, 89824132, 2, 640x360 
0x1382CA98, 37353947829448664, 89824148, 89824156, 8, 640x360 
0x1382CA98, 37353947829766752, 89824171, 89824179, 8, 640x360 
0x1382CA98, 37353947830244208, 89824218, 89824224, 6, 640x360 
0x1382CA98, 37353947830601128, 89824251, 89824256, 5, 640x360 
0x1382CA98, 37353947830894064, 89824289, 89824292, 3, 640x360 
0x1382CA98, 37353947831202888, 89824312, 89824315, 3, 640x360 
0x1382CA98, 37353947831533192, 89824347, 89824353, 6, 640x360 
0x1382CA98, 37353947831852888, 89824387, 89824393, 6, 640x360 
0x1382CA98, 37353947832169504, 89824423, 89824426, 3, 640x360 
0x1382CA98, 37353947832484488, 89824445, 89824447, 2, 640x360 
0x1382CA98, 37353947832813232, 89824478, 89824489, 11, 640x360 
0x1382CA98, 37353947833133432, 89824513, 89824523, 10, 640x360 
0x1382CA98, 37353947833451536, 89824562, 89824571, 9, 640x360 
0x1382CA98, 37353947833784928, 89824578, 89824581, 3, 640x360 
0x1382CA98, 37353947834250024, 89824620, 89824628, 8, 640x360 
0x1382CA98, 37353947834579704, 89824672, 89824676, 4, 640x360 
0x1382CA98, 37353947834884960, 89824693, 89824697, 4, 640x360 
0x1382CA98, 37353947835207712, 89824717, 89824725, 8, 640x360 
0x1382CA98, 37353947835525824, 89824749, 89824758, 9, 640x360 
0x1382CA98, 37353947835844664, 89824786, 89824799, 13, 640x360 
0x1382CA98, 37353947836188648, 89824821, 89824828, 7, 640x360 
0x1382CA98, 37353947836487016, 89824847, 89824849, 2, 640x360 
0x1382CA98, 37353947836846200, 89824892, 89824898, 6, 640x360 
0x1382CA98, 37353947837133472, 89824921, 89824931, 10, 640x360 
0x1382CA98, 37353947837474232, 89824951, 89824958, 7, 640x360 
0x1382CA98, 37353947837799544, 89824974, 89824984, 10, 640x360 
0x1382CA98, 37353947838084296, 89825006, 89825008, 2, 640x360 
0x1382CA98, 37353947838565656, 89825060, 89825065, 5, 640x360 
0x1382CA98, 37353947838892424, 89825094, 89825104, 10, 640x360 
0x1382CA98, 37353947839201528, 89825114, 89825122, 8, 640x360 
0x1382CA98, 37353947839531512, 89825158, 89825161, 3, 640x360 
0x1382CA98, 37353947839846472, 89825176, 89825179, 3, 640x360 
0x1382CA98, 37353947840165128, 89825209, 89825216, 7, 640x360 
0x1382CA98, 37353947840481376, 89825246, 89825249, 3, 640x360 
0x1382CA98, 37353947840809520, 89825275, 89825282, 7, 640x360 
0x1382CA98, 37353947841125496, 89825305, 89825308, 3, 640x360 
0x1382CA98, 37353947841461968, 89825333, 89825340, 7, 640x360 
0x1382CA98, 37353947841765520, 89825364, 89825367, 3, 640x360 
0x1382CA98, 37353947842082088, 89825398, 89825401, 3, 640x360 
0x1382CA98, 37353947842560624, 89825447, 89825450, 3, 640x360 
0x1382CA98, 37353947842881080, 89825480, 89825483, 3, 640x360 
0x1382CA98, 37353947843201616, 89825518, 89825527, 9, 640x360 
0x1382CA98, 37353947843524816, 89825542, 89825545, 3, 640x360 
0x1382CA98, 37353947843840792, 89825575, 89825578, 3, 640x360 
0x1382CA98, 37353947844160976, 89825606, 89825612, 6, 640x360 
0x1382CA98, 37353947844492568, 89825640, 89825648, 8, 640x360 
0x1382CA98, 37353947844805976, 89825676, 89825678, 2, 640x360 
0x1382CA98, 37353947845123528, 89825717, 89825724, 7, 640x360 
0x1382CA98, 37353947845447776, 89825743, 89825745, 2, 640x360 
0x1382CA98, 37353947845761880, 89825763, 89825765, 2, 640x360 
0x1382CA98, 37353947846087440, 89825796, 89825799, 3, 640x360 
0x1382CA98, 37353947846562000, 89825850, 89825857, 7, 640x360 
0x1382CA98, 37353947846884792, 89825893, 89825896, 3, 640x360 
0x1382CA98, 37353947847200816, 89825919, 89825922, 3, 640x360 
0x1382CA98, 37353947847520576, 89825940, 89825948, 8, 640x360 
0x1382CA98, 37353947847841160, 89825986, 89825989, 3, 640x360 
0x1382CA98, 37353947848163960, 89826012, 89826015, 3, 640x360 
0x1382CA98, 37353947848485816, 89826052, 89826063, 11, 640x360 
0x1382CA98, 37353947848801704, 89826083, 89826090, 7, 640x360 
0x1382CA98, 37353947849124840, 89826113, 89826115, 2, 640x360 
0x1382CA98, 37353947849448504, 89826144, 89826149, 5, 640x360 
0x1382CA98, 37353947849780032, 89826194, 89826198, 4, 640x360 
0x1382CA98, 37353947850179232, 89826227, 89826230, 3, 640x360 
0x1382CA98, 37353947850562472, 89826257, 89826261, 4, 640x360 
0x1382CA98, 37353947850887728, 89826306, 89826310, 4, 640x360 
0x1382CA98, 37353947851207808, 89826338, 89826342, 4, 640x360 
0x1382CA98, 37353947851542576, 89826361, 89826363, 2, 640x360 
0x1382CA98, 37353947851841256, 89826388, 89826391, 3, 640x360 
0x1382CA98, 37353947852169280, 89826413, 89826426, 13, 640x360 
0x1382CA98, 37353947852482224, 89826455, 89826461, 6, 640x360 
0x1382CA98, 37353947852806992, 89826507, 89826511, 4, 640x360 
0x1382CA98, 37353947853455560, 89826542, 89826545, 3, 640x360 
0x1382CA98, 37353947853764888, 89826567, 89826579, 12, 640x360 
0x1382CA98, 37353947854084016, 89826597, 89826600, 3, 640x360 
0x1382CA98, 37353947854561480, 89826649, 89826654, 5, 640x360 
0x1382CA98, 37353947854880360, 89826675, 89826681, 6, 640x360 
0x1382CA98, 37353947855213208, 89826710, 89826718, 8, 640x360 
0x1382CA98, 37353947855519952, 89826741, 89826748, 7, 640x360 
0x1382CA98, 37353947855840072, 89826779, 89826780, 1, 640x360 
0x1382CA98, 37353947856163560, 89826805, 89826808, 3, 640x360 
0x1382CA98, 37353947856484776, 89826842, 89826848, 6, 640x360 
0x1382CA98, 37353947856802776, 89826873, 89826875, 2, 640x360 
0x1382CA98, 37353947857120784, 89826907, 89826909, 2, 640x360 
0x1382CA98, 37353947857443760, 89826941, 89826942, 1, 640x360 
0x1382CA98, 37353947857770088, 89826966, 89826978, 12, 640x360 
0x1382CA98, 37353947858090416, 89827005, 89827007, 2, 640x360 
0x1382CA98, 37353947858565440, 89827050, 89827056, 6, 640x360 
0x1382CA98, 37353947858879928, 89827078, 89827081, 3, 640x360 
0x1382CA98, 37353947859199744, 89827122, 89827130, 8, 640x360 
0x1382CA98, 37353947859537616, 89827142, 89827145, 3, 640x360 
0x1382CA98, 37353947859843984, 89827180, 89827182, 2, 640x360 
0x1382CA98, 37353947860164472, 89827207, 89827210, 3, 640x360 
0x1382CA98, 37353947860483720, 89827247, 89827252, 5, 640x360 
0x1382CA98, 37353947860800712, 89827275, 89827280, 5, 640x360 
0x1382CA98, 37353947861124720, 89827314, 89827320, 6, 640x360 
0x1382CA98, 37353947861444560, 89827343, 89827351, 8, 640x360 
0x1382CA98, 37353947861767792, 89827365, 89827369, 4, 640x360 
0x1382CA98, 37353947862080984, 89827402, 89827406, 4, 640x360 
0x1382CA98, 37353947862559648, 89827449, 89827454, 5, 640x360 
0x1382CA98, 37353947862886584, 89827481, 89827484, 3, 640x360 
0x1382CA98, 37353947863213296, 89827513, 89827515, 2, 640x360 
0x1382CA98, 37353947863520112, 89827541, 89827544, 3, 640x360 
0x1382CA98, 37353947863840720, 89827573, 89827580, 7, 640x360 
0x1382CA98, 37353947864160528, 89827612, 89827614, 2, 640x360 
0x1382CA98, 37353947864485048, 89827653, 89827656, 3, 640x360 
0x1382CA98, 37353947864802384, 89827677, 89827679, 2, 640x360 
0x1382CA98, 37353947865123872, 89827714, 89827717, 3, 640x360 
0x1382CA98, 37353947865449024, 89827742, 89827744, 2, 640x360 
0x1382CA98, 37353947865761264, 89827762, 89827764, 2, 640x360 
0x1382CA98, 37353947866080944, 89827796, 89827799, 3, 640x360 
0x1382CA98, 37353947866408472, 89827832, 89827837, 5, 640x360 
0x1382CA98, 37353947866880104, 89827895, 89827897, 2, 640x360 
0x1382CA98, 37353947867203960, 89827921, 89827923, 2, 640x360 
0x1382CA98, 37353947867520088, 89827941, 89827946, 5, 640x360 
0x1382CA98, 37353947867839816, 89827976, 89827981, 5, 640x360 
0x1382CA98, 37353947868159968, 89828007, 89828010, 3, 640x360 
0x1382CA98, 37353947868490256, 89828043, 89828050, 7, 640x360 
0x1382CA98, 37353947868801760, 89828075, 89828084, 9, 640x360 
0x1382CA98, 37353947869120416, 89828107, 89828110, 3, 640x360 
0x1382CA98, 37353947869444464, 89828133, 89828144, 11, 640x360 
0x1382CA98, 37353947869766784, 89828164, 89828167, 3, 640x360 
0x1382CA98, 37353947870081704, 89828195, 89828198, 3, 640x360 
0x1382CA98, 37353947870410560, 89828240, 89828243, 3, 640x360 
0x1382CA98, 37353947870880720, 89828279, 89828285, 6, 640x360 
0x1382CA98, 37353947871205296, 89828322, 89828324, 2, 640x360 
0x1382CA98, 37353947871519784, 89828347, 89828349, 2, 640x360 
0x1382CA98, 37353947871839896, 89828388, 89828397, 9, 640x360 
0x1382CA98, 37353947872164496, 89828423, 89828433, 10, 640x360 
0x1382CA98, 37353947872490800, 89828449, 89828455, 6, 640x360 
0x1382CA98, 37353947872800088, 89828491, 89828501, 10, 640x360 
0x1382CA98, 37353947873139696, 89828515, 89828517, 2, 640x360 
0x1382CA98, 37353947873444240, 89828543, 89828545, 2, 640x360 
0x1382CA98, 37353947873761328, 89828577, 89828584, 7, 640x360 
0x1382CA98, 37353947874081728, 89828603, 89828606, 3, 640x360 
0x1382CA98, 37353947874417592, 89828637, 89828639, 2, 640x360 
0x1382CA98, 37353947874884808, 89828679, 89828682, 3, 640x360 
0x1382CA98, 37353947875215432, 89828712, 89828714, 2, 640x360 
0x1382CA98, 37353947875520272, 89828748, 89828750, 2, 640x360 
0x1382CA98, 37353947875839872, 89828777, 89828779, 2, 640x360 
0x1382CA98, 37353947876176760, 89828821, 89828823, 2, 640x360 
0x1382CA98, 37353947876479592, 89828840, 89828847, 7, 640x360 
0x1382CA98, 37353947876805560, 89828868, 89828871, 3, 640x360 
0x1382CA98, 37353947877120952, 89828901, 89828904, 3, 640x360 
0x1382CA98, 37353947877443720, 89828932, 89828934, 2, 640x360 
0x1382CA98, 37353947877773488, 89828966, 89828973, 7, 640x360 
0x1382CA98, 37353947878080352, 89829002, 89829006, 4, 640x360 
0x1382CA98, 37353947878400848, 89829040, 89829043, 3, 640x360 
0x1382CA98, 37353947878879640, 89829089, 89829105, 16, 640x360 
0x1382CA98, 37353947879200344, 89829124, 89829134, 10, 640x360 
0x1382CA98, 37353947879524080, 89829162, 89829164, 2, 640x360 
0x1382CA98, 37353947879847136, 89829212, 89829220, 8, 640x360 
0x1382CA98, 37353947880481088, 89829250, 89829253, 3, 640x360 
0x1382CA98, 37353947880804136, 89829277, 89829280, 3, 640x360 
0x1382CA98, 37353947881120600, 89829305, 89829316, 11, 640x360 
0x1382CA98, 37353947881450320, 89829340, 89829346, 6, 640x360 
0x1382CA98, 37353947881781544, 89829384, 89829390, 6, 640x360 
0x1382CA98, 37353947882081856, 89829407, 89829412, 5, 640x360 
0x1382CA98, 37353947882399936, 89829433, 89829438, 5, 640x360 
0x1382CA98, 37353947882883272, 89829489, 89829491, 2, 640x360 
0x1382CA98, 37353947883205872, 89829522, 89829525, 3, 640x360 
0x1382CA98, 37353947883519896, 89829541, 89829548, 7, 640x360 
0x1382CA98, 37353947883839024, 89829573, 89829576, 3, 640x360 
0x1382CA98, 37353947884159224, 89829605, 89829608, 3, 640x360 
0x1382CA98, 37353947884479344, 89829636, 89829639, 3, 640x360 
0x1382CA98, 37353947884803680, 89829671, 89829673, 2, 640x360 
0x1382CA98, 37353947885119880, 89829704, 89829707, 3, 640x360 
0x1382CA98, 37353947885445928, 89829739, 89829743, 4, 640x360 
0x1382CA98, 37353947885796096, 89829773, 89829782, 9, 640x360 
0x1382CA98, 37353947886096120, 89829799, 89829804, 5, 640x360 
0x1382CA98, 37353947886400016, 89829831, 89829835, 4, 640x360 
0x1382CA98, 37353947886885840, 89829888, 89829894, 6, 640x360 
0x1382CA98, 37353947887203664, 89829911, 89829916, 5, 640x360 
0x1382CA98, 37353947887519464, 89829944, 89829946, 2, 640x360 
0x1382CA98, 37353947887842472, 89829976, 89829978, 2, 640x360 
0x1382CA98, 37353947888159816, 89830014, 89830016, 2, 640x360 
0x1382CA98, 37353947888491976, 89830045, 89830047, 2, 640x360 
0x1382CA98, 37353947888800032, 89830077, 89830085, 8, 640x360 
0x1382CA98, 37353947889120008, 89830110, 89830112, 2, 640x360 
0x1382CA98, 37353947889446000, 89830148, 89830151, 3, 640x360 
0x1382CA98, 37353947889769616, 89830183, 89830187, 4, 640x360 
0x1382CA98, 37353947890094072, 89830201, 89830210, 9, 640x360 
0x1382CA98, 37353947890406792, 89830239, 89830242, 3, 640x360 
0x1382CA98, 37353947890878896, 89830284, 89830288, 4, 640x360 
0x1382CA98, 37353947891200600, 89830310, 89830314, 4, 640x360 
0x1382CA98, 37353947891522776, 89830353, 89830358, 5, 640x360 
0x1382CA98, 37353947891847256, 89830377, 89830386, 9, 640x360 
0x1382CA98, 37353947892159416, 89830408, 89830414, 6, 640x360 
0x1382CA98, 37353947892482912, 89830450, 89830456, 6, 640x360 
0x1382CA98, 37353947892800136, 89830488, 89830492, 4, 640x360 
0x1382CA98, 37353947893126264, 89830523, 89830525, 2, 640x360 
0x1382CA98, 37353947893445632, 89830545, 89830548, 3, 640x360 
0x1382CA98, 37353947893774664, 89830567, 89830573, 6, 640x360 
0x1382CA98, 37353947894086728, 89830599, 89830605, 6, 640x360 
0x1382CA98, 37353947894405960, 89830644, 89830646, 2, 640x360 
0x1382CA98, 37353947895210616, 89830722, 89830725, 3, 640x360 
0x1382CA98, 37353947895519584, 89830759, 89830762, 3, 640x360 
0x1382CA98, 37353947895841272, 89830787, 89830791, 4, 640x360 
0x1382CA98, 37353947896159296, 89830826, 89830833, 7, 640x360 
0x1382CA98, 37353947896482120, 89830856, 89830861, 5, 640x360 
0x1382CA98, 37353947896816448, 89830892, 89830896, 4, 640x360 
0x1382CA98, 37353947897144384, 89830916, 89830919, 3, 640x360 
0x1382CA98, 37353947897448736, 89830944, 89830947, 3, 640x360 
0x1382CA98, 37353947897775656, 89830978, 89830980, 2, 640x360 
0x1382CA98, 37353947898089280, 89831011, 89831014, 3, 640x360 
0x1382CA98, 37353947898406592, 89831041, 89831044, 3, 640x360 
0x1382CA98, 37353947898720288, 89831064, 89831068, 4, 640x360 
0x1382CA98, 37353947899199096, 89831115, 89831117, 2, 640x360 
0x1382CA98, 37353947899523080, 89831146, 89831149, 3, 640x360 
0x1382CA98, 37353947899844136, 89831176, 89831179, 3, 640x360 
0x1382CA98, 37353947900162880, 89831209, 89831212, 3, 640x360 
0x1382CA98, 37353947900478816, 89831245, 89831247, 2, 640x360 
0x1382CA98, 37353947900799960, 89831277, 89831280, 3, 640x360 
0x1382CA98, 37353947901119808, 89831309, 89831311, 2, 640x360 
0x1382CA98, 37353947901439448, 89831344, 89831346, 2, 640x360 
0x1382CA98, 37353947901760168, 89831379, 89831381, 2, 640x360 
0x1382CA98, 37353947902081232, 89831407, 89831409, 2, 640x360 
0x1382CA98, 37353947902399240, 89831436, 89831441, 5, 640x360 
0x1382CA98, 37353947902719760, 89831468, 89831480, 12, 640x360 
0x1382CA98, 37353947903199312, 89831511, 89831516, 5, 640x360 
0x1382CA98, 37353947903523368, 89831555, 89831558, 3, 640x360 
0x1382CA98, 37353947903843288, 89831583, 89831586, 3, 640x360 
0x1382CA98, 37353947904167224, 89831615, 89831617, 2, 640x360 
0x1382CA98, 37353947904481608, 89831660, 89831665, 5, 640x360 
0x1382CA98, 37353947904805200, 89831685, 89831694, 9, 640x360 
0x1382CA98, 37353947905134680, 89831708, 89831715, 7, 640x360 
0x1382CA98, 37353947905445448, 89831744, 89831747, 3, 640x360 
0x1382CA98, 37353947905772176, 89831783, 89831785, 2, 640x360 
0x1382CA98, 37353947906088912, 89831811, 89831820, 9, 640x360 
0x1382CA98, 37353947906401352, 89831842, 89831845, 3, 640x360 
0x1382CA98, 37353947906725800, 89831877, 89831883, 6, 640x360 
0x1382CA98, 37353947907209408, 89831928, 89831944, 16, 640x360 
0x1382CA98, 37353947907556928, 89831957, 89831976, 19, 640x360 
0x1382CA98, 37353947907848400, 89831992, 89831996, 4, 640x360 
0x1382CA98, 37353947908168296, 89832028, 89832033, 5, 640x360 
0x1382CA98, 37353947908487712, 89832048, 89832053, 5, 640x360 
0x1382CA98, 37353947908825120, 89832082, 89832094, 12, 640x360 
0x1382CA98, 37353947909122896, 89832122, 89832133, 11, 640x360 
0x1382CA98, 37353947909467688, 89832157, 89832165, 8, 640x360 
0x1382CA98, 37353947909764616, 89832176, 89832178, 2, 640x360 
0x1382CA98, 37353947910099664, 89832220, 89832223, 3, 640x360 
0x1382CA98, 37353947910402632, 89832242, 89832244, 2, 640x360 
0x1382CA98, 37353947910722128, 89832274, 89832279, 5, 640x360 
0x1382CA98, 37353947911198144, 89832325, 89832326, 1, 640x360 
0x1382CA98, 37353947911519296, 89832352, 89832363, 11, 640x360 
0x1382CA98, 37353947911853400, 89832383, 89832390, 7, 640x360 
0x1382CA98, 37353947912162368, 89832420, 89832423, 3, 640x360 
0x1382CA98, 37353947912478432, 89832455, 89832459, 4, 640x360 
0x1382CA98, 37353947912801512, 89832488, 89832491, 3, 640x360 
0x1382CA98, 37353947913125408, 89832517, 89832530, 13, 640x360 
0x1382CA98, 37353947913460328, 89832543, 89832546, 3, 640x360 
0x1382CA98, 37353947913771192, 89832577, 89832589, 12, 640x360 
0x1382CA98, 37353947914092464, 89832608, 89832610, 2, 640x360 
0x1382CA98, 37353947914398640, 89832632, 89832636, 4, 640x360 
0x1382CA98, 37353947914718808, 89832664, 89832666, 2, 640x360 
0x1382CA98, 37353947915202552, 89832714, 89832718, 4, 640x360 
0x1382CA98, 37353947915535800, 89832753, 89832762, 9, 640x360 
0x1382CA98, 37353947915841480, 89832786, 89832796, 10, 640x360 
0x1382CA98, 37353947916166448, 89832819, 89832829, 10, 640x360 
0x1382CA98, 37353947916486224, 89832848, 89832850, 2, 640x360 
0x1382CA98, 37353947916807424, 89832874, 89832881, 7, 640x360 
0x1382CA98, 37353947917123672, 89832916, 89832918, 2, 640x360 
0x1382CA98, 37353947917443440, 89832940, 89832947, 7, 640x360 
0x1382CA98, 37353947917769552, 89832975, 89832976, 1, 640x360 
0x1382CA98, 37353947918084656, 89833012, 89833020, 8, 640x360 
0x1382CA98, 37353947918409792, 89833036, 89833042, 6, 640x360 
0x1382CA98, 37353947918718568, 89833068, 89833073, 5, 640x360 
0x1382CA98, 37353947919041280, 89833103, 89833106, 3, 640x360 
0x1382CA98, 37353947919529968, 89833154, 89833157, 3, 640x360 
0x1382CA98, 37353947919838200, 89833173, 89833182, 9, 640x360 
0x1382CA98, 37353947920166936, 89833208, 89833211, 3, 640x360 
0x1382CA98, 37353947920482088, 89833242, 89833244, 2, 640x360 
0x1382CA98, 37353947920798392, 89833277, 89833284, 7, 640x360 
0x1382CA98, 37353947921119416, 89833309, 89833311, 2, 640x360 
0x1382CA98, 37353947921453464, 89833337, 89833348, 11, 640x360 
0x1382CA98, 37353947921769112, 89833373, 89833380, 7, 640x360 
0x1382CA98, 37353947922083048, 89833397, 89833399, 2, 640x360 
0x1382CA98, 37353947922398416, 89833435, 89833439, 4, 640x360 
0x1382CA98, 37353947922732440, 89833463, 89833465, 2, 640x360 
0x1382CA98, 37353947923038904, 89833497, 89833499, 2, 640x360 
0x1382CA98, 37353947923518392, 89833547, 89833549, 2, 640x360 
0x1382CA98, 37353947923838080, 89833574, 89833578, 4, 640x360 
0x1382CA98, 37353947924168912, 89833615, 89833618, 3, 640x360 
0x1382CA98, 37353947924479424, 89833646, 89833649, 3, 640x360 
0x1382CA98, 37353947924800288, 89833678, 89833681, 3, 640x360 
0x1382CA98, 37353947925120568, 89833711, 89833713, 2, 640x360 
0x1382CA98, 37353947925441480, 89833753, 89833756, 3, 640x360 
0x1382CA98, 37353947925761576, 89833785, 89833787, 2, 640x360 
0x1382CA98, 37353947926081880, 89833803, 89833813, 10, 640x360 
0x1382CA98, 37353947926398888, 89833836, 89833844, 8, 640x360 
0x1382CA98, 37353947926721656, 89833875, 89833877, 2, 640x360 
0x1382CA98, 37353947927042328, 89833900, 89833906, 6, 640x360 
0x1382CA98, 37353947927522968, 89833953, 89833958, 5, 640x360 
0x1382CA98, 37353947927848824, 89833986, 89833994, 8, 640x360 
0x1382CA98, 37353947928160272, 89834016, 89834018, 2, 640x360 
0x1382CA98, 37353947928479032, 89834045, 89834056, 11, 640x360 
0x1382CA98, 37353947928799968, 89834094, 89834097, 3, 640x360 
0x1382CA98, 37353947929121976, 89834121, 89834131, 10, 640x360 
0x1382CA98, 37353947929451968, 89834159, 89834163, 4, 640x360 
0x1382CA98, 37353947929769152, 89834174, 89834182, 8, 640x360 
0x1382CA98, 37353947930097664, 89834212, 89834218, 6, 640x360 
0x1382CA98, 37353947930404440, 89834232, 89834238, 6, 640x360 
0x1382CA98, 37353947930729160, 89834267, 89834274, 7, 640x360 
0x1382CA98, 37353947931046984, 89834298, 89834301, 3, 640x360 
0x1382CA98, 37353947931517784, 89834354, 89834357, 3, 640x360 
0x1382CA98, 37353947931840704, 89834380, 89834382, 2, 640x360 
0x1382CA98, 37353947932163584, 89834409, 89834412, 3, 640x360 
0x1382CA98, 37353947932486112, 89834446, 89834448, 2, 640x360 
0x1382CA98, 37353947932803960, 89834478, 89834481, 3, 640x360 
0x1382CA98, 37353947933118632, 89834510, 89834512, 2, 640x360 
0x1382CA98, 37353947933442808, 89834541, 89834547, 6, 640x360 
0x1382CA98, 37353947933765472, 89834577, 89834579, 2, 640x360 
0x1382CA98, 37353947934081880, 89834623, 89834631, 8, 640x360 
0x1382CA98, 37353947934400768, 89834642, 89834644, 2, 640x360 
0x1382CA98, 37353947934723576, 89834664, 89834667, 3, 640x360 
0x1382CA98, 37353947935043240, 89834698, 89834700, 2, 640x360 
0x1382CA98, 37353947935520464, 89834741, 89834748, 7, 640x360 
0x1382CA98, 37353947935841704, 89834783, 89834788, 5, 640x360 
0x1382CA98, 37353947936158208, 89834818, 89834823, 5, 640x360 
0x1382CA98, 37353947936478560, 89834844, 89834850, 6, 640x360 
0x1382CA98, 37353947936798800, 89834875, 89834877, 2, 640x360 
0x1382CA98, 37353947937118832, 89834897, 89834900, 3, 640x360 
0x1382CA98, 37353947937446432, 89834938, 89834941, 3, 640x360 
0x1382CA98, 37353947937770968, 89834967, 89834974, 7, 640x360 
0x1382CA98, 37353947938081184, 89835007, 89835010, 3, 640x360 
0x1382CA98, 37353947938399000, 89835034, 89835039, 5, 640x360 
0x1382CA98, 37353947938721872, 89835064, 89835066, 2, 640x360 
0x1382CA98, 37353947939044600, 89835106, 89835111, 5, 640x360 
0x1382CA98, 37353947939521640, 89835148, 89835151, 3, 640x360 
0x1382CA98, 37353947939840952, 89835176, 89835185, 9, 640x360 
0x1382CA98, 37353947940158104, 89835210, 89835211, 1, 640x360 
0x1382CA98, 37353947940482224, 89835244, 89835256, 12, 640x360 
0x1382CA98, 37353947940797744, 89835270, 89835292, 22, 640x360 
0x1382CA98, 37353947941118192, 89835312, 89835324, 12, 640x360 
0x1382CA98, 37353947941468576, 89835363, 89835395, 32, 640x360 
0x1382CA98, 37353947941835520, 89835396, 89835412, 16, 640x360 
0x1382CA98, 37353947942100328, 89835423, 89835438, 15, 640x360 
0x1382CA98, 37353947942434936, 89835455, 89835458, 3, 640x360 
0x1382CA98, 37353947942728648, 89835474, 89835477, 3, 640x360 
0x1382CA98, 37353947943037936, 89835502, 89835505, 3, 640x360 
0x1382CA98, 37353947943517504, 89835540, 89835542, 2, 640x360 
0x1382CA98, 37353947943841712, 89835588, 89835591, 3, 640x360 
0x1382CA98, 37353947944159264, 89835609, 89835612, 3, 640x360 
0x1382CA98, 37353947944481448, 89835643, 89835645, 2, 640x360 
0x1382CA98, 37353947944801648, 89835670, 89835678, 8, 640x360 
0x1382CA98, 37353947945135760, 89835700, 89835714, 14, 640x360 
0x1382CA98, 37353947945445888, 89835733, 89835744, 11, 640x360 
0x1382CA98, 37353947945770976, 89835764, 89835767, 3, 640x360 
0x1382CA98, 37353947946082160, 89835797, 89835803, 6, 640x360 
0x1382CA98, 37353947946410904, 89835829, 89835832, 3, 640x360 
0x1382CA98, 37353947946718824, 89835863, 89835865, 2, 640x360 
0x1382CA98, 37353947947042128, 89835900, 89835904, 4, 640x360 
0x1382CA98, 37353947947358808, 89835928, 89835930, 2, 640x360 
0x1382CA98, 37353947947840680, 89835976, 89835978, 2, 640x360 
0x1382CA98, 37353947948158176, 89836012, 89836014, 2, 640x360 
0x1382CA98, 37353947948478688, 89836051, 89836054, 3, 640x360 
0x1382CA98, 37353947948798120, 89836074, 89836086, 12, 640x360 
0x1382CA98, 37353947949119464, 89836121, 89836125, 4, 640x360 
0x1382CA98, 37353947949460992, 89836155, 89836158, 3, 640x360 
0x1382CA98, 37353947949767960, 89836174, 89836179, 5, 640x360 
0x1382CA98, 37353947950139376, 89836221, 89836229, 8, 640x360 
0x1382CA98, 37353947950398776, 89836248, 89836250, 2, 640x360 
0x1382CA98, 37353947950718936, 89836261, 89836263, 2, 640x360 
0x1382CA98, 37353947951041568, 89836298, 89836300, 2, 640x360 
0x1382CA98, 37353947951368584, 89836329, 89836331, 2, 640x360 
0x1382CA98, 37353947951842200, 89836377, 89836380, 3, 640x360 
0x1382CA98, 37353947952166616, 89836417, 89836422, 5, 640x360 
0x1382CA98, 37353947952478064, 89836439, 89836441, 2, 640x360 
0x1382CA98, 37353947952805104, 89836475, 89836477, 2, 640x360 
0x1382CA98, 37353947953174088, 89836509, 89836517, 8, 640x360 
0x1382CA98, 37353947953455480, 89836542, 89836552, 10, 640x360 
0x1382CA98, 37353947953758256, 89836567, 89836580, 13, 640x360 
0x1382CA98, 37353947954081032, 89836609, 89836611, 2, 640x360 
0x1382CA98, 37353947954402600, 89836633, 89836635, 2, 640x360 
0x1382CA98, 37353947954717848, 89836664, 89836666, 2, 640x360 
0x1382CA98, 37353947955038352, 89836697, 89836699, 2, 640x360 
0x1382CA98, 37353947955362488, 89836733, 89836739, 6, 640x360 
0x1382CA98, 37353947955837456, 89836781, 89836782, 1, 640x360 
0x1382CA98, 37353947956162160, 89836810, 89836812, 2, 640x360 
0x1382CA98, 37353947956480072, 89836844, 89836846, 2, 640x360 
0x1382CA98, 37353947956803048, 89836868, 89836879, 11, 640x360 
0x1382CA98, 37353947957117696, 89836916, 89836919, 3, 640x360 
0x1382CA98, 37353947957442680, 89836933, 89836938, 5, 640x360 
0x1382CA98, 37353947957765128, 89836975, 89836981, 6, 640x360 
0x1382CA98, 37353947958099008, 89837015, 89837020, 5, 640x360 
0x1382CA98, 37353947958402360, 89837038, 89837042, 4, 640x360 
0x1382CA98, 37353947958718392, 89837064, 89837066, 2, 640x360 
0x1382CA98, 37353947959043184, 89837105, 89837107, 2, 640x360 
0x1382CA98, 37353947959367480, 89837134, 89837138, 4, 640x360 
0x1382CA98, 37353947959837944, 89837176, 89837179, 3, 640x360 
0x1382CA98, 37353947960156992, 89837210, 89837212, 2, 640x360 
0x1382CA98, 37353947960483520, 89837249, 89837251, 2, 640x360 
0x1382CA98, 37353947960801864, 89837274, 89837281, 7, 640x360 
0x1382CA98, 37353947961120872, 89837311, 89837317, 6, 640x360 
0x1382CA98, 37353947961441720, 89837339, 89837341, 2, 640x360 
0x1382CA98, 37353947961766328, 89837370, 89837380, 10, 640x360 
0x1382CA98, 37353947962082352, 89837403, 89837412, 9, 640x360 
0x1382CA98, 37353947962407832, 89837440, 89837449, 9, 640x360 
0x1382CA98, 37353947962720080, 89837476, 89837479, 3, 640x360 
0x1382CA98, 37353947963057888, 89837505, 89837508, 3, 640x360 
0x1382CA98, 37353947963358592, 89837535, 89837545, 10, 640x360 
0x1382CA98, 37353947963841440, 89837578, 89837582, 4, 640x360 
0x1382CA98, 37353947964162344, 89837612, 89837614, 2, 640x360 
0x1382CA98, 37353947964479096, 89837642, 89837647, 5, 640x360 
0x1382CA98, 37353947964796904, 89837670, 89837678, 8, 640x360 
0x1382CA98, 37353947965117384, 89837699, 89837704, 5, 640x360 
0x1382CA98, 37353947965450640, 89837740, 89837746, 6, 640x360 
0x1382CA98, 37353947965765368, 89837768, 89837780, 12, 640x360 
0x1382CA98, 37353947966081472, 89837806, 89837810, 4, 640x360 
0x1382CA98, 37353947966443072, 89837839, 89837842, 3, 640x360 
0x1382CA98, 37353947966725176, 89837862, 89837865, 3, 640x360 
0x1382CA98, 37353947967043040, 89837906, 89837910, 4, 640x360 
0x1382CA98, 37353947967357440, 89837926, 89837932, 6, 640x360 
0x1382CA98, 37353947967836640, 89837973, 89837981, 8, 640x360 
0x1382CA98, 37353947968183464, 89838021, 89838038, 17, 640x360 
0x1382CA98, 37353947968482896, 89838048, 89838057, 9, 640x360 
0x1382CA98, 37353947968807672, 89838072, 89838086, 14, 640x360 
0x1382CA98, 37353947969121856, 89838100, 89838104, 4, 640x360 
0x1382CA98, 37353947969443080, 89838145, 89838149, 4, 640x360 
0x1382CA98, 37353947969759504, 89838174, 89838176, 2, 640x360 
0x1382CA98, 37353947970081104, 89838198, 89838202, 4, 640x360 
0x1382CA98, 37353947970422592, 89838230, 89838233, 3, 640x360 
0x1382CA98, 37353947970717056, 89838271, 89838274, 3, 640x360 
0x1382CA98, 37353947971038560, 89838294, 89838297, 3, 640x360 
0x1382CA98, 37353947971363720, 89838344, 89838354, 10, 640x360 
0x1382CA98, 37353947971841200, 89838377, 89838386, 9, 640x360 
0x1382CA98, 37353947972157608, 89838410, 89838412, 2, 640x360 
0x1382CA98, 37353947972479464, 89838441, 89838444, 3, 640x360 
0x1382CA98, 37353947972802424, 89838478, 89838481, 3, 640x360 
0x1382CA98, 37353947973122952, 89838510, 89838514, 4, 640x360 
0x1382CA98, 37353947973441584, 89838542, 89838545, 3, 640x360 
0x1382CA98, 37353947973767040, 89838570, 89838583, 13, 640x360 
0x1382CA98, 37353947974105376, 89838610, 89838613, 3, 640x360 
0x1382CA98, 37353947974403192, 89838639, 89838651, 12, 640x360 
0x1382CA98, 37353947974760656, 89838677, 89838680, 3, 640x360 
0x1382CA98, 37353947975038096, 89838721, 89838724, 3, 640x360 
0x1382CA98, 37353947975362696, 89838741, 89838751, 10, 640x360 
0x1382CA98, 37353947975677120, 89838761, 89838764, 3, 640x360 
0x1382CA98, 37353947976166712, 89838815, 89838817, 2, 640x360 
0x1382CA98, 37353947976488120, 89838849, 89838851, 2, 640x360 
0x1382CA98, 37353947976798680, 89838872, 89838876, 4, 640x360 
0x1382CA98, 37353947977116824, 89838907, 89838910, 3, 640x360 
0x1382CA98, 37353947977436984, 89838937, 89838940, 3, 640x360 
0x1382CA98, 37353947977757608, 89838966, 89838970, 4, 640x360 
0x1382CA98, 37353947978081352, 89839009, 89839015, 6, 640x360 
0x1382CA98, 37353947978402632, 89839033, 89839037, 4, 640x360 
0x1382CA98, 37353947978721200, 89839065, 89839079, 14, 640x360 
0x1382CA98, 37353947979041960, 89839110, 89839113, 3, 640x360 
0x1382CA98, 37353947979363736, 89839130, 89839138, 8, 640x360 
0x1382CA98, 37353947979682552, 89839172, 89839181, 9, 640x360 
0x1382CA98, 37353947980161336, 89839210, 89839213, 3, 640x360 
0x1382CA98, 37353947980479736, 89839260, 89839265, 5, 640x360 
0x1382CA98, 37353947980807368, 89839281, 89839292, 11, 640x360 
0x1382CA98, 37353947981153816, 89839312, 89839314, 2, 640x360 
0x1382CA98, 37353947981451344, 89839344, 89839346, 2, 640x360 
0x1382CA98, 37353947981771176, 89839369, 89839372, 3, 640x360 
0x1382CA98, 37353947982081888, 89839406, 89839408, 2, 640x360 
0x1382CA98, 37353947982397912, 89839428, 89839430, 2, 640x360 
0x1382CA98, 37353947982717904, 89839476, 89839479, 3, 640x360 
0x1382CA98, 37353947983040568, 89839503, 89839507, 4, 640x360 
0x1382CA98, 37353947983357176, 89839528, 89839533, 5, 640x360 
0x1382CA98, 37353947983676976, 89839560, 89839566, 6, 640x360 
0x1382CA98, 37353947984156992, 89839616, 89839619, 3, 640x360 
0x1382CA98, 37353947984476336, 89839646, 89839648, 2, 640x360 
0x1382CA98, 37353947984797616, 89839673, 89839679, 6, 640x360 
0x1382CA98, 37353947985117304, 89839697, 89839700, 3, 640x360 
0x1382CA98, 37353947985440032, 89839734, 89839742, 8, 640x360 
0x1382CA98, 37353947985762808, 89839772, 89839774, 2, 640x360 
0x1382CA98, 37353947986082672, 89839797, 89839799, 2, 640x360 
0x1382CA98, 37353947986402272, 89839828, 89839830, 2, 640x360 
0x1382CA98, 37353947986725256, 89839872, 89839879, 7, 640x360 
0x1382CA98, 37353947987038248, 89839903, 89839907, 4, 640x360 
0x1382CA98, 37353947987357360, 89839929, 89839931, 2, 640x360 
0x1382CA98, 37353947987677552, 89839957, 89839965, 8, 640x360 
0x1382CA98, 37353947988166136, 89840009, 89840012, 3, 640x360 
0x1382CA98, 37353947988480640, 89840040, 89840047, 7, 640x360 
0x1382CA98, 37353947988810040, 89840074, 89840077, 3, 640x360 
0x1382CA98, 37353947989117376, 89840107, 89840110, 3, 640x360 
0x1382CA98, 37353947989444408, 89840158, 89840160, 2, 640x360 
0x1382CA98, 37353947989782432, 89840180, 89840182, 2, 640x360 
0x1382CA98, 37353947990081120, 89840206, 89840210, 4, 640x360 
0x1382CA98, 37353947990402784, 89840243, 89840258, 15, 640x360 
0x1382CA98, 37353947990812296, 89840290, 89840299, 9, 640x360 
0x1382CA98, 37353947991044256, 89840307, 89840312, 5, 640x360 
0x1382CA98, 37353947991358040, 89840339, 89840342, 3, 640x360 
0x1382CA98, 37353947991689168, 89840379, 89840382, 3, 640x360 
0x1382CA98, 37353947992182056, 89840435, 89840455, 20, 640x360 
0x1382CA98, 37353947992523960, 89840493, 89840519, 26, 640x360 
0x1382CA98, 37353947993149272, 89840542, 89840558, 16, 640x360 
0x1382CA98, 37353947993469248, 89840559, 89840581, 22, 640x360 
0x1382CA98, 37353947993814560, 89840624, 89840632, 8, 640x360 
0x1382CA98, 37353947994141752, 89840643, 89840673, 30, 640x360 
0x1382CA98, 37353947994422272, 89840673, 89840680, 7, 640x360 
0x1382CA98, 37353947994751920, 89840682, 89840690, 8, 640x360 
0x1382CA98, 37353947995045152, 89840726, 89840738, 12, 640x360 
0x1382CA98, 37353947995387352, 89840746, 89840752, 6, 640x360 
0x1382CA98, 37353947995682376, 89840780, 89840783, 3, 640x360 
0x1382CA98, 37353947996159688, 89840820, 89840823, 3, 640x360 
0x1382CA98, 37353947996501912, 89840862, 89840868, 6, 640x360 
0x1382CA98, 37353947996811600, 89840880, 89840882, 2, 640x360 
0x1382CA98, 37353947997143192, 89840901, 89840907, 6, 640x360 
0x1382CA98, 37353947997442488, 89840941, 89840947, 6, 640x360 
0x1382CA98, 37353947997759712, 89840965, 89840969, 4, 640x360 
0x1382CA98, 37353947998077808, 89841004, 89841012, 8, 640x360 
0x1382CA98, 37353947998413912, 89841031, 89841033, 2, 640x360 
0x1382CA98, 37353947998716640, 89841064, 89841066, 2, 640x360 
0x1382CA98, 37353947999036744, 89841092, 89841094, 2, 640x360 
0x1382CA98, 37353947999356344, 89841145, 89841153, 8, 640x360 
0x1382CA98, 37353947999699448, 89841166, 89841168, 2, 640x360 
0x1382CA98, 37353948000010072, 89841198, 89841200, 2, 640x360 
0x1382CA98, 37353948000480216, 89841236, 89841245, 9, 640x360 
0x1382CA98, 37353948000826736, 89841282, 89841284, 2, 640x360 
0x1382CA98, 37353948001120088, 89841318, 89841330, 12, 640x360 
0x1382CA98, 37353948001449840, 89841351, 89841357, 6, 640x360 
0x1382CA98, 37353948001775088, 89841377, 89841379, 2, 640x360 
0x1382CA98, 37353948002079312, 89841398, 89841402, 4, 640x360 
0x1382CA98, 37353948002396760, 89841438, 89841441, 3, 640x360 
0x1382CA98, 37353948002721232, 89841470, 89841473, 3, 640x360 
0x1382CA98, 37353948003040128, 89841498, 89841500, 2, 640x360 
0x1382CA98, 37353948003366880, 89841525, 89841529, 4, 640x360 
0x1382CA98, 37353948003677200, 89841559, 89841566, 7, 640x360 
0x1382CA98, 37353948004002760, 89841593, 89841603, 10, 640x360 
0x1382CA98, 37353948004481792, 89841643, 89841646, 3, 640x360 
0x1382CA98, 37353948004801688, 89841668, 89841674, 6, 640x360 
0x1382CA98, 37353948005124008, 89841714, 89841717, 3, 640x360 
0x1382CA98, 37353948005442416, 89841743, 89841745, 2, 640x360 
0x1382CA98, 37353948005760936, 89841766, 89841769, 3, 640x360 
0x1382CA98, 37353948006079984, 89841806, 89841808, 2, 640x360 
0x1382CA98, 37353948006401200, 89841830, 89841833, 3, 640x360 
0x1382CA98, 37353948006720864, 89841872, 89841880, 8, 640x360 
0x1382CA98, 37353948007037488, 89841905, 89841908, 3, 640x360 
0x1382CA98, 37353948007357208, 89841927, 89841930, 3, 640x360 
0x1382CA98, 37353948007676480, 89841970, 89841974, 4, 640x360 
0x1382CA98, 37353948007996672, 89841992, 89841994, 2, 640x360 
0x1382CA98, 37353948008477736, 89842042, 89842044, 2, 640x360 
0x1382CA98, 37353948008796296, 89842067, 89842074, 7, 640x360 
0x1382CA98, 37353948009121720, 89842099, 89842103, 4, 640x360 
0x1382CA98, 37353948009442152, 89842135, 89842143, 8, 640x360 
0x1382CA98, 37353948009763704, 89842165, 89842169, 4, 640x360 
0x1382CA98, 37353948010076840, 89842203, 89842206, 3, 640x360 
0x1382CA98, 37353948010396560, 89842234, 89842238, 4, 640x360 
0x1382CA98, 37353948010716936, 89842258, 89842261, 3, 640x360 
0x1382CA98, 37353948011039272, 89842295, 89842297, 2, 640x360 
0x1382CA98, 37353948011358800, 89842333, 89842338, 5, 640x360 
0x1382CA98, 37353948011677192, 89842358, 89842364, 6, 640x360 
0x1382CA98, 37353948012002488, 89842392, 89842398, 6, 640x360 
0x1382CA98, 37353948012482248, 89842453, 89842462, 9, 640x360 
0x1382CA98, 37353948012796592, 89842488, 89842492, 4, 640x360 
0x1382CA98, 37353948013140488, 89842508, 89842512, 4, 640x360 
0x1382CA98, 37353948013453216, 89842542, 89842548, 6, 640x360 
0x1382CA98, 37353948013760216, 89842565, 89842568, 3, 640x360 
0x1382CA98, 37353948014077040, 89842606, 89842616, 10, 640x360 
0x1382CA98, 37353948014398744, 89842632, 89842634, 2, 640x360 
0x1382CA98, 37353948014716056, 89842665, 89842668, 3, 640x360 
0x1382CA98, 37353948015037800, 89842705, 89842707, 2, 640x360 
0x1382CA98, 37353948015357032, 89842725, 89842732, 7, 640x360 
0x1382CA98, 37353948015682312, 89842761, 89842763, 2, 640x360 
0x1382CA98, 37353948016000376, 89842793, 89842796, 3, 640x360 
0x1382CA98, 37353948016478912, 89842843, 89842846, 3, 640x360 
0x1382CA98, 37353948016797256, 89842871, 89842877, 6, 640x360 
0x1382CA98, 37353948017123216, 89842912, 89842914, 2, 640x360 
0x1382CA98, 37353948017438904, 89842943, 89842945, 2, 640x360 
0x1382CA98, 37353948017755664, 89842972, 89842974, 2, 640x360 
0x1382CA98, 37353948018083976, 89843006, 89843008, 2, 640x360 
0x1382CA98, 37353948018399520, 89843028, 89843031, 3, 640x360 
0x1382CA98, 37353948018720072, 89843064, 89843066, 2, 640x360 
0x1382CA98, 37353948019036416, 89843101, 89843105, 4, 640x360 
0x1382CA98, 37353948019384352, 89843140, 89843142, 2, 640x360 
0x1382CA98, 37353948019676136, 89843164, 89843166, 2, 640x360 
0x1382CA98, 37353948020000608, 89843187, 89843190, 3, 640x360 
0x1382CA98, 37353948020475608, 89843235, 89843240, 5, 640x360 
0x1382CA98, 37353948020796072, 89843267, 89843275, 8, 640x360 
0x1382CA98, 37353948021137536, 89843321, 89843323, 2, 640x360 
0x1382CA98, 37353948021453984, 89843345, 89843352, 7, 640x360 
0x1382CA98, 37353948021763136, 89843366, 89843374, 8, 640x360 
0x1382CA98, 37353948022083392, 89843397, 89843403, 6, 640x360 
0x1382CA98, 37353948022396096, 89843430, 89843433, 3, 640x360 
0x1382CA98, 37353948022720208, 89843471, 89843480, 9, 640x360 
0x1382CA98, 37353948023037600, 89843505, 89843508, 3, 640x360 
0x1382CA98, 37353948023366032, 89843541, 89843543, 2, 640x360 
0x1382CA98, 37353948023679632, 89843563, 89843565, 2, 640x360 
0x1382CA98, 37353948024008920, 89843600, 89843613, 13, 640x360 
0x1382CA98, 37353948024475336, 89843654, 89843659, 5, 640x360 
0x1382CA98, 37353948024809784, 89843682, 89843686, 4, 640x360 
0x1382CA98, 37353948025122504, 89843721, 89843730, 9, 640x360 
0x1382CA98, 37353948025453976, 89843758, 89843761, 3, 640x360 
0x1382CA98, 37353948025788136, 89843780, 89843782, 2, 640x360 
0x1382CA98, 37353948026086072, 89843823, 89843832, 9, 640x360 
0x1382CA98, 37353948026401784, 89843844, 89843846, 2, 640x360 
0x1382CA98, 37353948026719472, 89843867, 89843879, 12, 640x360 
0x1382CA98, 37353948027042728, 89843911, 89843915, 4, 640x360 
0x1382CA98, 37353948027359816, 89843929, 89843932, 3, 640x360 
0x1382CA98, 37353948027681416, 89843966, 89843969, 3, 640x360 
0x1382CA98, 37353948027996400, 89843994, 89843996, 2, 640x360 
0x1382CA98, 37353948028328440, 89844025, 89844032, 7, 640x360 
0x1382CA98, 37353948028799640, 89844066, 89844074, 8, 640x360 
0x1382CA98, 37353948029120424, 89844106, 89844113, 7, 640x360 
0x1382CA98, 37353948029448952, 89844138, 89844144, 6, 640x360 
0x1382CA98, 37353948029771752, 89844169, 89844176, 7, 640x360 
0x1382CA98, 37353948030081960, 89844195, 89844197, 2, 640x360 
0x1382CA98, 37353948030396424, 89844232, 89844234, 2, 640x360 
0x1382CA98, 37353948030721672, 89844264, 89844268, 4, 640x360 
0x1382CA98, 37353948031041968, 89844294, 89844297, 3, 640x360 
0x1382CA98, 37353948031361280, 89844327, 89844330, 3, 640x360 
0x1382CA98, 37353948031680496, 89844358, 89844361, 3, 640x360 
0x1382CA98, 37353948031996872, 89844386, 89844389, 3, 640x360 
0x1382CA98, 37353948032320472, 89844420, 89844430, 10, 640x360 
0x1382CA98, 37353948032811832, 89844475, 89844480, 5, 640x360 
0x1382CA98, 37353948033133016, 89844502, 89844510, 8, 640x360 
0x1382CA98, 37353948033453992, 89844540, 89844542, 2, 640x360 
0x1382CA98, 37353948033764048, 89844566, 89844568, 2, 640x360 
0x1382CA98, 37353948034082736, 89844600, 89844606, 6, 640x360 
0x1382CA98, 37353948034404312, 89844633, 89844635, 2, 640x360 
0x1382CA98, 37353948034718048, 89844665, 89844683, 18, 640x360 
0x1382CA98, 37353948035045112, 89844699, 89844706, 7, 640x360 
0x1382CA98, 37353948035358912, 89844727, 89844730, 3, 640x360 
0x1382CA98, 37353948035678024, 89844762, 89844766, 4, 640x360 
0x1382CA98, 37353948036003792, 89844796, 89844799, 3, 640x360 
0x1382CA98, 37353948036317624, 89844833, 89844838, 5, 640x360 
0x1382CA98, 37353948036800112, 89844866, 89844873, 7, 640x360 
0x1382CA98, 37353948037131440, 89844931, 89844934, 3, 640x360 
0x1382CA98, 37353948037450496, 89844945, 89844948, 3, 640x360 
0x1382CA98, 37353948037755488, 89844978, 89844981, 3, 640x360 
0x1382CA98, 37353948038083336, 89845013, 89845015, 2, 640x360 
0x1382CA98, 37353948038395488, 89845039, 89845042, 3, 640x360 
0x1382CA98, 37353948038721696, 89845065, 89845070, 5, 640x360 
0x1382CA98, 37353948039038672, 89845106, 89845114, 8, 640x360 
0x1382CA98, 37353948039360104, 89845131, 89845138, 7, 640x360 
0x1382CA98, 37353948039675240, 89845166, 89845170, 4, 640x360 
0x1382CA98, 37353948040004400, 89845199, 89845201, 2, 640x360 
0x1382CA98, 37353948040318848, 89845234, 89845243, 9, 640x360 
0x1382CA98, 37353948040807632, 89845276, 89845286, 10, 640x360 
0x1382CA98, 37353948041120928, 89845303, 89845307, 4, 640x360 
0x1382CA98, 37353948041444880, 89845348, 89845353, 5, 640x360 
0x1382CA98, 37353948041763888, 89845366, 89845369, 3, 640x360 
0x1382CA98, 37353948042079176, 89845399, 89845402, 3, 640x360 
0x1382CA98, 37353948042407000, 89845431, 89845434, 3, 640x360 
0x1382CA98, 37353948042716080, 89845471, 89845480, 9, 640x360 
0x1382CA98, 37353948043037136, 89845501, 89845505, 4, 640x360 
0x1382CA98, 37353948043361672, 89845529, 89845535, 6, 640x360 
0x1382CA98, 37353948043679088, 89845563, 89845565, 2, 640x360 
0x1382CA98, 37353948044014024, 89845594, 89845596, 2, 640x360 
0x1382CA98, 37353948044320296, 89845627, 89845629, 2, 640x360 
0x1382CA98, 37353948044799336, 89845678, 89845685, 7, 640x360 
0x1382CA98, 37353948045115160, 89845704, 89845713, 9, 640x360 
0x1382CA98, 37353948045440696, 89845739, 89845745, 6, 640x360 
0x1382CA98, 37353948045760232, 89845769, 89845772, 3, 640x360 
0x1382CA98, 37353948046083560, 89845799, 89845804, 5, 640x360 
0x1382CA98, 37353948046395232, 89845831, 89845836, 5, 640x360 
0x1382CA98, 37353948046715544, 89845868, 89845874, 6, 640x360 
0x1382CA98, 37353948047044488, 89845896, 89845898, 2, 640x360 
0x1382CA98, 37353948047365608, 89845933, 89845936, 3, 640x360 
0x1382CA98, 37353948047679880, 89845960, 89845966, 6, 640x360 
0x1382CA98, 37353948047999176, 89845993, 89845995, 2, 640x360 
0x1382CA98, 37353948048315320, 89846021, 89846023, 2, 640x360 
0x1382CA98, 37353948048794912, 89846069, 89846079, 10, 640x360 
0x1382CA98, 37353948049120728, 89846108, 89846112, 4, 640x360 
0x1382CA98, 37353948049455992, 89846149, 89846154, 5, 640x360 
0x1382CA98, 37353948049774744, 89846170, 89846176, 6, 640x360 
0x1382CA98, 37353948050086880, 89846202, 89846206, 4, 640x360 
0x1382CA98, 37353948050399456, 89846241, 89846243, 2, 640x360 
0x1382CA98, 37353948050717472, 89846271, 89846278, 7, 640x360 
0x1382CA98, 37353948051039984, 89846304, 89846307, 3, 640x360 
0x1382CA98, 37353948051360816, 89846339, 89846342, 3, 640x360 
0x1382CA98, 37353948051694064, 89846359, 89846361, 2, 640x360 
0x1382CA98, 37353948052012456, 89846394, 89846396, 2, 640x360 
0x1382CA98, 37353948052330816, 89846425, 89846432, 7, 640x360 
0x1382CA98, 37353948053131232, 89846512, 89846523, 11, 640x360 
0x1382CA98, 37353948053470240, 89846538, 89846542, 4, 640x360 
0x1382CA98, 37353948053759952, 89846567, 89846570, 3, 640x360 
0x1382CA98, 37353948054113104, 89846609, 89846614, 5, 640x360 
0x1382CA98, 37353948054396280, 89846642, 89846650, 8, 640x360 
0x1382CA98, 37353948054717000, 89846676, 89846683, 7, 640x360 
0x1382CA98, 37353948055037952, 89846706, 89846709, 3, 640x360 
0x1382CA98, 37353948055354712, 89846728, 89846736, 8, 640x360 
0x1382CA98, 37353948055679336, 89846766, 89846772, 6, 640x360 
0x1382CA98, 37353948055995504, 89846797, 89846799, 2, 640x360 
0x1382CA98, 37353948056336336, 89846831, 89846833, 2, 640x360 
0x1382CA98, 37353948056683688, 89846865, 89846867, 2, 640x360 
0x1382CA98, 37353948057116648, 89846915, 89846918, 3, 640x360 
0x1382CA98, 37353948057443920, 89846944, 89846946, 2, 640x360 
0x1382CA98, 37353948057762248, 89846979, 89846981, 2, 640x360 
0x1382CA98, 37353948058087360, 89847009, 89847012, 3, 640x360 
0x1382CA98, 37353948058394720, 89847036, 89847042, 6, 640x360 
0x1382CA98, 37353948058714632, 89847072, 89847075, 3, 640x360 
0x1382CA98, 37353948059034592, 89847103, 89847107, 4, 640x360 
0x1382CA98, 37353948059354736, 89847127, 89847135, 8, 640x360 
0x1382CA98, 37353948059681352, 89847157, 89847165, 8, 640x360 
0x1382CA98, 37353948059994680, 89847188, 89847191, 3, 640x360 
0x1382CA98, 37353948060321240, 89847227, 89847236, 9, 640x360 
0x1382CA98, 37353948060652472, 89847273, 89847276, 3, 640x360 
0x1382CA98, 37353948061119616, 89847310, 89847313, 3, 640x360 
0x1382CA98, 37353948061434376, 89847341, 89847343, 2, 640x360 
0x1382CA98, 37353948061755672, 89847365, 89847368, 3, 640x360 
0x1382CA98, 37353948062082272, 89847408, 89847411, 3, 640x360 
0x1382CA98, 37353948062394536, 89847439, 89847442, 3, 640x360 
0x1382CA98, 37353948062714608, 89847471, 89847475, 4, 640x360 
0x1382CA98, 37353948063034800, 89847495, 89847498, 3, 640x360 
0x1382CA98, 37353948063359912, 89847527, 89847530, 3, 640x360 
0x1382CA98, 37353948063678400, 89847568, 89847572, 4, 640x360 
0x1382CA98, 37353948064006776, 89847599, 89847601, 2, 640x360 
0x1382CA98, 37353948064317904, 89847632, 89847635, 3, 640x360 
0x1382CA98, 37353948064652008, 89847661, 89847663, 2, 640x360 
0x1382CA98, 37353948065118456, 89847716, 89847718, 2, 640x360 
0x1382CA98, 37353948065436512, 89847741, 89847744, 3, 640x360 
0x1382CA98, 37353948065758600, 89847763, 89847765, 2, 640x360 
0x1382CA98, 37353948066082064, 89847797, 89847802, 5, 640x360 
0x1382CA98, 37353948066395080, 89847839, 89847843, 4, 640x360 
0x1382CA98, 37353948066722152, 89847878, 89847880, 2, 640x360 
0x1382CA98, 37353948067034664, 89847897, 89847899, 2, 640x360 
0x1382CA98, 37353948067359184, 89847926, 89847933, 7, 640x360 
0x1382CA98, 37353948067679216, 89847960, 89847966, 6, 640x360 
0x1382CA98, 37353948067995328, 89847994, 89847996, 2, 640x360 
0x1382CA98, 37353948068319200, 89848021, 89848025, 4, 640x360 
0x1382CA98, 37353948068636712, 89848053, 89848065, 12, 640x360 
0x1382CA98, 37353948069114264, 89848100, 89848110, 10, 640x360 
0x1382CA98, 37353948069443080, 89848134, 89848150, 16, 640x360 
0x1382CA98, 37353948069768712, 89848171, 89848180, 9, 640x360 
0x1382CA98, 37353948070074752, 89848198, 89848204, 6, 640x360 
0x1382CA98, 37353948070394424, 89848241, 89848250, 9, 640x360 
0x1382CA98, 37353948070718304, 89848265, 89848269, 4, 640x360 
0x1382CA98, 37353948071035048, 89848306, 89848308, 2, 640x360 
0x1382CA98, 37353948071358064, 89848326, 89848329, 3, 640x360 
0x1382CA98, 37353948071675272, 89848359, 89848365, 6, 640x360 
0x1382CA98, 37353948072011592, 89848394, 89848399, 5, 640x360 
0x1382CA98, 37353948072315168, 89848427, 89848432, 5, 640x360 
0x1382CA98, 37353948072635904, 89848458, 89848467, 9, 640x360 
0x1382CA98, 37353948073114208, 89848513, 89848518, 5, 640x360 
0x1382CA98, 37353948073433952, 89848533, 89848536, 3, 640x360 
0x1382CA98, 37353948073761728, 89848573, 89848575, 2, 640x360 
0x1382CA98, 37353948074083712, 89848598, 89848599, 1, 640x360 
0x1382CA98, 37353948074401360, 89848639, 89848642, 3, 640x360 
0x1382CA98, 37353948074715608, 89848662, 89848665, 3, 640x360 
0x1382CA98, 37353948075039144, 89848704, 89848709, 5, 640x360 
0x1382CA98, 37353948075354360, 89848731, 89848736, 5, 640x360 
0x1382CA98, 37353948075674720, 89848757, 89848768, 11, 640x360 
0x1382CA98, 37353948075994256, 89848788, 89848802, 14, 640x360 
0x1382CA98, 37353948076314776, 89848825, 89848828, 3, 640x360 
0x1382CA98, 37353948076639584, 89848852, 89848858, 6, 640x360 
0x1382CA98, 37353948077114016, 89848906, 89848913, 7, 640x360 
0x1382CA98, 37353948077445664, 89848946, 89848948, 2, 640x360 
0x1382CA98, 37353948077767480, 89848966, 89848969, 3, 640x360 
0x1382CA98, 37353948078075816, 89848998, 89849001, 3, 640x360 
0x1382CA98, 37353948078395056, 89849041, 89849044, 3, 640x360 
0x1382CA98, 37353948078717848, 89849063, 89849065, 2, 640x360 
0x1382CA98, 37353948079034976, 89849098, 89849100, 2, 640x360 
0x1382CA98, 37353948079359784, 89849127, 89849130, 3, 640x360 
0x1382CA98, 37353948079674544, 89849167, 89849170, 3, 640x360 
0x1382CA98, 37353948079994952, 89849195, 89849197, 2, 640x360 
0x1382CA98, 37353948080319016, 89849228, 89849231, 3, 640x360 
0x1382CA98, 37353948080640712, 89849261, 89849264, 3, 640x360 
0x1382CA98, 37353948080955176, 89849286, 89849293, 7, 640x360 
0x1382CA98, 37353948081451888, 89849333, 89849337, 4, 640x360 
0x1382CA98, 37353948081759936, 89849364, 89849366, 2, 640x360 
0x1382CA98, 37353948082077976, 89849398, 89849401, 3, 640x360 
0x1382CA98, 37353948082395128, 89849433, 89849437, 4, 640x360 
0x1382CA98, 37353948082714984, 89849473, 89849481, 8, 640x360 
0x1382CA98, 37353948083035456, 89849494, 89849496, 2, 640x360 
0x1382CA98, 37353948083355032, 89849527, 89849530, 3, 640x360 
0x1382CA98, 37353948083680768, 89849560, 89849563, 3, 640x360 
0x1382CA98, 37353948084015016, 89849593, 89849595, 2, 640x360 
0x1382CA98, 37353948084331192, 89849631, 89849633, 2, 640x360 
0x1382CA98, 37353948084640120, 89849679, 89849685, 6, 640x360 
0x1382CA98, 37353948084970016, 89849706, 89849708, 2, 640x360 
0x1382CA98, 37353948085447936, 89849753, 89849758, 5, 640x360 
0x1382CA98, 37353948085755800, 89849770, 89849775, 5, 640x360 
0x1382CA98, 37353948086083744, 89849797, 89849800, 3, 640x360 
0x1382CA98, 37353948086397912, 89849839, 89849849, 10, 640x360 
0x1382CA98, 37353948086718064, 89849873, 89849876, 3, 640x360 
0x1382CA98, 37353948087034104, 89849898, 89849900, 2, 640x360 
0x1382CA98, 37353948087354088, 89849926, 89849929, 3, 640x360 
0x1382CA98, 37353948087674264, 89849966, 89849968, 2, 640x360 
0x1382CA98, 37353948087998056, 89849994, 89849996, 2, 640x360 
0x1382CA98, 37353948088322616, 89850034, 89850037, 3, 640x360 
0x1382CA98, 37353948088634520, 89850059, 89850062, 3, 640x360 
0x1382CA98, 37353948088954568, 89850090, 89850092, 2, 640x360 
0x1382CA98, 37353948089434792, 89850136, 89850143, 7, 640x360 
0x1382CA98, 37353948089787608, 89850177, 89850183, 6, 640x360 
0x1382CA98, 37353948090113200, 89850212, 89850214, 2, 640x360 
0x1382CA98, 37353948090403736, 89850236, 89850249, 13, 640x360 
0x1382CA98, 37353948090716000, 89850267, 89850274, 7, 640x360 
0x1382CA98, 37353948091041336, 89850299, 89850302, 3, 640x360 
0x1382CA98, 37353948091386136, 89850339, 89850349, 10, 640x360 
0x1382CA98, 37353948091678184, 89850361, 89850364, 3, 640x360 
0x1382CA98, 37353948091999080, 89850395, 89850397, 2, 640x360 
0x1382CA98, 37353948092336544, 89850428, 89850430, 2, 640x360 
0x1382CA98, 37353948092657296, 89850461, 89850463, 2, 640x360 
0x1382CA98, 37353948092970328, 89850494, 89850496, 2, 640x360 
0x1382CA98, 37353948093447808, 89850538, 89850541, 3, 640x360 
0x1382CA98, 37353948093761304, 89850567, 89850575, 8, 640x360 
0x1382CA98, 37353948094096232, 89850601, 89850607, 6, 640x360 
0x1382CA98, 37353948094394448, 89850635, 89850646, 11, 640x360 
0x1382CA98, 37353948094719608, 89850672, 89850675, 3, 640x360 
0x1382CA98, 37353948095039032, 89850700, 89850704, 4, 640x360 
0x1382CA98, 37353948095363904, 89850743, 89850749, 6, 640x360 
0x1382CA98, 37353948095692584, 89850768, 89850772, 4, 640x360 
0x1382CA98, 37353948096014336, 89850800, 89850804, 4, 640x360 
0x1382CA98, 37353948096317368, 89850821, 89850825, 4, 640x360 
0x1382CA98, 37353948096634336, 89850860, 89850863, 3, 640x360 
0x1382CA98, 37353948096962376, 89850890, 89850900, 10, 640x360 
0x1382CA98, 37353948097437072, 89850942, 89850944, 2, 640x360 
0x1382CA98, 37353948097758864, 89850967, 89850970, 3, 640x360 
0x1382CA98, 37353948098074368, 89850995, 89850998, 3, 640x360 
0x1382CA98, 37353948098413872, 89851040, 89851042, 2, 640x360 
0x1382CA98, 37353948098718424, 89851063, 89851065, 2, 640x360 
0x1382CA98, 37353948099034688, 89851099, 89851105, 6, 640x360 
0x1382CA98, 37353948099357584, 89851128, 89851131, 3, 640x360 
0x1382CA98, 37353948099674296, 89851166, 89851169, 3, 640x360 
0x1382CA98, 37353948099998504, 89851195, 89851202, 7, 640x360 
0x1382CA98, 37353948100313544, 89851227, 89851229, 2, 640x360 
0x1382CA98, 37353948100638600, 89851262, 89851264, 2, 640x360 
0x1382CA98, 37353948100957440, 89851285, 89851293, 8, 640x360 
0x1382CA98, 37353948101444312, 89851339, 89851341, 2, 640x360 
0x1382CA98, 37353948101781016, 89851367, 89851374, 7, 640x360 
0x1382CA98, 37353948102073904, 89851400, 89851404, 4, 640x360 
0x1382CA98, 37353948102398152, 89851438, 89851440, 2, 640x360 
0x1382CA98, 37353948102722888, 89851473, 89851476, 3, 640x360 
0x1382CA98, 37353948103034104, 89851494, 89851497, 3, 640x360 
0x1382CA98, 37353948103354568, 89851526, 89851531, 5, 640x360 
0x1382CA98, 37353948103680240, 89851559, 89851563, 4, 640x360 
0x1382CA98, 37353948103998880, 89851595, 89851597, 2, 640x360 
0x1382CA98, 37353948104318976, 89851620, 89851633, 13, 640x360 
0x1382CA98, 37353948104638880, 89851660, 89851662, 2, 640x360 
0x1382CA98, 37353948104959376, 89851694, 89851696, 2, 640x360 
0x1382CA98, 37353948105433520, 89851732, 89851734, 2, 640x360 
0x1382CA98, 37353948105754488, 89851764, 89851772, 8, 640x360 
0x1382CA98, 37353948106075952, 89851808, 89851814, 6, 640x360 
0x1382CA98, 37353948106408112, 89851850, 89851854, 4, 640x360 
0x1382CA98, 37353948106716224, 89851873, 89851885, 12, 640x360 
0x1382CA98, 37353948107038208, 89851906, 89851922, 16, 640x360 
0x1382CA98, 37353948107356344, 89851940, 89851942, 2, 640x360 
0x1382CA98, 37353948107674328, 89851965, 89851966, 1, 640x360 
0x1382CA98, 37353948107999424, 89851994, 89851996, 2, 640x360 
0x1382CA98, 37353948108317752, 89852028, 89852040, 12, 640x360 
0x1382CA98, 37353948108635520, 89852058, 89852065, 7, 640x360 
0x1382CA98, 37353948108953888, 89852090, 89852100, 10, 640x360 
0x1382CA98, 37353948109284136, 89852117, 89852133, 16, 640x360 
0x1382CA98, 37353948109755712, 89852165, 89852168, 3, 640x360 
0x1382CA98, 37353948110074400, 89852205, 89852208, 3, 640x360 
0x1382CA98, 37353948110399560, 89852231, 89852233, 2, 640x360 
0x1382CA98, 37353948110713192, 89852270, 89852273, 3, 640x360 
0x1382CA98, 37353948111033312, 89852297, 89852300, 3, 640x360 
0x1382CA98, 37353948111362488, 89852331, 89852333, 2, 640x360 
0x1382CA98, 37353948111673208, 89852357, 89852366, 9, 640x360 
0x1382CA98, 37353948111999048, 89852392, 89852394, 2, 640x360 
0x1382CA98, 37353948112313312, 89852437, 89852441, 4, 640x360 
0x1382CA98, 37353948112645368, 89852461, 89852473, 12, 640x360 
0x1382CA98, 37353948112960088, 89852499, 89852501, 2, 640x360 
0x1382CA98, 37353948113283440, 89852517, 89852523, 6, 640x360 
0x1382CA98, 37353948113782432, 89852568, 89852574, 6, 640x360 
0x1382CA98, 37353948114085408, 89852601, 89852606, 5, 640x360 
0x1382CA98, 37353948114392840, 89852639, 89852643, 4, 640x360 
0x1382CA98, 37353948114713488, 89852663, 89852667, 4, 640x360 
0x1382CA98, 37353948115034016, 89852698, 89852701, 3, 640x360 
0x1382CA98, 37353948115357296, 89852736, 89852741, 5, 640x360 
0x1382CA98, 37353948115673272, 89852768, 89852772, 4, 640x360 
0x1382CA98, 37353948115995864, 89852793, 89852803, 10, 640x360 
0x1382CA98, 37353948116313640, 89852829, 89852830, 1, 640x360 
0x1382CA98, 37353948116635912, 89852871, 89852874, 3, 640x360 
0x1382CA98, 37353948116955904, 89852896, 89852906, 10, 640x360 
0x1382CA98, 37353948117277712, 89852922, 89852924, 2, 640x360 
0x1382CA98, 37353948117755872, 89852967, 89852970, 3, 640x360 
0x1382CA98, 37353948118080800, 89852998, 89853000, 2, 640x360 
0x1382CA98, 37353948118393960, 89853029, 89853032, 3, 640x360 
0x1382CA98, 37353948118714272, 89853065, 89853067, 2, 640x360 
0x1382CA98, 37353948119034152, 89853091, 89853098, 7, 640x360 
0x1382CA98, 37353948119442672, 89853138, 89853143, 5, 640x360 
0x1382CA98, 37353948119677000, 89853170, 89853179, 9, 640x360 
0x1382CA98, 37353948120007416, 89853195, 89853197, 2, 640x360 
0x1382CA98, 37353948120314136, 89853221, 89853233, 12, 640x360 
0x1382CA98, 37353948120634032, 89853256, 89853262, 6, 640x360 
0x1382CA98, 37353948120954176, 89853285, 89853294, 9, 640x360 
0x1382CA98, 37353948121274184, 89853316, 89853322, 6, 640x360 
0x1382CA98, 37353948121757144, 89853369, 89853380, 11, 640x360 
0x1382CA98, 37353948122074400, 89853397, 89853400, 3, 640x360 
0x1382CA98, 37353948122392704, 89853429, 89853431, 2, 640x360 
0x1382CA98, 37353948122712704, 89853464, 89853466, 2, 640x360 
0x1382CA98, 37353948123033376, 89853492, 89853494, 2, 640x360 
0x1382CA98, 37353948123353624, 89853537, 89853541, 4, 640x360 
0x1382CA98, 37353948123676400, 89853562, 89853564, 2, 640x360 
0x1382CA98, 37353948124009816, 89853593, 89853597, 4, 640x360 
0x1382CA98, 37353948124317744, 89853627, 89853629, 2, 640x360 
0x1382CA98, 37353948124663392, 89853672, 89853675, 3, 640x360 
0x1382CA98, 37353948124955576, 89853706, 89853708, 2, 640x360 
0x1382CA98, 37353948125290624, 89853730, 89853740, 10, 640x360 
0x1382CA98, 37353948125755688, 89853776, 89853783, 7, 640x360 
0x1382CA98, 37353948126096008, 89853807, 89853810, 3, 640x360 
0x1382CA98, 37353948126392512, 89853833, 89853836, 3, 640x360 
0x1382CA98, 37353948126717984, 89853872, 89853874, 2, 640x360 
0x1382CA98, 37353948127038416, 89853898, 89853908, 10, 640x360 
0x1382CA98, 37353948127356960, 89853933, 89853935, 2, 640x360 
0x1382CA98, 37353948127672816, 89853960, 89853962, 2, 640x360 
0x1382CA98, 37353948127992912, 89853992, 89853995, 3, 640x360 
0x1382CA98, 37353948128317080, 89854026, 89854028, 2, 640x360 
0x1382CA98, 37353948128633968, 89854062, 89854070, 8, 640x360 
0x1382CA98, 37353948128954072, 89854085, 89854092, 7, 640x360 
0x1382CA98, 37353948129277840, 89854131, 89854143, 12, 640x360 
0x1382CA98, 37353948129760392, 89854171, 89854179, 8, 640x360 
0x1382CA98, 37353948130073128, 89854199, 89854203, 4, 640x360 
0x1382CA98, 37353948130392424, 89854231, 89854234, 3, 640x360 
0x1382CA98, 37353948130717744, 89854272, 89854281, 9, 640x360 
0x1382CA98, 37353948131040288, 89854301, 89854305, 4, 640x360 
0x1382CA98, 37353948131363088, 89854328, 89854331, 3, 640x360 
0x1382CA98, 37353948131677888, 89854366, 89854368, 2, 640x360 
0x1382CA98, 37353948131997872, 89854398, 89854401, 3, 640x360 
0x1382CA98, 37353948132325936, 89854428, 89854430, 2, 640x360 
0x1382CA98, 37353948132658904, 89854470, 89854474, 4, 640x360 
0x1382CA98, 37353948132962680, 89854505, 89854508, 3, 640x360 
0x1382CA98, 37353948133291032, 89854527, 89854529, 2, 640x360 
0x1382CA98, 37353948133756032, 89854571, 89854573, 2, 640x360 
0x1382CA98, 37353948134073592, 89854596, 89854599, 3, 640x360 
0x1382CA98, 37353948134396688, 89854638, 89854641, 3, 640x360 
0x1382CA98, 37353948134721784, 89854667, 89854672, 5, 640x360 
0x1382CA98, 37353948135037256, 89854704, 89854707, 3, 640x360 
0x1382CA98, 37353948135353832, 89854729, 89854731, 2, 640x360 
0x1382CA98, 37353948135677592, 89854758, 89854762, 4, 640x360 
0x1382CA98, 37353948135995168, 89854800, 89854802, 2, 640x360 
0x1382CA98, 37353948136322416, 89854825, 89854832, 7, 640x360 
0x1382CA98, 37353948136633928, 89854851, 89854859, 8, 640x360 
0x1382CA98, 37353948136955944, 89854897, 89854899, 2, 640x360 
0x1382CA98, 37353948137285312, 89854925, 89854927, 2, 640x360 
0x1382CA98, 37353948137602192, 89854952, 89854957, 5, 640x360 
0x1382CA98, 37353948138072840, 89855001, 89855006, 5, 640x360 
0x1382CA98, 37353948138404528, 89855031, 89855033, 2, 640x360 
0x1382CA98, 37353948138712608, 89855069, 89855075, 6, 640x360 
0x1382CA98, 37353948139042264, 89855095, 89855098, 3, 640x360 
0x1382CA98, 37353948139354024, 89855127, 89855130, 3, 640x360 
0x1382CA98, 37353948139682400, 89855166, 89855170, 4, 640x360 
0x1382CA98, 37353948139999496, 89855199, 89855203, 4, 640x360 
0x1382CA98, 37353948140315136, 89855221, 89855229, 8, 640x360 
0x1382CA98, 37353948140633144, 89855253, 89855263, 10, 640x360 
0x1382CA98, 37353948140954472, 89855289, 89855295, 6, 640x360 
0x1382CA98, 37353948141274152, 89855323, 89855332, 9, 640x360 
0x1382CA98, 37353948141620240, 89855373, 89855382, 9, 640x360 
0x1382CA98, 37353948142095632, 89855415, 89855429, 14, 640x360 
0x1382CA98, 37353948142410328, 89855458, 89855461, 3, 640x360 
0x1382CA98, 37353948142768328, 89855474, 89855477, 3, 640x360 
0x1382CA98, 37353948143032136, 89855501, 89855521, 20, 640x360 
0x1382CA98, 37353948143375240, 89855529, 89855532, 3, 640x360 
0x1382CA98, 37353948143675424, 89855566, 89855575, 9, 640x360 
0x1382CA98, 37353948144001736, 89855593, 89855597, 4, 640x360 
0x1382CA98, 37353948144322768, 89855631, 89855641, 10, 640x360 
0x1382CA98, 37353948144635040, 89855664, 89855676, 12, 640x360 
0x1382CA98, 37353948144966216, 89855711, 89855714, 3, 640x360 
0x1382CA98, 37353948145280744, 89855728, 89855733, 5, 640x360 
0x1382CA98, 37353948145623872, 89855765, 89855767, 2, 640x360 
0x1382CA98, 37353948146072992, 89855805, 89855807, 2, 640x360 
0x1382CA98, 37353948146396448, 89855838, 89855841, 3, 640x360 
0x1382CA98, 37353948146722704, 89855874, 89855876, 2, 640x360 
0x1382CA98, 37353948147035368, 89855896, 89855899, 3, 640x360 
0x1382CA98, 37353948147354504, 89855927, 89855930, 3, 640x360 
0x1382CA98, 37353948147672544, 89855961, 89855963, 2, 640x360 
0x1382CA98, 37353948147992856, 89855988, 89855999, 11, 640x360 
0x1382CA98, 37353948148316152, 89856030, 89856032, 2, 640x360 
0x1382CA98, 37353948148632928, 89856055, 89856062, 7, 640x360 
0x1382CA98, 37353948148956784, 89856090, 89856095, 5, 640x360 
0x1382CA98, 37353948149274888, 89856130, 89856133, 3, 640x360 
0x1382CA98, 37353948149634280, 89856165, 89856166, 1, 640x360 
0x1382CA98, 37353948150072192, 89856196, 89856199, 3, 640x360 
0x1382CA98, 37353948150396384, 89856234, 89856238, 4, 640x360 
0x1382CA98, 37353948150712640, 89856272, 89856280, 8, 640x360 
0x1382CA98, 37353948151033176, 89856299, 89856305, 6, 640x360 
0x1382CA98, 37353948151353048, 89856324, 89856333, 9, 640x360 
0x1382CA98, 37353948151672904, 89856362, 89856364, 2, 640x360 
0x1382CA98, 37353948152008704, 89856398, 89856400, 2, 640x360 
0x1382CA98, 37353948152319032, 89856432, 89856434, 2, 640x360 
0x1382CA98, 37353948152636176, 89856467, 89856473, 6, 640x360 
0x1382CA98, 37353948152956168, 89856502, 89856507, 5, 640x360 
0x1382CA98, 37353948153279528, 89856528, 89856530, 2, 640x360 
0x1382CA98, 37353948153613744, 89856557, 89856565, 8, 640x360 
0x1382CA98, 37353948154072600, 89856603, 89856606, 3, 640x360 
0x1382CA98, 37353948154396296, 89856630, 89856633, 3, 640x360 
0x1382CA98, 37353948154725984, 89856672, 89856674, 2, 640x360 
0x1382CA98, 37353948155031984, 89856697, 89856699, 2, 640x360 
0x1382CA98, 37353948155356240, 89856731, 89856741, 10, 640x360 
0x1382CA98, 37353948155674192, 89856764, 89856767, 3, 640x360 
0x1382CA98, 37353948155993368, 89856789, 89856794, 5, 640x360 
0x1382CA98, 37353948156316800, 89856836, 89856843, 7, 640x360 
0x1382CA98, 37353948156656040, 89856875, 89856878, 3, 640x360 
0x1382CA98, 37353948156971968, 89856893, 89856895, 2, 640x360 
0x1382CA98, 37353948157276160, 89856933, 89856938, 5, 640x360 
0x1382CA98, 37353948157593096, 89856967, 89856969, 2, 640x360 
0x1382CA98, 37353948158072392, 89857010, 89857019, 9, 640x360 
0x1382CA98, 37353948158396008, 89857029, 89857033, 4, 640x360 
0x1382CA98, 37353948158715048, 89857060, 89857063, 3, 640x360 
0x1382CA98, 37353948159032480, 89857099, 89857103, 4, 640x360 
0x1382CA98, 37353948159352984, 89857126, 89857138, 12, 640x360 
0x1382CA98, 37353948159674576, 89857160, 89857167, 7, 640x360 
0x1382CA98, 37353948159997000, 89857193, 89857200, 7, 640x360 
0x1382CA98, 37353948160313184, 89857220, 89857223, 3, 640x360 
0x1382CA98, 37353948160633880, 89857250, 89857253, 3, 640x360 
0x1382CA98, 37353948160953232, 89857290, 89857297, 7, 640x360 
0x1382CA98, 37353948161274080, 89857315, 89857320, 5, 640x360 
0x1382CA98, 37353948161593144, 89857347, 89857349, 2, 640x360 
0x1382CA98, 37353948161917072, 89857388, 89857397, 9, 640x360 
0x1382CA98, 37353948162393744, 89857432, 89857435, 3, 640x360 
0x1382CA98, 37353948162712712, 89857474, 89857477, 3, 640x360 
0x1382CA98, 37353948163039784, 89857505, 89857508, 3, 640x360 
0x1382CA98, 37353948163352288, 89857530, 89857532, 2, 640x360 
0x1382CA98, 37353948163671952, 89857560, 89857565, 5, 640x360 
0x1382CA98, 37353948163995296, 89857594, 89857596, 2, 640x360 
0x1382CA98, 37353948164314872, 89857626, 89857629, 3, 640x360 
0x1382CA98, 37353948164632408, 89857652, 89857658, 6, 640x360 
0x1382CA98, 37353948164956264, 89857683, 89857686, 3, 640x360 
0x1382CA98, 37353948165275912, 89857717, 89857723, 6, 640x360 
0x1382CA98, 37353948165604664, 89857749, 89857753, 4, 640x360 
0x1382CA98, 37353948165916704, 89857786, 89857794, 8, 640x360 
0x1382CA98, 37353948166392112, 89857833, 89857840, 7, 640x360 
0x1382CA98, 37353948166720480, 89857862, 89857865, 3, 640x360 
0x1382CA98, 37353948167049960, 89857899, 89857905, 6, 640x360 
0x1382CA98, 37353948167351736, 89857925, 89857933, 8, 640x360 
0x1382CA98, 37353948167681296, 89857959, 89857962, 3, 640x360 
0x1382CA98, 37353948167995976, 89858002, 89858006, 4, 640x360 
0x1382CA98, 37353948168312176, 89858024, 89858026, 2, 640x360 
0x1382CA98, 37353948168699632, 89858061, 89858064, 3, 640x360 
0x1382CA98, 37353948169007664, 89858096, 89858097, 1, 640x360 
0x1382CA98, 37353948169276456, 89858127, 89858130, 3, 640x360 
0x1382CA98, 37353948169652272, 89858161, 89858163, 2, 640x360 
0x1382CA98, 37353948169917776, 89858186, 89858190, 4, 640x360 
0x1382CA98, 37353948170396712, 89858238, 89858242, 4, 640x360 
0x1382CA98, 37353948170712424, 89858270, 89858274, 4, 640x360 
0x1382CA98, 37353948171032160, 89858300, 89858303, 3, 640x360 
0x1382CA98, 37353948171357376, 89858337, 89858340, 3, 640x360 
0x1382CA98, 37353948171672432, 89858359, 89858362, 3, 640x360 
0x1382CA98, 37353948171995840, 89858394, 89858397, 3, 640x360 
0x1382CA98, 37353948172317032, 89858423, 89858427, 4, 640x360 
0x1382CA98, 37353948172637536, 89858454, 89858458, 4, 640x360 
0x1382CA98, 37353948172953928, 89858486, 89858491, 5, 640x360 
0x1382CA98, 37353948173275784, 89858517, 89858524, 7, 640x360 
0x1382CA98, 37353948173592424, 89858550, 89858556, 6, 640x360 
0x1382CA98, 37353948173918944, 89858581, 89858583, 2, 640x360 
0x1382CA98, 37353948174392384, 89858630, 89858633, 3, 640x360 
0x1382CA98, 37353948174712560, 89858666, 89858672, 6, 640x360 
0x1382CA98, 37353948175032512, 89858694, 89858697, 3, 640x360 
0x1382CA98, 37353948175354160, 89858728, 89858730, 2, 640x360 
0x1382CA98, 37353948175673352, 89858761, 89858763, 2, 640x360 
0x1382CA98, 37353948175992000, 89858787, 89858800, 13, 640x360 
0x1382CA98, 37353948176316960, 89858828, 89858831, 3, 640x360 
0x1382CA98, 37353948176635624, 89858849, 89858852, 3, 640x360 
0x1382CA98, 37353948176953032, 89858883, 89858899, 16, 640x360 
0x1382CA98, 37353948177293024, 89858925, 89858939, 14, 640x360 
0x1382CA98, 37353948177612616, 89858960, 89858963, 3, 640x360 
0x1382CA98, 37353948177926320, 89858983, 89858987, 4, 640x360 
0x1382CA98, 37353948178391144, 89859032, 89859034, 2, 640x360 
0x1382CA98, 37353948178711376, 89859071, 89859073, 2, 640x360 
0x1382CA98, 37353948179031920, 89859097, 89859099, 2, 640x360 
0x1382CA98, 37353948179353296, 89859131, 89859136, 5, 640x360 
0x1382CA98, 37353948179672320, 89859159, 89859168, 9, 640x360 
0x1382CA98, 37353948179991824, 89859193, 89859195, 2, 640x360 
0x1382CA98, 37353948180318216, 89859227, 89859229, 2, 640x360 
0x1382CA98, 37353948180650608, 89859259, 89859261, 2, 640x360 
0x1382CA98, 37353948180972512, 89859297, 89859299, 2, 640x360 
0x1382CA98, 37353948181311160, 89859327, 89859330, 3, 640x360 
0x1382CA98, 37353948181655664, 89859363, 89859365, 2, 640x360 
0x1382CA98, 37353948181923760, 89859385, 89859391, 6, 640x360 
0x1382CA98, 37353948182391184, 89859438, 89859441, 3, 640x360 
0x1382CA98, 37353948182715864, 89859463, 89859465, 2, 640x360 
0x1382CA98, 37353948183031328, 89859506, 89859508, 2, 640x360 
0x1382CA98, 37353948183354376, 89859536, 89859540, 4, 640x360 
0x1382CA98, 37353948183675104, 89859561, 89859569, 8, 640x360 
0x1382CA98, 37353948183991384, 89859605, 89859608, 3, 640x360 
0x1382CA98, 37353948184311848, 89859627, 89859631, 4, 640x360 
0x1382CA98, 37353948184635064, 89859651, 89859657, 6, 640x360 
0x1382CA98, 37353948184956704, 89859689, 89859698, 9, 640x360 
0x1382CA98, 37353948185286296, 89859725, 89859728, 3, 640x360 
0x1382CA98, 37353948185598544, 89859749, 89859752, 3, 640x360 
0x1382CA98, 37353948185916376, 89859781, 89859784, 3, 640x360 
0x1382CA98, 37353948186395120, 89859832, 89859835, 3, 640x360 
0x1382CA98, 37353948186727544, 89859865, 89859868, 3, 640x360 
0x1382CA98, 37353948187038456, 89859905, 89859921, 16, 640x360 
0x1382CA98, 37353948187354816, 89859934, 89859938, 4, 640x360 
0x1382CA98, 37353948187671512, 89859959, 89859967, 8, 640x360 
0x1382CA98, 37353948187996296, 89859993, 89860000, 7, 640x360 
0x1382CA98, 37353948188311584, 89860025, 89860027, 2, 640x360 
0x1382CA98, 37353948188643568, 89860066, 89860068, 2, 640x360 
0x1382CA98, 37353948188952160, 89860090, 89860098, 8, 640x360 
0x1382CA98, 37353948189277792, 89860122, 89860125, 3, 640x360 
0x1382CA98, 37353948189601648, 89860149, 89860152, 3, 640x360 
0x1382CA98, 37353948189917312, 89860186, 89860194, 8, 640x360 
0x1382CA98, 37353948190231632, 89860217, 89860222, 5, 640x360 
0x1382CA98, 37353948190716304, 89860264, 89860268, 4, 640x360 
0x1382CA98, 37353948191044064, 89860306, 89860314, 8, 640x360 
0x1382CA98, 37353948191365392, 89860333, 89860344, 11, 640x360 
0x1382CA98, 37353948191676736, 89860364, 89860366, 2, 640x360 
0x1382CA98, 37353948191993024, 89860397, 89860398, 1, 640x360 
0x1382CA98, 37353948192354136, 89860434, 89860461, 27, 640x360 
0x1382CA98, 37353948192636976, 89860471, 89860490, 19, 640x360 
0x1382CA98, 37353948192989576, 89860530, 89860556, 26, 640x360 
0x1382CA98, 37353948193296856, 89860557, 89860560, 3, 640x360 
0x1382CA98, 37353948193681128, 89860585, 89860593, 8, 640x360 
0x1382CA98, 37353948193930576, 89860607, 89860624, 17, 640x360 
0x1382CA98, 37353948194321960, 89860643, 89860648, 5, 640x360 
0x1382CA98, 37353948194727408, 89860678, 89860698, 20, 640x360 
0x1382CA98, 37353948195038128, 89860734, 89860742, 8, 640x360 
0x1382CA98, 37353948195460824, 89860767, 89860782, 15, 640x360 
0x1382CA98, 37353948195699056, 89860783, 89860796, 13, 640x360 
0x1382CA98, 37353948196026352, 89860841, 89860908, 67, 640x360 
0x1382CA98, 37353948196371608, 89860910, 89860914, 4, 640x360 
0x1382CA98, 37353948197285408, 89860940, 89860947, 7, 640x360 
0x1382CA98, 37353948197617664, 89860966, 89860977, 11, 640x360 
0x1382CA98, 37353948197939096, 89860999, 89861005, 6, 640x360 
0x1382CA98, 37353948198233480, 89861017, 89861035, 18, 640x360 
0x1382CA98, 37353948198710568, 89861065, 89861067, 2, 640x360 
0x1382CA98, 37353948199031992, 89861101, 89861113, 12, 640x360 
0x1382CA98, 37353948199371520, 89861138, 89861141, 3, 640x360 
0x1382CA98, 37353948199687688, 89861165, 89861170, 5, 640x360 
0x1382CA98, 37353948200004248, 89861194, 89861196, 2, 640x360 
0x1382CA98, 37353948200334456, 89861224, 89861227, 3, 640x360 
0x1382CA98, 37353948200637096, 89861261, 89861263, 2, 640x360 
0x1382CA98, 37353948200956712, 89861293, 89861299, 6, 640x360 
0x1382CA98, 37353948201283312, 89861317, 89861322, 5, 640x360 
0x1382CA98, 37353948201596552, 89861356, 89861366, 10, 640x360 
0x1382CA98, 37353948201914240, 89861383, 89861387, 4, 640x360 
0x1382CA98, 37353948202235096, 89861413, 89861415, 2, 640x360 
0x1382CA98, 37353948202716624, 89861463, 89861465, 2, 640x360 
0x1382CA98, 37353948203033656, 89861497, 89861501, 4, 640x360 
0x1382CA98, 37353948203355184, 89861537, 89861547, 10, 640x360 
0x1382CA98, 37353948203685904, 89861573, 89861581, 8, 640x360 
0x1382CA98, 37353948204036512, 89861594, 89861596, 2, 640x360 
0x1382CA98, 37353948204334712, 89861628, 89861630, 2, 640x360 
0x1382CA98, 37353948204664896, 89861658, 89861661, 3, 640x360 
0x1382CA98, 37353948204956064, 89861705, 89861707, 2, 640x360 
0x1382CA98, 37353948205278616, 89861720, 89861728, 8, 640x360 
0x1382CA98, 37353948205603576, 89861748, 89861753, 5, 640x360 
0x1382CA98, 37353948205915160, 89861784, 89861794, 10, 640x360 
0x1382CA98, 37353948206235968, 89861821, 89861823, 2, 640x360 
0x1382CA98, 37353948206711512, 89861871, 89861874, 3, 640x360 
0x1382CA98, 37353948207031240, 89861895, 89861897, 2, 640x360 
0x1382CA98, 37353948207351296, 89861922, 89861924, 2, 640x360 
0x1382CA98, 37353948207671728, 89861958, 89861964, 6, 640x360 
0x1382CA98, 37353948207994296, 89861998, 89862006, 8, 640x360 
0x1382CA98, 37353948208311568, 89862026, 89862029, 3, 640x360 
0x1382CA98, 37353948208640928, 89862054, 89862059, 5, 640x360 
0x1382CA98, 37353948208956288, 89862087, 89862097, 10, 640x360 
0x1382CA98, 37353948209277448, 89862122, 89862125, 3, 640x360 
0x1382CA98, 37353948209606880, 89862160, 89862161, 1, 640x360 
0x1382CA98, 37353948209911736, 89862181, 89862183, 2, 640x360 
0x1382CA98, 37353948210231216, 89862213, 89862217, 4, 640x360 
0x1382CA98, 37353948210710408, 89862264, 89862266, 2, 640x360 
0x1382CA98, 37353948211034776, 89862295, 89862305, 10, 640x360 
0x1382CA98, 37353948211353640, 89862323, 89862333, 10, 640x360 
0x1382CA98, 37353948211678392, 89862360, 89862363, 3, 640x360 
0x1382CA98, 37353948211990576, 89862403, 89862406, 3, 640x360 
0x1382CA98, 37353948212311624, 89862426, 89862429, 3, 640x360 
0x1382CA98, 37353948212630680, 89862453, 89862465, 12, 640x360 
0x1382CA98, 37353948212994984, 89862494, 89862504, 10, 640x360 
0x1382CA98, 37353948213276160, 89862515, 89862518, 3, 640x360 
0x1382CA98, 37353948213600104, 89862551, 89862564, 13, 640x360 
0x1382CA98, 37353948213912976, 89862584, 89862595, 11, 640x360 
0x1382CA98, 37353948214234536, 89862615, 89862619, 4, 640x360 
0x1382CA98, 37353948214710360, 89862664, 89862669, 5, 640x360 
0x1382CA98, 37353948215034696, 89862698, 89862700, 2, 640x360 
0x1382CA98, 37353948215355848, 89862726, 89862729, 3, 640x360 
0x1382CA98, 37353948215674584, 89862767, 89862772, 5, 640x360 
0x1382CA98, 37353948215991368, 89862792, 89862797, 5, 640x360 
0x1382CA98, 37353948216314760, 89862827, 89862835, 8, 640x360 
0x1382CA98, 37353948216640408, 89862860, 89862862, 2, 640x360 
0x1382CA98, 37353948216957128, 89862905, 89862907, 2, 640x360 
0x1382CA98, 37353948217286176, 89862925, 89862928, 3, 640x360 
0x1382CA98, 37353948217604064, 89862951, 89862962, 11, 640x360 
0x1382CA98, 37353948217910808, 89862990, 89862998, 8, 640x360 
0x1382CA98, 37353948218235296, 89863024, 89863026, 2, 640x360 
0x1382CA98, 37353948218556352, 89863048, 89863052, 4, 640x360 
0x1382CA98, 37353948219034792, 89863100, 89863106, 6, 640x360 
0x1382CA98, 37353948219351496, 89863138, 89863142, 4, 640x360 
0x1382CA98, 37353948219675112, 89863159, 89863165, 6, 640x360 
0x1382CA98, 37353948219993616, 89863192, 89863194, 2, 640x360 
0x1382CA98, 37353948220320568, 89863233, 89863239, 6, 640x360 
0x1382CA98, 37353948220631152, 89863258, 89863273, 15, 640x360 
0x1382CA98, 37353948220968224, 89863286, 89863291, 5, 640x360 
0x1382CA98, 37353948221276664, 89863317, 89863323, 6, 640x360 
0x1382CA98, 37353948221614256, 89863356, 89863363, 7, 640x360 
0x1382CA98, 37353948221912984, 89863381, 89863384, 3, 640x360 
0x1382CA98, 37353948222235120, 89863421, 89863423, 2, 640x360 
0x1382CA98, 37353948222551672, 89863446, 89863449, 3, 640x360 
0x1382CA98, 37353948223031864, 89863493, 89863496, 3, 640x360 
0x1382CA98, 37353948223356880, 89863526, 89863532, 6, 640x360 
0x1382CA98, 37353948223675224, 89863558, 89863566, 8, 640x360 
0x1382CA98, 37353948223990808, 89863588, 89863592, 4, 640x360 
0x1382CA98, 37353948224330544, 89863625, 89863628, 3, 640x360 
0x1382CA98, 37353948224632528, 89863656, 89863659, 3, 640x360 
0x1382CA98, 37353948224950960, 89863682, 89863685, 3, 640x360 
0x1382CA98, 37353948225270672, 89863713, 89863715, 2, 640x360 
0x1382CA98, 37353948225598776, 89863750, 89863753, 3, 640x360 
0x1382CA98, 37353948225916464, 89863782, 89863785, 3, 640x360 
0x1382CA98, 37353948226230672, 89863817, 89863823, 6, 640x360 
0x1382CA98, 37353948226563176, 89863844, 89863846, 2, 640x360 
0x1382CA98, 37353948227035200, 89863893, 89863920, 27, 640x360 
0x1382CA98, 37353948227350968, 89863930, 89863940, 10, 640x360 
0x1382CA98, 37353948227676032, 89863965, 89863968, 3, 640x360 
0x1382CA98, 37353948227994584, 89864004, 89864023, 19, 640x360 
0x1382CA98, 37353948228320568, 89864027, 89864032, 5, 640x360 
0x1382CA98, 37353948228631024, 89864065, 89864066, 1, 640x360 
0x1382CA98, 37353948228951456, 89864090, 89864094, 4, 640x360 
0x1382CA98, 37353948229270632, 89864118, 89864131, 13, 640x360 
0x1382CA98, 37353948229594760, 89864151, 89864159, 8, 640x360 
0x1382CA98, 37353948229917736, 89864188, 89864192, 4, 640x360 
0x1382CA98, 37353948230230432, 89864215, 89864218, 3, 640x360 
0x1382CA98, 37353948230550584, 89864253, 89864258, 5, 640x360 
0x1382CA98, 37353948231029832, 89864293, 89864299, 6, 640x360 
0x1382CA98, 37353948231350568, 89864325, 89864333, 8, 640x360 
0x1382CA98, 37353948231671048, 89864356, 89864358, 2, 640x360 
0x1382CA98, 37353948231990928, 89864395, 89864401, 6, 640x360 
0x1382CA98, 37353948232316336, 89864425, 89864427, 2, 640x360 
0x1382CA98, 37353948232630888, 89864470, 89864475, 5, 640x360 
0x1382CA98, 37353948232953480, 89864490, 89864496, 6, 640x360 
0x1382CA98, 37353948233276472, 89864521, 89864532, 11, 640x360 
0x1382CA98, 37353948233597368, 89864557, 89864565, 8, 640x360 
0x1382CA98, 37353948233911616, 89864597, 89864600, 3, 640x360 
0x1382CA98, 37353948234231136, 89864623, 89864626, 3, 640x360 
0x1382CA98, 37353948234553472, 89864649, 89864652, 3, 640x360 
0x1382CA98, 37353948235030296, 89864700, 89864704, 4, 640x360 
0x1382CA98, 37353948235350608, 89864726, 89864733, 7, 640x360 
0x1382CA98, 37353948235670576, 89864766, 89864768, 2, 640x360 
0x1382CA98, 37353948235995000, 89864795, 89864801, 6, 640x360 
0x1382CA98, 37353948236310680, 89864821, 89864824, 3, 640x360 
0x1382CA98, 37353948236630944, 89864853, 89864859, 6, 640x360 
0x1382CA98, 37353948236950456, 89864884, 89864891, 7, 640x360 
0x1382CA98, 37353948237274768, 89864929, 89864931, 2, 640x360 
0x1382CA98, 37353948237605320, 89864948, 89864951, 3, 640x360 
0x1382CA98, 37353948237911464, 89864994, 89864997, 3, 640x360 
0x1382CA98, 37353948238234448, 89865015, 89865023, 8, 640x360 
0x1382CA98, 37353948238554008, 89865047, 89865051, 4, 640x360 
0x1382CA98, 37353948239034528, 89865106, 89865113, 7, 640x360 
0x1382CA98, 37353948239354720, 89865137, 89865140, 3, 640x360 
0x1382CA98, 37353948239672056, 89865167, 89865171, 4, 640x360 
0x1382CA98, 37353948239994928, 89865197, 89865199, 2, 640x360 
0x1382CA98, 37353948240314728, 89865234, 89865236, 2, 640x360 
0x1382CA98, 37353948240634512, 89865259, 89865267, 8, 640x360 
0x1382CA98, 37353948240950904, 89865283, 89865286, 3, 640x360 
0x1382CA98, 37353948241271760, 89865314, 89865316, 2, 640x360 
0x1382CA98, 37353948241601128, 89865355, 89865357, 2, 640x360 
0x1382CA98, 37353948241915816, 89865383, 89865385, 2, 640x360 
0x1382CA98, 37353948242230880, 89865419, 89865424, 5, 640x360 
0x1382CA98, 37353948242551136, 89865454, 89865458, 4, 640x360 
0x1382CA98, 37353948242871480, 89865487, 89865492, 5, 640x360 
0x1382CA98, 37353948243354712, 89865526, 89865533, 7, 640x360 
0x1382CA98, 37353948243670672, 89865556, 89865559, 3, 640x360 
0x1382CA98, 37353948243992728, 89865600, 89865607, 7, 640x360 
0x1382CA98, 37353948244310384, 89865633, 89865636, 3, 640x360 
0x1382CA98, 37353948244637280, 89865666, 89865669, 3, 640x360 
0x1382CA98, 37353948244963832, 89865699, 89865701, 2, 640x360 
0x1382CA98, 37353948245276200, 89865719, 89865734, 15, 640x360 
0x1382CA98, 37353948245592328, 89865752, 89865756, 4, 640x360 
0x1382CA98, 37353948245909936, 89865787, 89865792, 5, 640x360 
0x1382CA98, 37353948246233168, 89865823, 89865826, 3, 640x360 
0x1382CA98, 37353948246553496, 89865846, 89865848, 2, 640x360 
0x1382CA98, 37353948246870176, 89865877, 89865880, 3, 640x360 
0x1382CA98, 37353948247349376, 89865932, 89865934, 2, 640x360 
0x1382CA98, 37353948247670200, 89865960, 89865968, 8, 640x360 
0x1382CA98, 37353948247990232, 89865993, 89865999, 6, 640x360 
0x1382CA98, 37353948248310344, 89866027, 89866029, 2, 640x360 
0x1382CA98, 37353948248630640, 89866053, 89866055, 2, 640x360 
0x1382CA98, 37353948248950824, 89866091, 89866094, 3, 640x360 
0x1382CA98, 37353948249270088, 89866116, 89866119, 3, 640x360 
0x1382CA98, 37353948249590888, 89866152, 89866157, 5, 640x360 
0x1382CA98, 37353948249917280, 89866185, 89866190, 5, 640x360 
0x1382CA98, 37353948250234744, 89866223, 89866226, 3, 640x360 
0x1382CA98, 37353948250560568, 89866249, 89866253, 4, 640x360 
0x1382CA98, 37353948250871200, 89866285, 89866291, 6, 640x360 
0x1382CA98, 37353948251355008, 89866329, 89866331, 2, 640x360 
0x1382CA98, 37353948251673552, 89866368, 89866381, 13, 640x360 
0x1382CA98, 37353948251997568, 89866408, 89866416, 8, 640x360 
0x1382CA98, 37353948252332224, 89866439, 89866442, 3, 640x360 
0x1382CA98, 37353948252630128, 89866459, 89866465, 6, 640x360 
0x1382CA98, 37353948252956240, 89866494, 89866499, 5, 640x360 
0x1382CA98, 37353948253273808, 89866521, 89866525, 4, 640x360 
0x1382CA98, 37353948253609288, 89866552, 89866558, 6, 640x360 
0x1382CA98, 37353948253910472, 89866583, 89866586, 3, 640x360 
0x1382CA98, 37353948254233192, 89866615, 89866618, 3, 640x360 
0x1382CA98, 37353948254550680, 89866650, 89866655, 5, 640x360 
0x1382CA98, 37353948254871216, 89866677, 89866680, 3, 640x360 
0x1382CA98, 37353948255350176, 89866726, 89866728, 2, 640x360 
0x1382CA98, 37353948255679136, 89866757, 89866760, 3, 640x360 
0x1382CA98, 37353948255990624, 89866789, 89866792, 3, 640x360 
0x1382CA98, 37353948256310312, 89866820, 89866823, 3, 640x360 
0x1382CA98, 37353948256639392, 89866858, 89866860, 2, 640x360 
0x1382CA98, 37353948256950088, 89866885, 89866894, 9, 640x360 
0x1382CA98, 37353948257273048, 89866916, 89866919, 3, 640x360 
0x1382CA98, 37353948257595888, 89866955, 89866958, 3, 640x360 
0x1382CA98, 37353948257915328, 89866981, 89866984, 3, 640x360 
0x1382CA98, 37353948258230080, 89867025, 89867027, 2, 640x360 
0x1382CA98, 37353948258553552, 89867051, 89867053, 2, 640x360 
0x1382CA98, 37353948258874040, 89867078, 89867081, 3, 640x360 
0x1382CA98, 37353948259349776, 89867126, 89867129, 3, 640x360 
0x1382CA98, 37353948259669736, 89867167, 89867170, 3, 640x360 
0x1382CA98, 37353948259994608, 89867196, 89867198, 2, 640x360 
0x1382CA98, 37353948260320888, 89867227, 89867233, 6, 640x360 
0x1382CA98, 37353948260629856, 89867258, 89867266, 8, 640x360 
0x1382CA98, 37353948260974728, 89867300, 89867303, 3, 640x360 
0x1382CA98, 37353948261275616, 89867326, 89867332, 6, 640x360 
0x1382CA98, 37353948261598584, 89867354, 89867357, 3, 640x360 
0x1382CA98, 37353948261915032, 89867382, 89867385, 3, 640x360 
0x1382CA98, 37353948262233640, 89867423, 89867425, 2, 640x360 
0x1382CA98, 37353948262576648, 89867450, 89867455, 5, 640x360 
0x1382CA98, 37353948262878704, 89867481, 89867483, 2, 640x360 
0x1382CA98, 37353948263349136, 89867530, 89867536, 6, 640x360 
0x1382CA98, 37353948263669064, 89867585, 89867588, 3, 640x360 
0x1382CA98, 37353948264012800, 89867599, 89867606, 7, 640x360 
0x1382CA98, 37353948264310064, 89867633, 89867635, 2, 640x360 
0x1382CA98, 37353948264637872, 89867668, 89867674, 6, 640x360 
0x1382CA98, 37353948264951904, 89867694, 89867696, 2, 640x360 
0x1382CA98, 37353948265275560, 89867727, 89867731, 4, 640x360 
0x1382CA98, 37353948265595480, 89867778, 89867785, 7, 640x360 
0x1382CA98, 37353948265937816, 89867806, 89867816, 10, 640x360 
0x1382CA98, 37353948266232752, 89867825, 89867827, 2, 640x360 
0x1382CA98, 37353948266560488, 89867849, 89867850, 1, 640x360 
0x1382CA98, 37353948266869504, 89867889, 89867891, 2, 640x360 
0x1382CA98, 37353948267349032, 89867932, 89867934, 2, 640x360 
0x1382CA98, 37353948267671704, 89867961, 89867963, 2, 640x360 
0x1382CA98, 37353948267993288, 89867991, 89867993, 2, 640x360 
0x1382CA98, 37353948268312776, 89868022, 89868025, 3, 640x360 
0x1382CA98, 37353948268633320, 89868055, 89868058, 3, 640x360 
0x1382CA98, 37353948268949760, 89868084, 89868088, 4, 640x360 
0x1382CA98, 37353948269269360, 89868115, 89868118, 3, 640x360 
0x1382CA98, 37353948269607432, 89868155, 89868161, 6, 640x360 
0x1382CA98, 37353948269913480, 89868183, 89868190, 7, 640x360 
0x1382CA98, 37353948270233616, 89868214, 89868218, 4, 640x360 
0x1382CA98, 37353948270553768, 89868249, 89868251, 2, 640x360 
0x1382CA98, 37353948270877744, 89868281, 89868283, 2, 640x360 
0x1382CA98, 37353948271205472, 89868312, 89868316, 4, 640x360 
0x1382CA98, 37353948271673032, 89868366, 89868368, 2, 640x360 
0x1382CA98, 37353948271988880, 89868388, 89868392, 4, 640x360 
0x1382CA98, 37353948272309688, 89868417, 89868421, 4, 640x360 
0x1382CA98, 37353948272630072, 89868453, 89868456, 3, 640x360 
0x1382CA98, 37353948272950208, 89868484, 89868486, 2, 640x360 
0x1382CA98, 37353948273272992, 89868515, 89868518, 3, 640x360 
0x1382CA98, 37353948273590984, 89868549, 89868553, 4, 640x360 
0x1382CA98, 37353948273909672, 89868582, 89868584, 2, 640x360 
0x1382CA98, 37353948274229408, 89868615, 89868617, 2, 640x360 
0x1382CA98, 37353948274550128, 89868644, 89868647, 3, 640x360 
0x1382CA98, 37353948274872880, 89868679, 89868681, 2, 640x360 
0x1382CA98, 37353948275189384, 89868711, 89868713, 2, 640x360 
0x1382CA98, 37353948275669240, 89868759, 89868763, 4, 640x360 
0x1382CA98, 37353948276013144, 89868803, 89868814, 11, 640x360 
0x1382CA98, 37353948276338832, 89868835, 89868840, 5, 640x360 
0x1382CA98, 37353948276629184, 89868861, 89868864, 3, 640x360 
0x1382CA98, 37353948276955144, 89868889, 89868898, 9, 640x360 
0x1382CA98, 37353948277280072, 89868927, 89868933, 6, 640x360 
0x1382CA98, 37353948277591632, 89868959, 89868962, 3, 640x360 
0x1382CA98, 37353948277936320, 89868992, 89868994, 2, 640x360 
0x1382CA98, 37353948278233192, 89869017, 89869020, 3, 640x360 
0x1382CA98, 37353948278552792, 89869049, 89869050, 1, 640x360 
0x1382CA98, 37353948278873680, 89869081, 89869082, 1, 640x360 
0x1382CA98, 37353948279189384, 89869110, 89869113, 3, 640x360 
0x1382CA98, 37353948279668408, 89869165, 89869168, 3, 640x360 
0x1382CA98, 37353948279997880, 89869195, 89869202, 7, 640x360 
0x1382CA98, 37353948280309312, 89869227, 89869235, 8, 640x360 
0x1382CA98, 37353948280629144, 89869259, 89869262, 3, 640x360 
0x1382CA98, 37353948280957840, 89869290, 89869298, 8, 640x360 
0x1382CA98, 37353948281274432, 89869322, 89869325, 3, 640x360 
0x1382CA98, 37353948281604784, 89869351, 89869354, 3, 640x360 
0x1382CA98, 37353948281916208, 89869384, 89869390, 6, 640x360 
0x1382CA98, 37353948282228864, 89869421, 89869427, 6, 640x360 
0x1382CA98, 37353948282548904, 89869456, 89869461, 5, 640x360 
0x1382CA98, 37353948282868848, 89869491, 89869494, 3, 640x360 
0x1382CA98, 37353948283193488, 89869517, 89869519, 2, 640x360 
0x1382CA98, 37353948283671784, 89869559, 89869562, 3, 640x360 
0x1382CA98, 37353948283988424, 89869596, 89869602, 6, 640x360 
0x1382CA98, 37353948284312496, 89869619, 89869626, 7, 640x360 
0x1382CA98, 37353948284638056, 89869659, 89869662, 3, 640x360 
0x1382CA98, 37353948284954376, 89869688, 89869696, 8, 640x360 
0x1382CA98, 37353948285273096, 89869716, 89869719, 3, 640x360 
0x1382CA98, 37353948285601536, 89869749, 89869751, 2, 640x360 
0x1382CA98, 37353948285924832, 89869785, 89869792, 7, 640x360 
0x1382CA98, 37353948286240664, 89869813, 89869816, 3, 640x360 
0x1382CA98, 37353948286553200, 89869852, 89869864, 12, 640x360 
0x1382CA98, 37353948286869672, 89869877, 89869880, 3, 640x360 
0x1382CA98, 37353948287189752, 89869921, 89869924, 3, 640x360 
0x1382CA98, 37353948287669536, 89869966, 89869968, 2, 640x360 
0x1382CA98, 37353948287995400, 89870004, 89870014, 10, 640x360 
0x1382CA98, 37353948288326768, 89870030, 89870033, 3, 640x360 
0x1382CA98, 37353948288635016, 89870055, 89870058, 3, 640x360 
0x1382CA98, 37353948288955408, 89870088, 89870091, 3, 640x360 
0x1382CA98, 37353948289274808, 89870115, 89870119, 4, 640x360 
0x1382CA98, 37353948289598008, 89870147, 89870150, 3, 640x360 
0x1382CA98, 37353948289910744, 89870184, 89870190, 6, 640x360 
0x1382CA98, 37353948290232424, 89870215, 89870217, 2, 640x360 
0x1382CA98, 37353948290548952, 89870253, 89870260, 7, 640x360 
0x1382CA98, 37353948290869168, 89870288, 89870291, 3, 640x360 
0x1382CA98, 37353948291189200, 89870309, 89870315, 6, 640x360 
0x1382CA98, 37353948291671280, 89870360, 89870362, 2, 640x360 
0x1382CA98, 37353948291995536, 89870403, 89870406, 3, 640x360 
0x1382CA98, 37353948292324552, 89870430, 89870436, 6, 640x360 
0x1382CA98, 37353948292651120, 89870469, 89870482, 13, 640x360 
0x1382CA98, 37353948292972552, 89870494, 89870496, 2, 640x360 
0x1382CA98, 37353948293278200, 89870528, 89870530, 2, 640x360 
0x1382CA98, 37353948293594416, 89870554, 89870563, 9, 640x360 
0x1382CA98, 37353948293920360, 89870590, 89870598, 8, 640x360 
0x1382CA98, 37353948294232760, 89870616, 89870620, 4, 640x360 
0x1382CA98, 37353948294549440, 89870644, 89870646, 2, 640x360 
0x1382CA98, 37353948294868552, 89870677, 89870679, 2, 640x360 
0x1382CA98, 37353948295188768, 89870709, 89870712, 3, 640x360 
0x1382CA98, 37353948295667904, 89870774, 89870778, 4, 640x360 
0x1382CA98, 37353948296003272, 89870811, 89870815, 4, 640x360 
0x1382CA98, 37353948296320192, 89870841, 89870844, 3, 640x360 
0x1382CA98, 37353948296639560, 89870874, 89870879, 5, 640x360 
0x1382CA98, 37353948296983632, 89870907, 89870911, 4, 640x360 
0x1382CA98, 37353948297285256, 89870925, 89870936, 11, 640x360 
0x1382CA98, 37353948297593176, 89870955, 89870982, 27, 640x360 
0x1382CA98, 37353948297926752, 89871009, 89871014, 5, 640x360 
0x1382CA98, 37353948298287152, 89871036, 89871039, 3, 640x360 
0x1382CA98, 37353948298552072, 89871057, 89871060, 3, 640x360 
0x1382CA98, 37353948298875544, 89871084, 89871087, 3, 640x360 
0x1382CA98, 37353948299189248, 89871122, 89871125, 3, 640x360 
0x1382CA98, 37353948299535960, 89871162, 89871165, 3, 640x360 
0x1382CA98, 37353948299992200, 89871200, 89871203, 3, 640x360 
0x1382CA98, 37353948300308072, 89871231, 89871233, 2, 640x360 
0x1382CA98, 37353948300650984, 89871267, 89871270, 3, 640x360 
0x1382CA98, 37353948300951480, 89871287, 89871297, 10, 640x360 
0x1382CA98, 37353948301277088, 89871324, 89871333, 9, 640x360 
0x1382CA98, 37353948301593856, 89871358, 89871362, 4, 640x360 
0x1382CA98, 37353948301913160, 89871384, 89871386, 2, 640x360 
0x1382CA98, 37353948302228328, 89871414, 89871417, 3, 640x360 
0x1382CA98, 37353948302548256, 89871444, 89871446, 2, 640x360 
0x1382CA98, 37353948302868416, 89871478, 89871480, 2, 640x360 
0x1382CA98, 37353948303189496, 89871512, 89871514, 2, 640x360 
0x1382CA98, 37353948303509736, 89871544, 89871546, 2, 640x360 
0x1382CA98, 37353948303987896, 89871593, 89871605, 12, 640x360 
0x1382CA98, 37353948304308632, 89871621, 89871631, 10, 640x360 
0x1382CA98, 37353948304633272, 89871656, 89871664, 8, 640x360 
0x1382CA98, 37353948304955824, 89871684, 89871688, 4, 640x360 
0x1382CA98, 37353948305274712, 89871718, 89871724, 6, 640x360 
0x1382CA98, 37353948305594640, 89871751, 89871756, 5, 640x360 
0x1382CA98, 37353948305911408, 89871791, 89871798, 7, 640x360 
0x1382CA98, 37353948306228792, 89871815, 89871820, 5, 640x360 
0x1382CA98, 37353948306551680, 89871857, 89871859, 2, 640x360 
0x1382CA98, 37353948306873000, 89871894, 89871896, 2, 640x360 
0x1382CA98, 37353948307189752, 89871923, 89871927, 4, 640x360 
0x1382CA98, 37353948307508848, 89871956, 89871966, 10, 640x360 
0x1382CA98, 37353948307992112, 89871998, 89872006, 8, 640x360 
0x1382CA98, 37353948308323104, 89872046, 89872048, 2, 640x360 
0x1382CA98, 37353948308635360, 89872064, 89872065, 1, 640x360 
0x1382CA98, 37353948308952472, 89872089, 89872093, 4, 640x360 
0x1382CA98, 37353948309274912, 89872127, 89872130, 3, 640x360 
0x1382CA98, 37353948309609904, 89872152, 89872160, 8, 640x360 
0x1382CA98, 37353948309915096, 89872184, 89872187, 3, 640x360 
0x1382CA98, 37353948310229504, 89872217, 89872220, 3, 640x360 
0x1382CA98, 37353948310548072, 89872244, 89872246, 2, 640x360 
0x1382CA98, 37353948310871864, 89872286, 89872291, 5, 640x360 
0x1382CA98, 37353948311195120, 89872319, 89872330, 11, 640x360 
0x1382CA98, 37353948311514048, 89872350, 89872354, 4, 640x360 
0x1382CA98, 37353948311992368, 89872391, 89872398, 7, 640x360 
0x1382CA98, 37353948312309536, 89872427, 89872430, 3, 640x360 
0x1382CA98, 37353948312632744, 89872465, 89872467, 2, 640x360 
0x1382CA98, 37353948312948832, 89872492, 89872499, 7, 640x360 
0x1382CA98, 37353948313272840, 89872523, 89872529, 6, 640x360 
0x1382CA98, 37353948313594656, 89872555, 89872562, 7, 640x360 
0x1382CA98, 37353948313913128, 89872586, 89872588, 2, 640x360 
0x1382CA98, 37353948314228024, 89872618, 89872623, 5, 640x360 
0x1382CA98, 37353948314552840, 89872645, 89872648, 3, 640x360 
0x1382CA98, 37353948314868672, 89872677, 89872680, 3, 640x360 
0x1382CA98, 37353948315188968, 89872710, 89872719, 9, 640x360 
0x1382CA98, 37353948315512984, 89872743, 89872746, 3, 640x360 
0x1382CA98, 37353948315988176, 89872800, 89872802, 2, 640x360 
0x1382CA98, 37353948316307928, 89872839, 89872841, 2, 640x360 
0x1382CA98, 37353948316628512, 89872861, 89872863, 2, 640x360 
0x1382CA98, 37353948316953224, 89872883, 89872886, 3, 640x360 
0x1382CA98, 37353948317290560, 89872929, 89872938, 9, 640x360 
0x1382CA98, 37353948317594120, 89872949, 89872952, 3, 640x360 
0x1382CA98, 37353948317915400, 89872989, 89872992, 3, 640x360 
0x1382CA98, 37353948318868592, 89873078, 89873089, 11, 320x180 
0x1382CA98, 37353948319509288, 89873144, 89873146, 2, 320x180 
0x1382CA98, 37353948320308520, 89873225, 89873226, 1, 320x180 
0x1382CA98, 37353948320958408, 89873290, 89873295, 5, 320x180 
0x1382CA98, 37353948321605984, 89873352, 89873358, 6, 320x180 
0x1382CA98, 37353948322231648, 89873413, 89873415, 2, 320x180 
0x1382CA98, 37353948323508104, 89873547, 89873549, 2, 320x180 
0x1382CA98, 37353948324631368, 89873656, 89873662, 6, 320x180 
0x1382CA98, 37353948325282824, 89873729, 89873731, 2, 320x180 
0x1382CA98, 37353948325908416, 89873795, 89873798, 3, 320x180 
0x1382CA98, 37353948326547776, 89873849, 89873850, 1, 320x180 
0x1382CA98, 37353948327188848, 89873915, 89873916, 1, 320x180 
0x1382CA98, 37353948327830800, 89873981, 89873982, 1, 320x180 
0x1382CA98, 37353948328627904, 89874056, 89874058, 2, 320x180 
0x1382CA98, 37353948329274920, 89874116, 89874118, 2, 320x180 
0x1382CA98, 37353948329907656, 89874187, 89874194, 7, 320x180 
0x1382CA98, 37353948330547912, 89874243, 89874244, 1, 320x180 
0x1382CA98, 37353948331189184, 89874313, 89874314, 1, 320x180 
0x1382CA98, 37353948331828912, 89874376, 89874379, 3, 320x180 
0x1382CA98, 37353948332627728, 89874459, 89874461, 2, 320x180 
0x1382CA98, 37353948333271880, 89874516, 89874523, 7, 320x180 
0x1382CA98, 37353948333922176, 89874583, 89874586, 3, 320x180 
0x1382CA98, 37353948334552344, 89874646, 89874647, 1, 320x180 
0x1382CA98, 37353948335211848, 89874725, 89874732, 7, 320x180 
0x1382CA98, 37353948335828520, 89874776, 89874778, 2, 320x180 
0x1382CA98, 37353948336627776, 89874858, 89874860, 2, 320x180 
0x1382CA98, 37353948337272624, 89874921, 89874928, 7, 320x180 
0x1382CA98, 37353948337907264, 89874982, 89874983, 1, 320x180 
0x1382CA98, 37353948338555056, 89875049, 89875051, 2, 320x180 
0x1382CA98, 37353948339190712, 89875118, 89875120, 2, 320x180 
0x1382CA98, 37353948339828464, 89875184, 89875190, 6, 320x180 
0x1382CA98, 37353948340627664, 89875258, 89875260, 2, 320x180 
0x1382CA98, 37353948341271456, 89875318, 89875322, 4, 320x180 
0x1382CA98, 37353948341920224, 89875384, 89875388, 4, 320x180 
0x1382CA98, 37353948342554528, 89875445, 89875446, 1, 320x180 
0x1382CA98, 37353948343188392, 89875507, 89875514, 7, 320x180 
0x1382CA98, 37353948343829128, 89875580, 89875585, 5, 320x180 
0x1382CA98, 37353948344631000, 89875681, 89875693, 12, 320x180 
0x1382CA98, 37353948345274488, 89875733, 89875750, 17, 320x180 
0x1382CA98, 37353948345925408, 89875794, 89875796, 2, 320x180 
0x1382CA98, 37353948346547000, 89875856, 89875858, 2, 320x180 
0x1382CA98, 37353948347187488, 89875916, 89875917, 1, 320x180 
0x1382CA98, 37353948347827776, 89875975, 89875976, 1, 320x180 
0x1382CA98, 37353948348627048, 89876060, 89876061, 1, 320x180 
0x1382CA98, 37353948349273616, 89876121, 89876129, 8, 320x180 
0x1382CA98, 37353948349913496, 89876188, 89876190, 2, 320x180 
0x1382CA98, 37353948350549168, 89876246, 89876247, 1, 320x180 
0x1382CA98, 37353948351190856, 89876318, 89876322, 4, 320x180 
0x1382CA98, 37353948351828080, 89876378, 89876379, 1, 320x180 
0x1382CA98, 37353948352626800, 89876461, 89876463, 2, 320x180 
0x1382CA98, 37353948353271264, 89876523, 89876532, 9, 320x180 
0x1382CA98, 37353948353923608, 89876605, 89876614, 9, 320x180 
0x1382CA98, 37353948354548080, 89876650, 89876653, 3, 320x180 
0x1382CA98, 37353948355187528, 89876713, 89876714, 1, 320x180 
0x1382CA98, 37353948355835888, 89876775, 89876778, 3, 320x180 
0x1382CA98, 37353948356631488, 89876851, 89876858, 7, 320x180 
0x1382CA98, 37353948357271624, 89876925, 89876931, 6, 320x180 
0x1382CA98, 37353948357907472, 89876981, 89876982, 1, 320x180 
0x1382CA98, 37353948358547128, 89877046, 89877048, 2, 320x180 
0x1382CA98, 37353948359187424, 89877113, 89877115, 2, 320x180 
0x1382CA98, 37353948359827360, 89877178, 89877184, 6, 320x180 
0x1382CA98, 37353948360628000, 89877251, 89877256, 5, 320x180 
0x1382CA98, 37353948361272656, 89877317, 89877320, 3, 320x180 
0x1382CA98, 37353948361911840, 89877381, 89877383, 2, 320x180 
0x1382CA98, 37353948362548272, 89877444, 89877447, 3, 320x180 
0x1382CA98, 37353948363187496, 89877514, 89877515, 1, 320x180 
0x1382CA98, 37353948363835120, 89877589, 89877591, 2, 320x180 
0x1382CA98, 37353948364630040, 89877654, 89877658, 4, 320x180 
0x1382CA98, 37353948365271344, 89877725, 89877731, 6, 320x180 
0x1382CA98, 37353948365911416, 89877789, 89877791, 2, 320x180 
0x1382CA98, 37353948366549600, 89877856, 89877857, 1, 320x180 
0x1382CA98, 37353948367187072, 89877909, 89877917, 8, 320x180 
0x1382CA98, 37353948367840744, 89877976, 89877980, 4, 320x180 
0x1382CA98, 37353948368626136, 89878053, 89878054, 1, 320x180 
0x1382CA98, 37353948369270424, 89878123, 89878125, 2, 320x180 
0x1382CA98, 37353948369913432, 89878186, 89878195, 9, 320x180 
0x1382CA98, 37353948370547568, 89878249, 89878250, 1, 320x180 
0x1382CA98, 37353948371190528, 89878308, 89878314, 6, 320x180 
0x1382CA98, 37353948371827584, 89878379, 89878384, 5, 320x180 
0x1382CA98, 37353948372629104, 89878460, 89878461, 1, 320x180 
0x1382CA98, 37353948373267096, 89878516, 89878518, 2, 320x180 
0x1382CA98, 37353948373921752, 89878585, 89878596, 11, 320x180 
0x1382CA98, 37353948374547080, 89878649, 89878651, 2, 320x180 
0x1382CA98, 37353948375204320, 89878718, 89878719, 1, 320x180 
0x1382CA98, 37353948375827920, 89878775, 89878780, 5, 320x180 
0x1382CA98, 37353948376467192, 89878835, 89878841, 6, 320x180 
0x1382CA98, 37353948377266808, 89878916, 89878924, 8, 320x180 
0x1382CA98, 37353948377926744, 89878984, 89878985, 1, 320x180 
0x1382CA98, 37353948378546904, 89879045, 89879047, 2, 320x180 
0x1382CA98, 37353948379187328, 89879113, 89879115, 2, 320x180 
0x1382CA98, 37353948379827040, 89879174, 89879183, 9, 320x180 
0x1382CA98, 37353948380470824, 89879239, 89879243, 4, 320x180 
0x1382CA98, 37353948381273056, 89879327, 89879329, 2, 320x180 
0x1382CA98, 37353948381919312, 89879391, 89879400, 9, 320x180 
0x1382CA98, 37353948382550504, 89879452, 89879463, 11, 320x180 
0x1382CA98, 37353948383188144, 89879510, 89879515, 5, 320x180 
0x1382CA98, 37353948383827264, 89879586, 89879590, 4, 320x180 
0x1382CA98, 37353948384474848, 89879649, 89879651, 2, 320x180 
0x1382CA98, 37353948385270128, 89879723, 89879729, 6, 320x180 
0x1382CA98, 37353948385910336, 89879791, 89879796, 5, 320x180 
0x1382CA98, 37353948386549368, 89879851, 89879855, 4, 320x180 
0x1382CA98, 37353948387186088, 89879913, 89879914, 1, 320x180 
0x1382CA98, 37353948387830448, 89879977, 89879978, 1, 320x180 
0x1382CA98, 37353948388466920, 89880048, 89880049, 1, 320x180 
0x1382CA98, 37353948389274472, 89880115, 89880117, 2, 320x180 
0x1382CA98, 37353948389906080, 89880181, 89880182, 1, 320x180 
0x1382CA98, 37353948390546920, 89880250, 89880255, 5, 320x180 
0x1382CA98, 37353948391186584, 89880317, 89880323, 6, 320x180 
0x1382CA98, 37353948391830328, 89880391, 89880402, 11, 320x180 
0x1382CA98, 37353948392469024, 89880461, 89880464, 3, 320x180 
0x1382CA98, 37353948393278440, 89880526, 89880527, 1, 320x180 
0x1382CA98, 37353948393922840, 89880593, 89880596, 3, 320x180 
0x1382CA98, 37353948394674472, 89880670, 89880681, 11, 320x180 
0x1382CA98, 37353948395306680, 89880742, 89880753, 11, 320x180 
0x1382CA98, 37353948395827536, 89880787, 89880799, 12, 320x180 
0x1382CA98, 37353948396474056, 89880868, 89880875, 7, 320x180 
0x1382CA98, 37353948397268424, 89880932, 89880933, 1, 320x180 
0x1382CA98, 37353948397922288, 89881003, 89881013, 10, 320x180 
0x1382CA98, 37353948398588032, 89881069, 89881071, 2, 320x180 
0x1382CA98, 37353948399555848, 89881168, 89881189, 21, 320x180 
0x1382CA98, 37353948400153816, 89881232, 89881247, 15, 320x180 
0x1382CA98, 37353948400977848, 89881299, 89881307, 8, 320x180 
0x1382CA98, 37353948401593392, 89881361, 89881366, 5, 320x180 
0x1382CA98, 37353948402225312, 89881415, 89881417, 2, 320x180 
0x1382CA98, 37353948402869952, 89881482, 89881483, 1, 320x180 
0x1382CA98, 37353948403505768, 89881543, 89881550, 7, 320x180 
0x1382CA98, 37353948404146320, 89881611, 89881612, 1, 320x180 
0x1382CA98, 37353948404804720, 89881674, 89881683, 9, 320x180 
0x1382CA98, 37353948405587840, 89881757, 89881759, 2, 320x180 
0x1382CA98, 37353948406225952, 89881823, 89881825, 2, 320x180 
0x1382CA98, 37353948406883848, 89881886, 89881890, 4, 320x180 
0x1382CA98, 37353948407515816, 89881946, 89881951, 5, 320x180 
0x1382CA98, 37353948408151048, 89882009, 89882011, 2, 320x180 
0x1382CA98, 37353948408786672, 89882074, 89882076, 2, 320x180 
0x1382CA98, 37353948409591056, 89882150, 89882153, 3, 320x180 
0x1382CA98, 37353948410229008, 89882215, 89882217, 2, 320x180 
0x1382CA98, 37353948410868888, 89882282, 89882283, 1, 320x180 
0x1382CA98, 37353948411509040, 89882343, 89882352, 9, 320x180 
0x1382CA98, 37353948412158544, 89882418, 89882422, 4, 320x180 
0x1382CA98, 37353948412785960, 89882471, 89882476, 5, 320x180 
0x1382CA98, 37353948413595536, 89882556, 89882558, 2, 320x180 
0x1382CA98, 37353948414230320, 89882625, 89882626, 1, 320x180 
0x1382CA98, 37353948414865200, 89882678, 89882684, 6, 320x180 
0x1382CA98, 37353948415511632, 89882760, 89882762, 2, 320x180 
0x1382CA98, 37353948416145912, 89882812, 89882814, 2, 320x180 
0x1382CA98, 37353948416785856, 89882880, 89882883, 3, 320x180 
0x1382CA98, 37353948417618312, 89882961, 89882966, 5, 320x180 
0x1382CA98, 37353948418225488, 89883027, 89883050, 23, 320x180 
0x1382CA98, 37353948418867392, 89883111, 89883117, 6, 320x180 
0x1382CA98, 37353948419513320, 89883150, 89883151, 1, 320x180 
0x1382CA98, 37353948420149552, 89883213, 89883214, 1, 320x180 
0x1382CA98, 37353948420785440, 89883284, 89883286, 2, 320x180 
0x1382CA98, 37353948421592688, 89883360, 89883365, 5, 320x180 
0x1382CA98, 37353948422228728, 89883419, 89883423, 4, 320x180 
0x1382CA98, 37353948422870920, 89883481, 89883484, 3, 320x180 
0x1382CA98, 37353948423511240, 89883545, 89883547, 2, 320x180 
0x1382CA98, 37353948424153312, 89883611, 89883616, 5, 320x180 
0x1382CA98, 37353948424814976, 89883681, 89883682, 1, 320x180 
0x1382CA98, 37353948425603968, 89883749, 89883751, 2, 320x180 
0x1382CA98, 37353948426224768, 89883813, 89883815, 2, 320x180 
0x1382CA98, 37353948426864968, 89883894, 89883895, 1, 320x180 
0x1382CA98, 37353948427508752, 89883955, 89883964, 9, 320x180 
0x1382CA98, 37353948428153272, 89884018, 89884023, 5, 320x180 
0x1382CA98, 37353948428788968, 89884073, 89884080, 7, 320x180 
0x1382CA98, 37353948429588312, 89884157, 89884164, 7, 320x180 
0x1382CA98, 37353948430225680, 89884224, 89884231, 7, 320x180 
0x1382CA98, 37353948430867200, 89884294, 89884302, 8, 320x180 
0x1382CA98, 37353948431505040, 89884355, 89884365, 10, 320x180 
0x1382CA98, 37353948432151704, 89884412, 89884413, 1, 320x180 
0x1382CA98, 37353948432793016, 89884470, 89884481, 11, 320x180 
0x1382CA98, 37353948433584944, 89884553, 89884562, 9, 320x180 
0x1382CA98, 37353948434228776, 89884615, 89884617, 2, 320x180 
0x1382CA98, 37353948434869472, 89884679, 89884681, 2, 320x180 
0x1382CA98, 37353948435505424, 89884756, 89884758, 2, 320x180 
0x1382CA98, 37353948436148192, 89884818, 89884823, 5, 320x180 
0x1382CA98, 37353948436785008, 89884877, 89884884, 7, 320x180 
0x1382CA98, 37353948437590304, 89884956, 89884963, 7, 320x180 
0x1382CA98, 37353948438231768, 89885018, 89885019, 1, 320x180 
0x1382CA98, 37353948438868184, 89885081, 89885084, 3, 320x180 
0x1382CA98, 37353948439505472, 89885149, 89885151, 2, 320x180 
0x1382CA98, 37353948440145336, 89885206, 89885209, 3, 320x180 
0x1382CA98, 37353948440788120, 89885287, 89885291, 4, 320x180 
0x1382CA98, 37353948441589152, 89885357, 89885364, 7, 320x180 
0x1382CA98, 37353948442231792, 89885413, 89885414, 1, 320x180 
0x1382CA98, 37353948442867528, 89885481, 89885492, 11, 320x180 
0x1382CA98, 37353948443506240, 89885548, 89885549, 1, 320x180 
0x1382CA98, 37353948444150400, 89885617, 89885618, 1, 320x180 
0x1382CA98, 37353948444785224, 89885677, 89885679, 2, 320x180 
0x1382CA98, 37353948445586448, 89885748, 89885750, 2, 320x180 
0x1382CA98, 37353948446225072, 89885817, 89885824, 7, 320x180 
0x1382CA98, 37353948446868136, 89885889, 89885893, 4, 320x180 
0x1382CA98, 37353948447510912, 89885941, 89885943, 2, 320x180 
0x1382CA98, 37353948448148296, 89886005, 89886008, 3, 320x180 
0x1382CA98, 37353948448784456, 89886067, 89886069, 2, 320x180 
0x1382CA98, 37353948449587480, 89886152, 89886156, 4, 320x180 
0x1382CA98, 37353948450224480, 89886215, 89886217, 2, 320x180 
0x1382CA98, 37353948450868576, 89886281, 89886282, 1, 320x180 
0x1382CA98, 37353948451508832, 89886344, 89886347, 3, 320x180 
0x1382CA98, 37353948452145872, 89886415, 89886422, 7, 320x180 
0x1382CA98, 37353948452800272, 89886471, 89886482, 11, 320x180 
0x1382CA98, 37353948453594256, 89886561, 89886562, 1, 320x180 
0x1382CA98, 37353948454224680, 89886624, 89886626, 2, 320x180 
0x1382CA98, 37353948454869256, 89886690, 89886692, 2, 320x180 
0x1382CA98, 37353948455505296, 89886760, 89886761, 1, 320x180 
0x1382CA98, 37353948456151056, 89886817, 89886821, 4, 320x180 
0x1382CA98, 37353948456790600, 89886883, 89886884, 1, 320x180 
0x1382CA98, 37353948457620880, 89886953, 89886962, 9, 320x180 
0x1382CA98, 37353948458223736, 89887015, 89887016, 1, 320x180 
0x1382CA98, 37353948458864304, 89887091, 89887099, 8, 320x180 
0x1382CA98, 37353948459512264, 89887143, 89887150, 7, 320x180 
0x1382CA98, 37353948460144720, 89887204, 89887206, 2, 320x180 
0x1382CA98, 37353948460787568, 89887273, 89887279, 6, 320x180 
0x1382CA98, 37353948461433104, 89887334, 89887346, 12, 320x180 
0x1382CA98, 37353948462229408, 89887428, 89887429, 1, 320x180 
0x1382CA98, 37353948462865040, 89887486, 89887490, 4, 320x180 
0x1382CA98, 37353948463506112, 89887544, 89887546, 2, 320x180 
0x1382CA98, 37353948464159160, 89887611, 89887612, 1, 320x180 
0x1382CA98, 37353948464829496, 89887682, 89887684, 2, 320x180 
0x1382CA98, 37353948465431992, 89887734, 89887736, 2, 320x180 
0x1382CA98, 37353948466224584, 89887825, 89887826, 1, 320x180 
0x1382CA98, 37353948466868128, 89887882, 89887883, 1, 320x180 
0x1382CA98, 37353948467508128, 89887941, 89887944, 3, 320x180 
0x1382CA98, 37353948468150216, 89888014, 89888016, 2, 320x180 
0x1382CA98, 37353948468808016, 89888079, 89888080, 1, 320x180 
0x1382CA98, 37353948469425656, 89888156, 89888157, 1, 320x180 
0x1382CA98, 37353948470228392, 89888227, 89888229, 2, 320x180 
0x1382CA98, 37353948470864128, 89888285, 89888289, 4, 320x180 
0x1382CA98, 37353948471508288, 89888357, 89888364, 7, 320x180 
0x1382CA98, 37353948472145904, 89888414, 89888415, 1, 320x180 
0x1382CA98, 37353948472787176, 89888471, 89888473, 2, 320x180 
0x1382CA98, 37353948473443112, 89888533, 89888535, 2, 320x180 
0x1382CA98, 37353948474227680, 89888618, 89888619, 1, 320x180 
0x1382CA98, 37353948474864160, 89888677, 89888681, 4, 320x180 
0x1382CA98, 37353948475508736, 89888744, 89888749, 5, 320x180 
0x1382CA98, 37353948476144648, 89888803, 89888805, 2, 320x180 
0x1382CA98, 37353948476785232, 89888871, 89888879, 8, 320x180 
0x1382CA98, 37353948477430632, 89888954, 89888964, 10, 320x180 
0x1382CA98, 37353948478228488, 89889015, 89889017, 2, 320x180 
0x1382CA98, 37353948478868688, 89889089, 89889097, 8, 320x180 
0x1382CA98, 37353948479507216, 89889143, 89889146, 3, 320x180 
0x1382CA98, 37353948480149928, 89889216, 89889218, 2, 320x180 
0x1382CA98, 37353948480784328, 89889274, 89889282, 8, 320x180 
0x1382CA98, 37353948481439880, 89889340, 89889342, 2, 320x180 
0x1382CA98, 37353948482225840, 89889442, 89889444, 2, 320x180 
0x1382CA98, 37353948482864048, 89889489, 89889491, 2, 320x180 
0x1382CA98, 37353948483508488, 89889544, 89889550, 6, 320x180 
0x1382CA98, 37353948484145176, 89889615, 89889616, 1, 320x180 
0x1382CA98, 37353948484785640, 89889684, 89889686, 2, 320x180 
0x1382CA98, 37353948485436856, 89889751, 89889759, 8, 320x180 
0x1382CA98, 37353948486228440, 89889823, 89889825, 2, 320x180 
0x1382CA98, 37353948486867760, 89889885, 89889887, 2, 320x180 
0x1382CA98, 37353948487511232, 89889945, 89889947, 2, 320x180 
0x1382CA98, 37353948488143776, 89890010, 89890012, 2, 320x180 
0x1382CA98, 37353948488785800, 89890076, 89890078, 2, 320x180 
0x1382CA98, 37353948489440768, 89890149, 89890157, 8, 320x180 
0x1382CA98, 37353948490222736, 89890222, 89890224, 2, 320x180 
0x1382CA98, 37353948490878216, 89890285, 89890289, 4, 320x180 
0x1382CA98, 37353948491507400, 89890346, 89890353, 7, 320x180 
0x1382CA98, 37353948492153024, 89890412, 89890418, 6, 320x180 
0x1382CA98, 37353948492788112, 89890485, 89890501, 16, 320x180 
0x1382CA98, 37353948493447136, 89890551, 89890555, 4, 320x180 
0x1382CA98, 37353948494222608, 89890618, 89890623, 5, 320x180 
0x1382CA98, 37353948494867960, 89890683, 89890684, 1, 320x180 
0x1382CA98, 37353948495504472, 89890744, 89890747, 3, 320x180 
0x1382CA98, 37353948496148480, 89890811, 89890813, 2, 320x180 
0x1382CA98, 37353948496787096, 89890878, 89890880, 2, 320x180 
0x1382CA98, 37353948497436536, 89890941, 89890943, 2, 320x180 
0x1382CA98, 37353948498223360, 89891022, 89891023, 1, 320x180 
0x1382CA98, 37353948498873400, 89891086, 89891089, 3, 320x180 
0x1382CA98, 37353948499503392, 89891150, 89891151, 1, 320x180 
0x1382CA98, 37353948500146400, 89891209, 89891217, 8, 320x180 
0x1382CA98, 37353948500788832, 89891281, 89891282, 1, 320x180 
0x1382CA98, 37353948501426128, 89891344, 89891345, 1, 320x180 
0x1382CA98, 37353948502222864, 89891424, 89891426, 2, 320x180 
0x1382CA98, 37353948502866472, 89891478, 89891482, 4, 320x180 
0x1382CA98, 37353948503507192, 89891541, 89891543, 2, 320x180 
0x1382CA98, 37353948504143640, 89891604, 89891606, 2, 320x180 
0x1382CA98, 37353948504783664, 89891672, 89891674, 2, 320x180 
0x1382CA98, 37353948505433008, 89891732, 89891733, 1, 320x180 
0x1382CA98, 37353948506226800, 89891814, 89891816, 2, 320x180 
0x1382CA98, 37353948506863712, 89891876, 89891881, 5, 320x180 
0x1382CA98, 37353948507503872, 89891945, 89891950, 5, 320x180 
0x1382CA98, 37353948508143912, 89892009, 89892026, 17, 320x180 
0x1382CA98, 37353948508785664, 89892083, 89892084, 1, 320x180 
0x1382CA98, 37353948509513528, 89892145, 89892146, 1, 320x180 
0x1382CA98, 37353948510222784, 89892218, 89892223, 5, 320x180 
0x1382CA98, 37353948510863336, 89892288, 89892295, 7, 320x180 
0x1382CA98, 37353948511507536, 89892344, 89892351, 7, 320x180 
0x1382CA98, 37353948512146960, 89892410, 89892414, 4, 320x180 
0x1382CA98, 37353948512793992, 89892473, 89892485, 12, 320x180 
0x1382CA98, 37353948513423352, 89892534, 89892535, 1, 320x180 
0x1382CA98, 37353948514063200, 89892607, 89892615, 8, 320x180 
0x1382CA98, 37353948514863456, 89892682, 89892683, 1, 320x180 
0x1382CA98, 37353948515503184, 89892752, 89892764, 12, 320x180 
0x1382CA98, 37353948516169688, 89892809, 89892811, 2, 320x180 
0x1382CA98, 37353948516805120, 89892884, 89892899, 15, 320x180 
0x1382CA98, 37353948517451288, 89892948, 89892949, 1, 320x180 
0x1382CA98, 37353948518064504, 89893018, 89893022, 4, 320x180 
0x1382CA98, 37353948518878216, 89893101, 89893105, 4, 320x180 
0x1382CA98, 37353948519517056, 89893170, 89893183, 13, 320x180 
0x1382CA98, 37353948520149240, 89893228, 89893231, 3, 320x180 
0x1382CA98, 37353948520804304, 89893293, 89893297, 4, 320x180 
0x1382CA98, 37353948521436312, 89893343, 89893344, 1, 320x180 
0x1382CA98, 37353948522062920, 89893402, 89893411, 9, 320x180 
0x1382CA98, 37353948522868048, 89893483, 89893484, 1, 320x180 
0x1382CA98, 37353948523512552, 89893544, 89893546, 2, 320x180 
0x1382CA98, 37353948524148320, 89893617, 89893618, 1, 320x180 
0x1382CA98, 37353948524787704, 89893673, 89893682, 9, 320x180 
0x1382CA98, 37353948525431728, 89893733, 89893740, 7, 320x180 
0x1382CA98, 37353948526062872, 89893799, 89893801, 2, 320x180 
0x1382CA98, 37353948526862752, 89893878, 89893880, 2, 320x180 
0x1382CA98, 37353948527502384, 89893949, 89893951, 2, 320x180 
0x1382CA98, 37353948528147552, 89894007, 89894014, 7, 320x180 
0x1382CA98, 37353948528783896, 89894076, 89894079, 3, 320x180 
0x1382CA98, 37353948529429080, 89894138, 89894145, 7, 320x180 
0x1382CA98, 37353948530062560, 89894200, 89894201, 1, 320x180 
0x1382CA98, 37353948530862920, 89894288, 89894290, 2, 320x180 
0x1382CA98, 37353948531512496, 89894346, 89894347, 1, 320x180 
0x1382CA98, 37353948532142376, 89894419, 89894423, 4, 320x180 
0x1382CA98, 37353948532783336, 89894471, 89894482, 11, 320x180 
0x1382CA98, 37353948533429200, 89894539, 89894546, 7, 320x180 
0x1382CA98, 37353948534063400, 89894596, 89894598, 2, 320x180 
0x1382CA98, 37353948534869832, 89894682, 89894683, 1, 320x180 
0x1382CA98, 37353948535502432, 89894744, 89894745, 1, 320x180 
0x1382CA98, 37353948536146320, 89894806, 89894809, 3, 320x180 
0x1382CA98, 37353948536782952, 89894873, 89894876, 3, 320x180 
0x1382CA98, 37353948537428272, 89894938, 89894941, 3, 320x180 
0x1382CA98, 37353948538062560, 89895008, 89895009, 1, 320x180 
0x1382CA98, 37353948538862776, 89895078, 89895079, 1, 320x180 
0x1382CA98, 37353948539503760, 89895145, 89895148, 3, 320x180 
0x1382CA98, 37353948540146376, 89895208, 89895210, 2, 320x180 
0x1382CA98, 37353948540782648, 89895267, 89895269, 2, 320x180 
0x1382CA98, 37353948541424320, 89895338, 89895340, 2, 320x180 
0x1382CA98, 37353948542063216, 89895406, 89895409, 3, 320x180 
0x1382CA98, 37353948542862664, 89895484, 89895488, 4, 320x180 
0x1382CA98, 37353948543501936, 89895549, 89895551, 2, 320x180 
0x1382CA98, 37353948544149592, 89895616, 89895618, 2, 320x180 
0x1382CA98, 37353948544787600, 89895677, 89895678, 1, 320x180 
0x1382CA98, 37353948545428008, 89895739, 89895741, 2, 320x180 
0x1382CA98, 37353948546062520, 89895810, 89895812, 2, 320x180 
0x1382CA98, 37353948546864536, 89895879, 89895884, 5, 320x180 
0x1382CA98, 37353948547850856, 89895976, 89895989, 13, 640x360 
0x1382CA98, 37353948548181592, 89896026, 89896047, 21, 640x360 
0x1382CA98, 37353948548469464, 89896062, 89896066, 4, 640x360 
0x1382CA98, 37353948548790952, 89896089, 89896097, 8, 640x360 
0x1382CA98, 37353948549122696, 89896115, 89896117, 2, 640x360 
0x1382CA98, 37353948549427032, 89896144, 89896146, 2, 640x360 
0x1382CA98, 37353948549744176, 89896176, 89896179, 3, 640x360 
0x1382CA98, 37353948550061920, 89896203, 89896207, 4, 640x360 
0x1382CA98, 37353948550385808, 89896238, 89896242, 4, 640x360 
0x1382CA98, 37353948550861888, 89896286, 89896290, 4, 640x360 
0x1382CA98, 37353948551182016, 89896310, 89896320, 10, 640x360 
0x1382CA98, 37353948551506704, 89896345, 89896351, 6, 640x360 
0x1382CA98, 37353948551822128, 89896371, 89896375, 4, 640x360 
0x1382CA98, 37353948552146120, 89896411, 89896413, 2, 640x360 
0x1382CA98, 37353948552462288, 89896437, 89896446, 9, 640x360 
0x1382CA98, 37353948552785568, 89896469, 89896480, 11, 640x360 
0x1382CA98, 37353948553104816, 89896507, 89896516, 9, 640x360 
0x1382CA98, 37353948553437576, 89896540, 89896549, 9, 640x360 
0x1382CA98, 37353948553742880, 89896575, 89896577, 2, 640x360 
0x1382CA98, 37353948554067032, 89896599, 89896603, 4, 640x360 
0x1382CA98, 37353948554385992, 89896639, 89896642, 3, 640x360 
0x1382CA98, 37353948554861416, 89896677, 89896681, 4, 640x360 
0x1382CA98, 37353948555185176, 89896714, 89896716, 2, 640x360 
0x1382CA98, 37353948555505456, 89896743, 89896756, 13, 640x360 
0x1382CA98, 37353948555844392, 89896782, 89896788, 6, 640x360 
0x1382CA98, 37353948556141504, 89896811, 89896813, 2, 640x360 
0x1382CA98, 37353948556467520, 89896852, 89896858, 6, 640x360 
0x1382CA98, 37353948556784784, 89896887, 89896892, 5, 640x360 
0x1382CA98, 37353948557116584, 89896924, 89896927, 3, 640x360 
0x1382CA98, 37353948557437552, 89896944, 89896956, 12, 640x360 
0x1382CA98, 37353948557746944, 89896980, 89896982, 2, 640x360 
0x1382CA98, 37353948558061496, 89897012, 89897022, 10, 640x360 
0x1382CA98, 37353948558382520, 89897032, 89897036, 4, 640x360 
0x1382CA98, 37353948558861192, 89897078, 89897087, 9, 640x360 
0x1382CA98, 37353948559184416, 89897108, 89897111, 3, 640x360 
0x1382CA98, 37353948559505736, 89897164, 89897167, 3, 640x360 
0x1382CA98, 37353948559864608, 89897184, 89897199, 15, 640x360 
0x1382CA98, 37353948560155768, 89897216, 89897217, 1, 640x360 
0x1382CA98, 37353948560474432, 89897250, 89897252, 2, 640x360 
0x1382CA98, 37353948560807744, 89897278, 89897280, 2, 640x360 
0x1382CA98, 37353948561111232, 89897301, 89897305, 4, 640x360 
0x1382CA98, 37353948561425576, 89897339, 89897346, 7, 640x360 
0x1382CA98, 37353948561744864, 89897374, 89897375, 1, 640x360 
0x1382CA98, 37353948562065416, 89897398, 89897400, 2, 640x360 
0x1382CA98, 37353948562389528, 89897438, 89897441, 3, 640x360 
0x1382CA98, 37353948562865208, 89897485, 89897491, 6, 640x360 
0x1382CA98, 37353948563184824, 89897512, 89897514, 2, 640x360 
0x1382CA98, 37353948563516744, 89897550, 89897553, 3, 640x360 
0x1382CA98, 37353948563823280, 89897578, 89897582, 4, 640x360 
0x1382CA98, 37353948564141664, 89897609, 89897616, 7, 640x360 
0x1382CA98, 37353948564461408, 89897646, 89897648, 2, 640x360 
0x1382CA98, 37353948564786808, 89897683, 89897686, 3, 640x360 
0x1382CA98, 37353948565125312, 89897711, 89897716, 5, 640x360 
0x1382CA98, 37353948565424496, 89897740, 89897747, 7, 640x360 
0x1382CA98, 37353948565742328, 89897772, 89897775, 3, 640x360 
0x1382CA98, 37353948566065856, 89897798, 89897800, 2, 640x360 
0x1382CA98, 37353948566385632, 89897840, 89897842, 2, 640x360 
0x1382CA98, 37353948566702640, 89897864, 89897866, 2, 640x360 
0x1382CA98, 37353948567186776, 89897917, 89897924, 7, 640x360 
0x1382CA98, 37353948567501008, 89897944, 89897946, 2, 640x360 
0x1382CA98, 37353948567831904, 89897976, 89897985, 9, 640x360 
0x1382CA98, 37353948568142168, 89898009, 89898011, 2, 640x360 
0x1382CA98, 37353948568462000, 89898041, 89898043, 2, 640x360 
0x1382CA98, 37353948568781416, 89898065, 89898067, 2, 640x360 
0x1382CA98, 37353948569102464, 89898096, 89898099, 3, 640x360 
0x1382CA98, 37353948569426144, 89898132, 89898135, 3, 640x360 
0x1382CA98, 37353948569743624, 89898163, 89898165, 2, 640x360 
0x1382CA98, 37353948570061808, 89898200, 89898202, 2, 640x360 
0x1382CA98, 37353948570397496, 89898238, 89898240, 2, 640x360 
0x1382CA98, 37353948570702680, 89898258, 89898260, 2, 640x360 
0x1382CA98, 37353948571182024, 89898309, 89898315, 6, 640x360 
0x1382CA98, 37353948571502352, 89898351, 89898357, 6, 640x360 
0x1382CA98, 37353948571821776, 89898375, 89898379, 4, 640x360 
0x1382CA98, 37353948572144608, 89898417, 89898420, 3, 640x360 
0x1382CA98, 37353948572462800, 89898440, 89898446, 6, 640x360 
0x1382CA98, 37353948572788184, 89898473, 89898476, 3, 640x360 
0x1382CA98, 37353948573126304, 89898504, 89898508, 4, 640x360 
0x1382CA98, 37353948573449288, 89898535, 89898538, 3, 640x360 
0x1382CA98, 37353948573747744, 89898568, 89898571, 3, 640x360 
0x1382CA98, 37353948574067984, 89898607, 89898611, 4, 640x360 
0x1382CA98, 37353948574381576, 89898639, 89898645, 6, 640x360 
0x1382CA98, 37353948574706368, 89898666, 89898668, 2, 640x360 
0x1382CA98, 37353948575183072, 89898709, 89898716, 7, 640x360 
0x1382CA98, 37353948575501656, 89898745, 89898747, 2, 640x360 
0x1382CA98, 37353948575830616, 89898783, 89898786, 3, 640x360 
0x1382CA98, 37353948576146768, 89898811, 89898819, 8, 640x360 
0x1382CA98, 37353948576461528, 89898841, 89898843, 2, 640x360 
0x1382CA98, 37353948576787304, 89898866, 89898869, 3, 640x360 
0x1382CA98, 37353948577106592, 89898907, 89898911, 4, 640x360 
0x1382CA98, 37353948577424928, 89898943, 89898946, 3, 640x360 
0x1382CA98, 37353948577741496, 89898967, 89898971, 4, 640x360 
0x1382CA98, 37353948578064680, 89899005, 89899008, 3, 640x360 
0x1382CA98, 37353948578384504, 89899032, 89899036, 4, 640x360 
0x1382CA98, 37353948578701544, 89899061, 89899067, 6, 640x360 
0x1382CA98, 37353948579181136, 89899114, 89899117, 3, 640x360 
0x1382CA98, 37353948579505664, 89899146, 89899152, 6, 640x360 
0x1382CA98, 37353948579824704, 89899179, 89899181, 2, 640x360 
0x1382CA98, 37353948580142096, 89899210, 89899216, 6, 640x360 
0x1382CA98, 37353948580462576, 89899257, 89899260, 3, 640x360 
0x1382CA98, 37353948580797392, 89899278, 89899280, 2, 640x360 
0x1382CA98, 37353948581110736, 89899306, 89899309, 3, 640x360 
0x1382CA98, 37353948581424664, 89899346, 89899348, 2, 640x360 
0x1382CA98, 37353948581740888, 89899384, 89899391, 7, 640x360 
0x1382CA98, 37353948582062808, 89899407, 89899414, 7, 640x360 
0x1382CA98, 37353948582386376, 89899434, 89899437, 3, 640x360 
0x1382CA98, 37353948582702840, 89899463, 89899466, 3, 640x360 
0x1382CA98, 37353948583184816, 89899517, 89899521, 4, 640x360 
0x1382CA98, 37353948583506264, 89899546, 89899548, 2, 640x360 
0x1382CA98, 37353948583821312, 89899585, 89899590, 5, 640x360 
0x1382CA98, 37353948584144448, 89899608, 89899612, 4, 640x360 
0x1382CA98, 37353948584460648, 89899640, 89899644, 4, 640x360 
0x1382CA98, 37353948584780944, 89899673, 89899676, 3, 640x360 
0x1382CA98, 37353948585101232, 89899706, 89899709, 3, 640x360 
0x1382CA98, 37353948585422456, 89899733, 89899736, 3, 640x360 
0x1382CA98, 37353948585746872, 89899772, 89899774, 2, 640x360 
0x1382CA98, 37353948586064872, 89899796, 89899799, 3, 640x360 
0x1382CA98, 37353948586381064, 89899827, 89899829, 2, 640x360 
0x1382CA98, 37353948586721880, 89899869, 89899872, 3, 640x360 
0x1382CA98, 37353948587182592, 89899916, 89899922, 6, 640x360 
0x1382CA98, 37353948587501208, 89899952, 89899955, 3, 640x360 
0x1382CA98, 37353948587821336, 89899974, 89899978, 4, 640x360 
0x1382CA98, 37353948588141408, 89900012, 89900014, 2, 640x360 
0x1382CA98, 37353948588460760, 89900038, 89900044, 6, 640x360 
0x1382CA98, 37353948588780800, 89900073, 89900082, 9, 640x360 
0x1382CA98, 37353948589108368, 89900101, 89900104, 3, 640x360 
0x1382CA98, 37353948589432072, 89900141, 89900149, 8, 640x360 
0x1382CA98, 37353948589776808, 89900178, 89900184, 6, 640x360 
0x1382CA98, 37353948590060808, 89900202, 89900206, 4, 640x360 
0x1382CA98, 37353948590380920, 89900229, 89900231, 2, 640x360 
0x1382CA98, 37353948590700904, 89900262, 89900266, 4, 640x360 
0x1382CA98, 37353948591184488, 89900319, 89900323, 4, 640x360 
0x1382CA98, 37353948591509768, 89900344, 89900346, 2, 640x360 
0x1382CA98, 37353948591820520, 89900377, 89900387, 10, 640x360 
0x1382CA98, 37353948592141176, 89900408, 89900412, 4, 640x360 
0x1382CA98, 37353948592461152, 89900435, 89900438, 3, 640x360 
0x1382CA98, 37353948592781016, 89900478, 89900484, 6, 640x360 
0x1382CA98, 37353948593110128, 89900505, 89900510, 5, 640x360 
0x1382CA98, 37353948593425032, 89900536, 89900543, 7, 640x360 
0x1382CA98, 37353948593792168, 89900577, 89900579, 2, 640x360 
0x1382CA98, 37353948594061128, 89900599, 89900602, 3, 640x360 
0x1382CA98, 37353948594390160, 89900635, 89900637, 2, 640x360 
0x1382CA98, 37353948594706432, 89900668, 89900671, 3, 640x360 
0x1382CA98, 37353948595021888, 89900692, 89900698, 6, 640x360 
0x1382CA98, 37353948595501056, 89900741, 89900745, 4, 640x360 
0x1382CA98, 37353948595825872, 89900779, 89900782, 3, 640x360 
0x1382CA98, 37353948596145320, 89900811, 89900814, 3, 640x360 
0x1382CA98, 37353948596461008, 89900842, 89900845, 3, 640x360 
0x1382CA98, 37353948596785888, 89900875, 89900879, 4, 640x360 
0x1382CA98, 37353948597107432, 89900909, 89900911, 2, 640x360 
0x1382CA98, 37353948597426776, 89900946, 89900949, 3, 640x360 
0x1382CA98, 37353948597741000, 89900978, 89900981, 3, 640x360 
0x1382CA98, 37353948598060568, 89901016, 89901023, 7, 640x360 
0x1382CA98, 37353948598385320, 89901045, 89901049, 4, 640x360 
0x1382CA98, 37353948598701832, 89901078, 89901095, 17, 640x360 
0x1382CA98, 37353948599026936, 89901101, 89901113, 12, 640x360 
0x1382CA98, 37353948599529904, 89901191, 89901231, 40, 640x360 
0x1382CA98, 37353948600165856, 89901247, 89901267, 20, 640x360 
0x1382CA98, 37353948600535224, 89901268, 89901279, 11, 640x360 
0x1382CA98, 37353948600796200, 89901307, 89901316, 9, 640x360 
0x1382CA98, 37353948601139216, 89901331, 89901336, 5, 640x360 
0x1382CA98, 37353948601441136, 89901365, 89901378, 13, 640x360 
0x1382CA98, 37353948601822040, 89901382, 89901393, 11, 640x360 
0x1382CA98, 37353948602065416, 89901409, 89901418, 9, 640x360 
0x1382CA98, 37353948602386352, 89901434, 89901436, 2, 640x360 
0x1382CA98, 37353948602700528, 89901461, 89901463, 2, 640x360 
0x1382CA98, 37353948603025488, 89901497, 89901499, 2, 640x360 
0x1382CA98, 37353948603500952, 89901543, 89901549, 6, 640x360 
0x1382CA98, 37353948603824304, 89901576, 89901578, 2, 640x360 
0x1382CA98, 37353948604142392, 89901604, 89901607, 3, 640x360 
0x1382CA98, 37353948604465096, 89901635, 89901639, 4, 640x360 
0x1382CA98, 37353948604780416, 89901682, 89901684, 2, 640x360 
0x1382CA98, 37353948605123096, 89901700, 89901704, 4, 640x360 
0x1382CA98, 37353948605438640, 89901741, 89901743, 2, 640x360 
0x1382CA98, 37353948605763384, 89901769, 89901781, 12, 640x360 
0x1382CA98, 37353948606061352, 89901796, 89901798, 2, 640x360 
0x1382CA98, 37353948606381280, 89901835, 89901841, 6, 640x360 
0x1382CA98, 37353948606700584, 89901867, 89901871, 4, 640x360 
0x1382CA98, 37353948607024856, 89901894, 89901898, 4, 640x360 
0x1382CA98, 37353948607500504, 89901941, 89901943, 2, 640x360 
0x1382CA98, 37353948607820632, 89901978, 89901980, 2, 640x360 
0x1382CA98, 37353948608140688, 89902004, 89902007, 3, 640x360 
0x1382CA98, 37353948608461080, 89902035, 89902041, 6, 640x360 
0x1382CA98, 37353948608780856, 89902068, 89902080, 12, 640x360 
0x1382CA98, 37353948609107632, 89902100, 89902105, 5, 640x360 
0x1382CA98, 37353948609422856, 89902139, 89902145, 6, 640x360 
0x1382CA98, 37353948609744920, 89902166, 89902168, 2, 640x360 
0x1382CA98, 37353948610061184, 89902197, 89902200, 3, 640x360 
0x1382CA98, 37353948610388464, 89902233, 89902235, 2, 640x360 
0x1382CA98, 37353948610715120, 89902264, 89902267, 3, 640x360 
0x1382CA98, 37353948611027960, 89902296, 89902302, 6, 640x360 
0x1382CA98, 37353948611504912, 89902344, 89902350, 6, 640x360 
0x1382CA98, 37353948611820496, 89902376, 89902386, 10, 640x360 
0x1382CA98, 37353948612140528, 89902405, 89902413, 8, 640x360 
0x1382CA98, 37353948612462856, 89902445, 89902466, 21, 640x360 
0x1382CA98, 37353948612831240, 89902486, 89902514, 28, 640x360 
0x1382CA98, 37353948613124376, 89902530, 89902532, 2, 640x360 
0x1382CA98, 37353948613449400, 89902553, 89902561, 8, 640x360 
0x1382CA98, 37353948613789232, 89902586, 89902593, 7, 640x360 
0x1382CA98, 37353948614060504, 89902622, 89902625, 3, 640x360 
0x1382CA98, 37353948614384464, 89902646, 89902649, 3, 640x360 
0x1382CA98, 37353948614701056, 89902667, 89902673, 6, 640x360 
0x1382CA98, 37353948615045448, 89902700, 89902702, 2, 640x360 
0x1382CA98, 37353948615499512, 89902751, 89902752, 1, 640x360 
0x1382CA98, 37353948615831192, 89902783, 89902786, 3, 640x360 
0x1382CA98, 37353948616150128, 89902823, 89902832, 9, 640x360 
0x1382CA98, 37353948616469160, 89902850, 89902852, 2, 640x360 
0x1382CA98, 37353948616791432, 89902881, 89902883, 2, 640x360 
0x1382CA98, 37353948617105640, 89902907, 89902914, 7, 640x360 
0x1382CA98, 37353948617433800, 89902943, 89902946, 3, 640x360 
0x1382CA98, 37353948617745120, 89902965, 89902967, 2, 640x360 
0x1382CA98, 37353948618060184, 89903005, 89903015, 10, 640x360 
0x1382CA98, 37353948618382216, 89903031, 89903035, 4, 640x360 
0x1382CA98, 37353948618703416, 89903068, 89903070, 2, 640x360 
0x1382CA98, 37353948619027472, 89903096, 89903099, 3, 640x360 
0x1382CA98, 37353948619527232, 89903146, 89903152, 6, 640x360 
0x1382CA98, 37353948619835784, 89903178, 89903180, 2, 640x360 
0x1382CA98, 37353948620141560, 89903210, 89903216, 6, 640x360 
0x1382CA98, 37353948620464176, 89903239, 89903241, 2, 640x360 
0x1382CA98, 37353948620783896, 89903271, 89903275, 4, 640x360 
0x1382CA98, 37353948621100168, 89903299, 89903301, 2, 640x360 
0x1382CA98, 37353948621424936, 89903334, 89903338, 4, 640x360 
0x1382CA98, 37353948621745552, 89903367, 89903372, 5, 640x360 
0x1382CA98, 37353948622064752, 89903398, 89903401, 3, 640x360 
0x1382CA98, 37353948622395856, 89903440, 89903442, 2, 640x360 
0x1382CA98, 37353948622700912, 89903461, 89903465, 4, 640x360 
0x1382CA98, 37353948623021424, 89903494, 89903496, 2, 640x360 
0x1382CA98, 37353948623346696, 89903530, 89903532, 2, 640x360 
0x1382CA98, 37353948623820296, 89903571, 89903577, 6, 640x360 
0x1382CA98, 37353948624149024, 89903606, 89903612, 6, 640x360 
0x1382CA98, 37353948624470296, 89903636, 89903646, 10, 640x360 
0x1382CA98, 37353948624779904, 89903674, 89903691, 17, 640x360 
0x1382CA98, 37353948625120448, 89903716, 89903723, 7, 640x360 
0x1382CA98, 37353948625429416, 89903738, 89903744, 6, 640x360 
0x1382CA98, 37353948625769288, 89903782, 89903784, 2, 640x360 
0x1382CA98, 37353948626061968, 89903811, 89903821, 10, 640x360 
0x1382CA98, 37353948626386424, 89903834, 89903841, 7, 640x360 
0x1382CA98, 37353948626710120, 89903866, 89903873, 7, 640x360 
0x1382CA98, 37353948627021600, 89903898, 89903901, 3, 640x360 
0x1382CA98, 37353948627344568, 89903940, 89903948, 8, 640x360 
0x1382CA98, 37353948627819240, 89903971, 89903979, 8, 640x360 
0x1382CA98, 37353948628142024, 89904016, 89904018, 2, 640x360 
0x1382CA98, 37353948628460016, 89904046, 89904048, 2, 640x360 
0x1382CA98, 37353948628783712, 89904073, 89904080, 7, 640x360 
0x1382CA98, 37353948629104672, 89904103, 89904112, 9, 640x360 
0x1382CA98, 37353948629431616, 89904140, 89904146, 6, 640x360 
0x1382CA98, 37353948629744584, 89904169, 89904179, 10, 640x360 
0x1382CA98, 37353948630063512, 89904197, 89904201, 4, 640x360 
0x1382CA98, 37353948630380128, 89904229, 89904232, 3, 640x360 
0x1382CA98, 37353948630700072, 89904265, 89904270, 5, 640x360 
0x1382CA98, 37353948631025008, 89904294, 89904296, 2, 640x360 
0x1382CA98, 37353948631341088, 89904330, 89904332, 2, 640x360 
0x1382CA98, 37353948631828992, 89904378, 89904385, 7, 640x360 
0x1382CA98, 37353948632140000, 89904409, 89904412, 3, 640x360 
0x1382CA98, 37353948632460344, 89904436, 89904441, 5, 640x360 
0x1382CA98, 37353948632779312, 89904468, 89904474, 6, 640x360 
0x1382CA98, 37353948633100984, 89904501, 89904506, 5, 640x360 
0x1382CA98, 37353948633424336, 89904532, 89904535, 3, 640x360 
0x1382CA98, 37353948633744408, 89904565, 89904567, 2, 640x360 
0x1382CA98, 37353948634059528, 89904600, 89904603, 3, 640x360 
0x1382CA98, 37353948634379880, 89904631, 89904633, 2, 640x360 
0x1382CA98, 37353948634699504, 89904665, 89904667, 2, 640x360 
0x1382CA98, 37353948635020664, 89904695, 89904697, 2, 640x360 
0x1382CA98, 37353948635340416, 89904735, 89904738, 3, 640x360 
0x1382CA98, 37353948635819728, 89904786, 89904791, 5, 640x360 
0x1382CA98, 37353948636139120, 89904818, 89904821, 3, 640x360 
0x1382CA98, 37353948636466968, 89904848, 89904855, 7, 640x360 
0x1382CA98, 37353948636799424, 89904879, 89904882, 3, 640x360 
0x1382CA98, 37353948637110080, 89904914, 89904916, 2, 640x360 
0x1382CA98, 37353948637421720, 89904943, 89904946, 3, 640x360 
0x1382CA98, 37353948637740968, 89904978, 89904980, 2, 640x360 
0x1382CA98, 37353948638059264, 89905006, 89905016, 10, 640x360 
0x1382CA98, 37353948638380600, 89905038, 89905047, 9, 640x360 
0x1382CA98, 37353948638705648, 89905067, 89905071, 4, 640x360 
0x1382CA98, 37353948639022280, 89905095, 89905103, 8, 640x360 
0x1382CA98, 37353948639346904, 89905128, 89905137, 9, 640x360 
0x1382CA98, 37353948639820080, 89905178, 89905180, 2, 640x360 
0x1382CA98, 37353948640141736, 89905213, 89905215, 2, 640x360 
0x1382CA98, 37353948640459832, 89905246, 89905253, 7, 640x360 
0x1382CA98, 37353948640782960, 89905272, 89905278, 6, 640x360 
0x1382CA98, 37353948641099296, 89905299, 89905302, 3, 640x360 
0x1382CA98, 37353948641423552, 89905334, 89905338, 4, 640x360 
0x1382CA98, 37353948641740104, 89905375, 89905383, 8, 640x360 
0x1382CA98, 37353948642060240, 89905411, 89905413, 2, 640x360 
0x1382CA98, 37353948642379992, 89905443, 89905450, 7, 640x360 
0x1382CA98, 37353948642716720, 89905467, 89905469, 2, 640x360 
0x1382CA98, 37353948643019824, 89905501, 89905504, 3, 640x360 
0x1382CA98, 37353948643340768, 89905535, 89905537, 2, 640x360 
0x1382CA98, 37353948643833048, 89905584, 89905586, 2, 640x360 
0x1382CA98, 37353948644149944, 89905622, 89905631, 9, 640x360 
0x1382CA98, 37353948644461416, 89905658, 89905661, 3, 640x360 
0x1382CA98, 37353948644807664, 89905679, 89905687, 8, 640x360 
0x1382CA98, 37353948645099640, 89905700, 89905703, 3, 640x360 
0x1382CA98, 37353948645420344, 89905741, 89905748, 7, 640x360 
0x1382CA98, 37353948645743344, 89905774, 89905783, 9, 640x360 
0x1382CA98, 37353948646064296, 89905807, 89905810, 3, 640x360 
0x1382CA98, 37353948646388584, 89905833, 89905834, 1, 640x360 
0x1382CA98, 37353948646705168, 89905872, 89905875, 3, 640x360 
0x1382CA98, 37353948647034344, 89905906, 89905909, 3, 640x360 
0x1382CA98, 37353948647345136, 89905928, 89905931, 3, 640x360 
0x1382CA98, 37353948647659776, 89905967, 89905970, 3, 640x360 
0x1382CA98, 37353948648150776, 89906017, 89906029, 12, 640x360 
0x1382CA98, 37353948648481752, 89906045, 89906047, 2, 640x360 
0x1382CA98, 37353948648792944, 89906078, 89906081, 3, 640x360 
0x1382CA98, 37353948649108176, 89906111, 89906113, 2, 640x360 
0x1382CA98, 37353948649434104, 89906143, 89906147, 4, 640x360 
0x1382CA98, 37353948649739992, 89906167, 89906171, 4, 640x360 
0x1382CA98, 37353948650066176, 89906198, 89906201, 3, 640x360 
0x1382CA98, 37353948650383832, 89906240, 89906243, 3, 640x360 
0x1382CA98, 37353948650702968, 89906261, 89906268, 7, 640x360 
0x1382CA98, 37353948651020336, 89906295, 89906297, 2, 640x360 
0x1382CA98, 37353948651347144, 89906326, 89906333, 7, 640x360 
0x1382CA98, 37353948651679168, 89906361, 89906363, 2, 640x360 
0x1382CA98, 37353948652151168, 89906418, 89906421, 3, 640x360 
0x1382CA98, 37353948652458752, 89906437, 89906451, 14, 640x360 
0x1382CA98, 37353948652781032, 89906476, 89906479, 3, 640x360 
0x1382CA98, 37353948653116288, 89906507, 89906515, 8, 640x360 
0x1382CA98, 37353948653430144, 89906544, 89906550, 6, 640x360 
0x1382CA98, 37353948653739480, 89906576, 89906578, 2, 640x360 
0x1382CA98, 37353948654058800, 89906603, 89906607, 4, 640x360 
0x1382CA98, 37353948654380704, 89906633, 89906635, 2, 640x360 
0x1382CA98, 37353948654698928, 89906666, 89906668, 2, 640x360 
0x1382CA98, 37353948655018944, 89906693, 89906704, 11, 640x360 
0x1382CA98, 37353948655343896, 89906735, 89906738, 3, 640x360 
0x1382CA98, 37353948655668856, 89906767, 89906770, 3, 640x360 
0x1382CA98, 37353948656141920, 89906816, 89906818, 2, 640x360 
0x1382CA98, 37353948656459056, 89906854, 89906864, 10, 640x360 
0x1382CA98, 37353948656794000, 89906884, 89906889, 5, 640x360 
0x1382CA98, 37353948657116960, 89906902, 89906909, 7, 640x360 
0x1382CA98, 37353948657424960, 89906945, 89906947, 2, 640x360 
0x1382CA98, 37353948657742680, 89906967, 89906970, 3, 640x360 
0x1382CA98, 37353948658062448, 89907000, 89907004, 4, 640x360 
0x1382CA98, 37353948658382592, 89907029, 89907031, 2, 640x360 
0x1382CA98, 37353948658702720, 89907066, 89907067, 1, 640x360 
0x1382CA98, 37353948659018856, 89907093, 89907099, 6, 640x360 
0x1382CA98, 37353948659340248, 89907135, 89907141, 6, 640x360 
0x1382CA98, 37353948659659856, 89907171, 89907174, 3, 640x360 
0x1382CA98, 37353948660145640, 89907217, 89907219, 2, 640x360 
0x1382CA98, 37353948660459392, 89907246, 89907248, 2, 640x360 
0x1382CA98, 37353948660785984, 89907287, 89907293, 6, 640x360 
0x1382CA98, 37353948661110200, 89907311, 89907313, 2, 640x360 
0x1382CA98, 37353948661424152, 89907339, 89907352, 13, 640x360 
0x1382CA98, 37353948661746736, 89907378, 89907380, 2, 640x360 
0x1382CA98, 37353948662061168, 89907398, 89907401, 3, 640x360 
0x1382CA98, 37353948662378744, 89907429, 89907431, 2, 640x360 
0x1382CA98, 37353948662702488, 89907465, 89907468, 3, 640x360 
0x1382CA98, 37353948663022368, 89907496, 89907498, 2, 640x360 
0x1382CA98, 37353948663344312, 89907527, 89907534, 7, 640x360 
0x1382CA98, 37353948663659912, 89907566, 89907571, 5, 640x360 
0x1382CA98, 37353948664141008, 89907621, 89907632, 11, 640x360 
0x1382CA98, 37353948664458728, 89907637, 89907655, 18, 640x360 
0x1382CA98, 37353948664790864, 89907679, 89907682, 3, 640x360 
0x1382CA98, 37353948665133056, 89907707, 89907715, 8, 640x360 
0x1382CA98, 37353948665453480, 89907743, 89907756, 13, 640x360 
0x1382CA98, 37353948665763568, 89907780, 89907782, 2, 640x360 
0x1382CA98, 37353948666058528, 89907801, 89907804, 3, 640x360 
0x1382CA98, 37353948666378648, 89907828, 89907831, 3, 640x360 
0x1382CA98, 37353948666702368, 89907876, 89907879, 3, 640x360 
0x1382CA98, 37353948667029976, 89907903, 89907908, 5, 640x360 
0x1382CA98, 37353948667370160, 89907944, 89907955, 11, 640x360 
0x1382CA98, 37353948667669648, 89907972, 89907981, 9, 640x360 
0x1382CA98, 37353948668138768, 89908017, 89908021, 4, 640x360 
0x1382CA98, 37353948668473320, 89908057, 89908064, 7, 640x360 
0x1382CA98, 37353948668793720, 89908083, 89908086, 3, 640x360 
0x1382CA98, 37353948669122608, 89908118, 89908123, 5, 640x360 
0x1382CA98, 37353948669427984, 89908151, 89908159, 8, 640x360 
0x1382CA98, 37353948669739880, 89908178, 89908181, 3, 640x360 
0x1382CA98, 37353948670059488, 89908209, 89908212, 3, 640x360 
0x1382CA98, 37353948670378520, 89908240, 89908242, 2, 640x360 
0x1382CA98, 37353948670698512, 89908271, 89908279, 8, 640x360 
0x1382CA98, 37353948671020240, 89908294, 89908300, 6, 640x360 
0x1382CA98, 37353948671342584, 89908326, 89908330, 4, 640x360 
0x1382CA98, 37353948671662360, 89908365, 89908368, 3, 640x360 
0x1382CA98, 37353948672159808, 89908414, 89908421, 7, 640x360 
0x1382CA98, 37353948672459800, 89908436, 89908445, 9, 640x360 
0x1382CA98, 37353948672783464, 89908481, 89908493, 12, 640x360 
0x1382CA98, 37353948673119240, 89908518, 89908524, 6, 640x360 
0x1382CA98, 37353948673433112, 89908562, 89908567, 5, 640x360 
0x1382CA98, 37353948673786296, 89908585, 89908594, 9, 640x360 
0x1382CA98, 37353948674061656, 89908614, 89908616, 2, 640x360 
0x1382CA98, 37353948674378768, 89908645, 89908647, 2, 640x360 
0x1382CA98, 37353948674699024, 89908668, 89908675, 7, 640x360 
0x1382CA98, 37353948675022848, 89908709, 89908716, 7, 640x360 
0x1382CA98, 37353948675342688, 89908736, 89908741, 5, 640x360 
0x1382CA98, 37353948675658832, 89908762, 89908764, 2, 640x360 
0x1382CA98, 37353948675981408, 89908794, 89908796, 2, 640x360 
0x1382CA98, 37353948676462120, 89908836, 89908860, 24, 640x360 
0x1382CA98, 37353948676786904, 89908888, 89908893, 5, 640x360 
0x1382CA98, 37353948677132768, 89908917, 89908922, 5, 640x360 
0x1382CA98, 37353948677428080, 89908942, 89908945, 3, 640x360 
0x1382CA98, 37353948677747816, 89908975, 89908977, 2, 640x360 
0x1382CA98, 37353948678058024, 89909010, 89909013, 3, 640x360 
0x1382CA98, 37353948678382136, 89909038, 89909041, 3, 640x360 
0x1382CA98, 37353948678702040, 89909070, 89909075, 5, 640x360 
0x1382CA98, 37353948679018392, 89909095, 89909098, 3, 640x360 
0x1382CA98, 37353948679340096, 89909135, 89909140, 5, 640x360 
0x1382CA98, 37353948679662392, 89909161, 89909170, 9, 640x360 
0x1382CA98, 37353948679978896, 89909200, 89909203, 3, 640x360 
0x1382CA98, 37353948680464176, 89909245, 89909254, 9, 640x360 
0x1382CA98, 37353948680791864, 89909274, 89909277, 3, 640x360 
0x1382CA98, 37353948681105152, 89909307, 89909310, 3, 640x360 
0x1382CA98, 37353948681426672, 89909340, 89909343, 3, 640x360 
0x1382CA98, 37353948681750456, 89909369, 89909374, 5, 640x360 
0x1382CA98, 37353948682062152, 89909413, 89909415, 2, 640x360 
0x1382CA98, 37353948682378608, 89909443, 89909446, 3, 640x360 
0x1382CA98, 37353948682704568, 89909477, 89909479, 2, 640x360 
0x1382CA98, 37353948683023840, 89909504, 89909514, 10, 640x360 
0x1382CA98, 37353948683351736, 89909541, 89909550, 9, 640x360 
0x1382CA98, 37353948683676992, 89909563, 89909565, 2, 640x360 
0x1382CA98, 37353948684000136, 89909594, 89909597, 3, 640x360 
0x1382CA98, 37353948684457976, 89909641, 89909644, 3, 640x360 
0x1382CA98, 37353948684783768, 89909678, 89909686, 8, 640x360 
0x1382CA98, 37353948685104856, 89909708, 89909715, 7, 640x360 
0x1382CA98, 37353948685425080, 89909746, 89909750, 4, 640x360 
0x1382CA98, 37353948685758464, 89909774, 89909782, 8, 640x360 
0x1382CA98, 37353948686057952, 89909810, 89909822, 12, 640x360 
0x1382CA98, 37353948686391944, 89909840, 89909849, 9, 640x360 
0x1382CA98, 37353948686703592, 89909872, 89909883, 11, 640x360 
0x1382CA98, 37353948687041128, 89909905, 89909912, 7, 640x360 
0x1382CA98, 37353948687340232, 89909936, 89909941, 5, 640x360 
0x1382CA98, 37353948687659528, 89909966, 89909970, 4, 640x360 
0x1382CA98, 37353948687979336, 89909996, 89909999, 3, 640x360 
0x1382CA98, 37353948688458296, 89910038, 89910043, 5, 640x360 
0x1382CA98, 37353948688777608, 89910077, 89910080, 3, 640x360 
0x1382CA98, 37353948689119256, 89910111, 89910113, 2, 640x360 
0x1382CA98, 37353948689423920, 89910139, 89910142, 3, 640x360 
0x1382CA98, 37353948689739048, 89910174, 89910181, 7, 640x360 
0x1382CA98, 37353948690057904, 89910200, 89910203, 3, 640x360 
0x1382CA98, 37353948690391232, 89910230, 89910236, 6, 640x360 
0x1382CA98, 37353948690698048, 89910261, 89910263, 2, 640x360 
0x1382CA98, 37353948691023536, 89910296, 89910299, 3, 640x360 
0x1382CA98, 37353948691339096, 89910328, 89910330, 2, 640x360 
0x1382CA98, 37353948691659032, 89910371, 89910375, 4, 640x360 
0x1382CA98, 37353948691987896, 89910397, 89910400, 3, 640x360 
0x1382CA98, 37353948692457448, 89910435, 89910440, 5, 640x360 
0x1382CA98, 37353948692788632, 89910472, 89910482, 10, 640x360 
0x1382CA98, 37353948693114968, 89910516, 89910518, 2, 640x360 
0x1382CA98, 37353948693451608, 89910557, 89910570, 13, 640x360 
0x1382CA98, 37353948693767720, 89910593, 89910596, 3, 640x360 
0x1382CA98, 37353948694067712, 89910611, 89910617, 6, 640x360 
0x1382CA98, 37353948694379736, 89910635, 89910649, 14, 640x360 
0x1382CA98, 37353948694699240, 89910674, 89910676, 2, 640x360 
0x1382CA98, 37353948695019728, 89910705, 89910713, 8, 640x360 
0x1382CA98, 37353948695341448, 89910735, 89910740, 5, 640x360 
0x1382CA98, 37353948695663376, 89910764, 89910765, 1, 640x360 
0x1382CA98, 37353948695977992, 89910796, 89910798, 2, 640x360 
0x1382CA98, 37353948696457400, 89910836, 89910842, 6, 640x360 
0x1382CA98, 37353948696786096, 89910874, 89910876, 2, 640x360 
0x1382CA98, 37353948697099048, 89910900, 89910903, 3, 640x360 
0x1382CA98, 37353948697425040, 89910934, 89910938, 4, 640x360 
0x1382CA98, 37353948697755152, 89910970, 89910976, 6, 640x360 
0x1382CA98, 37353948698057632, 89911010, 89911012, 2, 640x360 
0x1382CA98, 37353948698378064, 89911036, 89911041, 5, 640x360 
0x1382CA98, 37353948698698136, 89911060, 89911063, 3, 640x360 
0x1382CA98, 37353948699021696, 89911098, 89911099, 1, 640x360 
0x1382CA98, 37353948699359120, 89911129, 89911131, 2, 640x360 
0x1382CA98, 37353948699664816, 89911168, 89911171, 3, 640x360 
0x1382CA98, 37353948699982848, 89911209, 89911215, 6, 640x360 
0x1382CA98, 37353948700777808, 89911276, 89911283, 7, 640x360 
0x1382CA98, 37353948701101736, 89911314, 89911316, 2, 640x360 
0x1382CA98, 37353948701421736, 89911335, 89911342, 7, 640x360 
0x1382CA98, 37353948701737848, 89911366, 89911371, 5, 640x360 
0x1382CA98, 37353948702057512, 89911408, 89911413, 5, 640x360 
0x1382CA98, 37353948702382352, 89911451, 89911454, 3, 640x360 
0x1382CA98, 37353948702701856, 89911474, 89911476, 2, 640x360 
0x1382CA98, 37353948703020368, 89911494, 89911497, 3, 640x360 
0x1382CA98, 37353948703337952, 89911529, 89911531, 2, 640x360 
0x1382CA98, 37353948703658048, 89911565, 89911572, 7, 640x360 
0x1382CA98, 37353948703977632, 89911586, 89911592, 6, 640x360 
0x1382CA98, 37353948704308968, 89911619, 89911625, 6, 640x360 
0x1382CA98, 37353948704777120, 89911679, 89911681, 2, 640x360 
0x1382CA98, 37353948705103696, 89911702, 89911709, 7, 640x360 
0x1382CA98, 37353948705431896, 89911738, 89911742, 4, 640x360 
0x1382CA98, 37353948705742152, 89911766, 89911770, 4, 640x360 
0x1382CA98, 37353948706060400, 89911798, 89911801, 3, 640x360 
0x1382CA98, 37353948706379256, 89911832, 89911835, 3, 640x360 
0x1382CA98, 37353948706701944, 89911873, 89911882, 9, 640x360 
0x1382CA98, 37353948707030928, 89911901, 89911905, 4, 640x360 
0x1382CA98, 37353948707338248, 89911940, 89911942, 2, 640x360 
0x1382CA98, 37353948707663704, 89911962, 89911964, 2, 640x360 
0x1382CA98, 37353948707979952, 89912000, 89912002, 2, 640x360 
0x1382CA98, 37353948708298040, 89912028, 89912030, 2, 640x360 
0x1382CA98, 37353948708777520, 89912069, 89912071, 2, 640x360 
0x1382CA98, 37353948709103152, 89912107, 89912111, 4, 640x360 
0x1382CA98, 37353948709431824, 89912137, 89912144, 7, 640x360 
0x1382CA98, 37353948709741072, 89912168, 89912171, 3, 640x360 
0x1382CA98, 37353948710058304, 89912199, 89912201, 2, 640x360 
0x1382CA98, 37353948710378232, 89912230, 89912234, 4, 640x360 
0x1382CA98, 37353948710698216, 89912261, 89912264, 3, 640x360 
0x1382CA98, 37353948711018208, 89912295, 89912296, 1, 640x360 
0x1382CA98, 37353948711340744, 89912329, 89912335, 6, 640x360 
0x1382CA98, 37353948711658680, 89912355, 89912358, 3, 640x360 
0x1382CA98, 37353948711978360, 89912388, 89912393, 5, 640x360 
0x1382CA98, 37353948712303008, 89912420, 89912425, 5, 640x360 
0x1382CA98, 37353948712778048, 89912467, 89912476, 9, 640x360 
0x1382CA98, 37353948713102880, 89912512, 89912514, 2, 640x360 
0x1382CA98, 37353948713443088, 89912547, 89912549, 2, 640x360 
0x1382CA98, 37353948713751528, 89912582, 89912585, 3, 640x360 
0x1382CA98, 37353948714060208, 89912607, 89912615, 8, 640x360 
0x1382CA98, 37353948714387688, 89912642, 89912650, 8, 640x360 
0x1382CA98, 37353948714723072, 89912666, 89912673, 7, 640x360 
0x1382CA98, 37353948715021464, 89912695, 89912697, 2, 640x360 
0x1382CA98, 37353948715344576, 89912736, 89912748, 12, 640x360 
0x1382CA98, 37353948715664464, 89912775, 89912781, 6, 640x360 
0x1382CA98, 37353948715984000, 89912795, 89912798, 3, 640x360 
0x1382CA98, 37353948716315336, 89912834, 89912836, 2, 640x360 
0x1382CA98, 37353948716776744, 89912873, 89912880, 7, 640x360 
0x1382CA98, 37353948717131152, 89912903, 89912914, 11, 640x360 
0x1382CA98, 37353948717445608, 89912951, 89912953, 2, 640x360 
0x1382CA98, 37353948717737856, 89912967, 89912972, 5, 640x360 
0x1382CA98, 37353948718058160, 89913000, 89913003, 3, 640x360 
0x1382CA98, 37353948718378064, 89913033, 89913038, 5, 640x360 
0x1382CA98, 37353948718701816, 89913067, 89913072, 5, 640x360 
0x1382CA98, 37353948719026072, 89913100, 89913102, 2, 640x360 
0x1382CA98, 37353948719342784, 89913130, 89913132, 2, 640x360 
0x1382CA98, 37353948719659872, 89913168, 89913172, 4, 640x360 
0x1382CA98, 37353948719978368, 89913208, 89913209, 1, 640x360 
0x1382CA98, 37353948720301192, 89913231, 89913239, 8, 640x360 
0x1382CA98, 37353948720780960, 89913283, 89913285, 2, 640x360 
0x1382CA98, 37353948721104864, 89913305, 89913309, 4, 640x360 
0x1382CA98, 37353948721422960, 89913333, 89913336, 3, 640x360 
0x1382CA98, 37353948721759864, 89913366, 89913369, 3, 640x360 
0x1382CA98, 37353948722057136, 89913408, 89913418, 10, 640x360 
0x1382CA98, 37353948722385432, 89913434, 89913438, 4, 640x360 
0x1382CA98, 37353948722696872, 89913461, 89913469, 8, 640x360 
0x1382CA98, 37353948723045272, 89913500, 89913505, 5, 640x360 
0x1382CA98, 37353948723337152, 89913530, 89913532, 2, 640x360 
0x1382CA98, 37353948723662672, 89913567, 89913570, 3, 640x360 
0x1382CA98, 37353948723977400, 89913595, 89913597, 2, 640x360 
0x1382CA98, 37353948724301872, 89913626, 89913628, 2, 640x360 
0x1382CA98, 37353948724776720, 89913668, 89913684, 16, 640x360 
0x1382CA98, 37353948725103488, 89913702, 89913713, 11, 640x360 
0x1382CA98, 37353948725419720, 89913734, 89913738, 4, 640x360 
0x1382CA98, 37353948725738120, 89913766, 89913770, 4, 640x360 
0x1382CA98, 37353948726057696, 89913799, 89913804, 5, 640x360 
0x1382CA98, 37353948726377920, 89913833, 89913835, 2, 640x360 
0x1382CA98, 37353948726697472, 89913866, 89913869, 3, 640x360 
0x1382CA98, 37353948727017592, 89913901, 89913904, 3, 640x360 
0x1382CA98, 37353948727341296, 89913933, 89913935, 2, 640x360 
0x1382CA98, 37353948727658408, 89913960, 89913971, 11, 640x360 
0x1382CA98, 37353948727977792, 89913992, 89913994, 2, 640x360 
0x1382CA98, 37353948728298320, 89914028, 89914035, 7, 640x360 
0x1382CA98, 37353948728618664, 89914050, 89914054, 4, 640x360 
0x1382CA98, 37353948729104432, 89914106, 89914110, 4, 640x360 
0x1382CA98, 37353948729445888, 89914138, 89914144, 6, 640x360 
0x1382CA98, 37353948729737112, 89914171, 89914175, 4, 640x360 
0x1382CA98, 37353948730062224, 89914206, 89914208, 2, 640x360 
0x1382CA98, 37353948730380680, 89914232, 89914235, 3, 640x360 
0x1382CA98, 37353948730700896, 89914262, 89914264, 2, 640x360 
0x1382CA98, 37353948731021440, 89914293, 89914296, 3, 640x360 
0x1382CA98, 37353948731341176, 89914333, 89914335, 2, 640x360 
0x1382CA98, 37353948731669400, 89914361, 89914370, 9, 640x360 
0x1382CA98, 37353948731977624, 89914396, 89914402, 6, 640x360 
0x1382CA98, 37353948732323056, 89914434, 89914437, 3, 640x360 
0x1382CA98, 37353948732622880, 89914473, 89914475, 2, 640x360 
0x1382CA98, 37353948733119504, 89914511, 89914513, 2, 640x360 
0x1382CA98, 37353948733421880, 89914538, 89914551, 13, 640x360 
0x1382CA98, 37353948733738112, 89914570, 89914580, 10, 640x360 
0x1382CA98, 37353948734056504, 89914600, 89914604, 4, 640x360 
0x1382CA98, 37353948734381472, 89914633, 89914636, 3, 640x360 
0x1382CA98, 37353948734696784, 89914665, 89914667, 2, 640x360 
0x1382CA98, 37353948735021680, 89914707, 89914716, 9, 640x360 
0x1382CA98, 37353948735344304, 89914733, 89914737, 4, 640x360 
0x1382CA98, 37353948735657968, 89914765, 89914768, 3, 640x360 
0x1382CA98, 37353948735983880, 89914813, 89914824, 11, 640x360 
0x1382CA98, 37353948736302600, 89914829, 89914840, 11, 640x360 
0x1382CA98, 37353948736627560, 89914877, 89914885, 8, 640x360 
0x1382CA98, 37353948737123720, 89914915, 89914918, 3, 640x360 
0x1382CA98, 37353948737428512, 89914935, 89914949, 14, 640x360 
0x1382CA98, 37353948737736840, 89914968, 89914974, 6, 640x360 
0x1382CA98, 37353948738057160, 89915000, 89915003, 3, 640x360 
0x1382CA98, 37353948738376408, 89915043, 89915053, 10, 640x360 
0x1382CA98, 37353948738704272, 89915074, 89915077, 3, 640x360 
0x1382CA98, 37353948739016720, 89915101, 89915103, 2, 640x360 
0x1382CA98, 37353948739351584, 89915139, 89915142, 3, 640x360 
0x1382CA98, 37353948739657736, 89915160, 89915163, 3, 640x360 
0x1382CA98, 37353948739979568, 89915199, 89915202, 3, 640x360 
0x1382CA98, 37353948740297184, 89915221, 89915230, 9, 640x360 
0x1382CA98, 37353948740619688, 89915251, 89915256, 5, 640x360 
0x1382CA98, 37353948741100872, 89915305, 89915308, 3, 640x360 
0x1382CA98, 37353948741423256, 89915334, 89915347, 13, 640x360 
0x1382CA98, 37353948741737312, 89915368, 89915373, 5, 640x360 
0x1382CA98, 37353948742060616, 89915398, 89915400, 2, 640x360 
0x1382CA98, 37353948742378112, 89915428, 89915430, 2, 640x360 
0x1382CA98, 37353948742696832, 89915462, 89915465, 3, 640x360 
0x1382CA98, 37353948743018720, 89915501, 89915504, 3, 640x360 
0x1382CA98, 37353948743339608, 89915534, 89915536, 2, 640x360 
0x1382CA98, 37353948743664016, 89915568, 89915572, 4, 640x360 
0x1382CA98, 37353948744007288, 89915600, 89915602, 2, 640x360 
0x1382CA98, 37353948744298184, 89915622, 89915633, 11, 640x360 
0x1382CA98, 37353948744623224, 89915653, 89915667, 14, 640x360 
0x1382CA98, 37353948745115352, 89915712, 89915714, 2, 640x360 
0x1382CA98, 37353948745431616, 89915736, 89915742, 6, 640x360 
0x1382CA98, 37353948745761016, 89915771, 89915778, 7, 640x360 
0x1382CA98, 37353948746060504, 89915823, 89915834, 11, 640x360 
0x1382CA98, 37353948746383904, 89915835, 89915845, 10, 640x360 
0x1382CA98, 37353948746697144, 89915869, 89915875, 6, 640x360 
0x1382CA98, 37353948747018184, 89915898, 89915900, 2, 640x360 
0x1382CA98, 37353948747340624, 89915941, 89915945, 4, 640x360 
0x1382CA98, 37353948747661696, 89915959, 89915962, 3, 640x360 
0x1382CA98, 37353948747977128, 89916013, 89916017, 4, 640x360 
0x1382CA98, 37353948748307112, 89916030, 89916032, 2, 640x360 
0x1382CA98, 37353948748623432, 89916073, 89916084, 11, 640x360 
0x1382CA98, 37353948749116760, 89916129, 89916134, 5, 640x360 
0x1382CA98, 37353948749438776, 89916178, 89916193, 15, 640x360 
0x1382CA98, 37353948749834984, 89916194, 89916208, 14, 640x360 
0x1382CA98, 37353948750072584, 89916224, 89916226, 2, 640x360 
0x1382CA98, 37353948750389368, 89916242, 89916251, 9, 640x360 
0x1382CA98, 37353948750702024, 89916273, 89916280, 7, 640x360 
0x1382CA98, 37353948751021328, 89916301, 89916304, 3, 640x360 
0x1382CA98, 37353948751340560, 89916340, 89916343, 3, 640x360 
0x1382CA98, 37353948751657696, 89916360, 89916362, 2, 640x360 
0x1382CA98, 37353948751979736, 89916407, 89916415, 8, 640x360 
0x1382CA98, 37353948752301176, 89916428, 89916435, 7, 640x360 
0x1382CA98, 37353948752626152, 89916467, 89916469, 2, 640x360 
0x1382CA98, 37353948753102032, 89916517, 89916519, 2, 640x360 
0x1382CA98, 37353948753416456, 89916536, 89916551, 15, 640x360 
0x1382CA98, 37353948753738464, 89916567, 89916573, 6, 640x360 
0x1382CA98, 37353948754056424, 89916606, 89916614, 8, 640x360 
0x1382CA98, 37353948754379312, 89916638, 89916650, 12, 640x360 
0x1382CA98, 37353948754706544, 89916673, 89916680, 7, 640x360 
0x1382CA98, 37353948755026800, 89916706, 89916716, 10, 640x360 
0x1382CA98, 37353948755358096, 89916732, 89916734, 2, 640x360 
0x1382CA98, 37353948755672784, 89916762, 89916764, 2, 640x360 
0x1382CA98, 37353948756007704, 89916803, 89916814, 11, 640x360 
0x1382CA98, 37353948756299448, 89916837, 89916851, 14, 640x360 
0x1382CA98, 37353948756635720, 89916867, 89916869, 2, 640x360 
0x1382CA98, 37353948756976024, 89916896, 89916898, 2, 640x360 
0x1382CA98, 37353948757418624, 89916940, 89916948, 8, 640x360 
0x1382CA98, 37353948757746792, 89916978, 89916982, 4, 640x360 
0x1382CA98, 37353948758061936, 89917001, 89917004, 3, 640x360 
0x1382CA98, 37353948758376368, 89917035, 89917039, 4, 640x360 
0x1382CA98, 37353948758702424, 89917066, 89917069, 3, 640x360 
0x1382CA98, 37353948759044688, 89917105, 89917118, 13, 640x360 
0x1382CA98, 37353948759342208, 89917144, 89917147, 3, 640x360 
0x1382CA98, 37353948759660440, 89917164, 89917167, 3, 640x360 
0x1382CA98, 37353948759982704, 89917202, 89917204, 2, 640x360 
0x1382CA98, 37353948760297296, 89917241, 89917245, 4, 640x360 
0x1382CA98, 37353948760632928, 89917267, 89917278, 11, 640x360 
0x1382CA98, 37353948760954288, 89917300, 89917308, 8, 640x360 
0x1382CA98, 37353948761416112, 89917345, 89917351, 6, 640x360 
0x1382CA98, 37353948761736640, 89917378, 89917380, 2, 640x360 
0x1382CA98, 37353948762056240, 89917411, 89917414, 3, 640x360 
0x1382CA98, 37353948762375888, 89917445, 89917453, 8, 640x360 
0x1382CA98, 37353948762713264, 89917474, 89917476, 2, 640x360 
0x1382CA98, 37353948763035928, 89917512, 89917514, 2, 640x360 
0x1382CA98, 37353948763348688, 89917530, 89917535, 5, 640x360 
0x1382CA98, 37353948763662192, 89917578, 89917584, 6, 640x360 
0x1382CA98, 37353948763983408, 89917598, 89917600, 2, 640x360 
0x1382CA98, 37353948764319288, 89917640, 89917647, 7, 640x360 
0x1382CA98, 37353948764631624, 89917670, 89917688, 18, 640x360 
0x1382CA98, 37353948764970600, 89917714, 89917727, 13, 640x360 
0x1382CA98, 37353948765424240, 89917748, 89917751, 3, 640x360 
0x1382CA98, 37353948765783296, 89917790, 89917794, 4, 640x360 
0x1382CA98, 37353948766057376, 89917812, 89917814, 2, 640x360 
0x1382CA98, 37353948766376520, 89917845, 89917847, 2, 640x360 
0x1382CA98, 37353948766700688, 89917877, 89917879, 2, 640x360 
0x1382CA98, 37353948767016304, 89917902, 89917908, 6, 640x360 
0x1382CA98, 37353948767345864, 89917931, 89917933, 2, 640x360 
0x1382CA98, 37353948767668680, 89917964, 89917966, 2, 640x360 
0x1382CA98, 37353948767979624, 89918003, 89918010, 7, 640x360 
0x1382CA98, 37353948768303280, 89918031, 89918033, 2, 640x360 
0x1382CA98, 37353948768617312, 89918054, 89918069, 15, 640x360 
0x1382CA98, 37353948768948256, 89918089, 89918093, 4, 640x360 
0x1382CA98, 37353948769432760, 89918139, 89918146, 7, 640x360 
0x1382CA98, 37353948769739920, 89918169, 89918172, 3, 640x360 
0x1382CA98, 37353948770056232, 89918201, 89918203, 2, 640x360 
0x1382CA98, 37353948770380560, 89918230, 89918237, 7, 640x360 
0x1382CA98, 37353948770699336, 89918263, 89918269, 6, 640x360 
0x1382CA98, 37353948771019592, 89918296, 89918302, 6, 640x360 
0x1382CA98, 37353948771339656, 89918331, 89918333, 2, 640x360 
0x1382CA98, 37353948771663136, 89918368, 89918371, 3, 640x360 
0x1382CA98, 37353948771976064, 89918398, 89918400, 2, 640x360 
0x1382CA98, 37353948772299672, 89918423, 89918428, 5, 640x360 
0x1382CA98, 37353948772617048, 89918454, 89918464, 10, 640x360 
0x1382CA98, 37353948772936880, 89918486, 89918493, 7, 640x360 
0x1382CA98, 37353948773416000, 89918541, 89918544, 3, 640x360 
0x1382CA98, 37353948773741048, 89918567, 89918570, 3, 640x360 
0x1382CA98, 37353948774060864, 89918600, 89918602, 2, 640x360 
0x1382CA98, 37353948774390496, 89918637, 89918641, 4, 640x360 
0x1382CA98, 37353948774696576, 89918670, 89918675, 5, 640x360 
0x1382CA98, 37353948775016872, 89918700, 89918702, 2, 640x360 
0x1382CA98, 37353948775340440, 89918737, 89918741, 4, 640x360 
0x1382CA98, 37353948775657712, 89918763, 89918765, 2, 640x360 
0x1382CA98, 37353948775980368, 89918802, 89918804, 2, 640x360 
0x1382CA98, 37353948776296408, 89918827, 89918834, 7, 640x360 
0x1382CA98, 37353948776624264, 89918865, 89918867, 2, 640x360 
0x1382CA98, 37353948776937952, 89918891, 89918897, 6, 640x360 
0x1382CA98, 37353948777417552, 89918941, 89918943, 2, 640x360 
0x1382CA98, 37353948777756320, 89918966, 89918971, 5, 640x360 
0x1382CA98, 37353948778055808, 89919022, 89919027, 5, 640x360 
0x1382CA98, 37353948778384760, 89919046, 89919048, 2, 640x360 
0x1382CA98, 37353948778699512, 89919072, 89919082, 10, 640x360 
0x1382CA98, 37353948779028120, 89919101, 89919102, 1, 640x360 
0x1382CA98, 37353948779336152, 89919129, 89919137, 8, 640x360 
0x1382CA98, 37353948779664824, 89919159, 89919164, 5, 640x360 
0x1382CA98, 37353948779976592, 89919201, 89919202, 1, 640x360 
0x1382CA98, 37353948780300936, 89919235, 89919237, 2, 640x360 
0x1382CA98, 37353948780621024, 89919261, 89919264, 3, 640x360 
0x1382CA98, 37353948780946240, 89919298, 89919300, 2, 640x360 
0x1382CA98, 37353948781425880, 89919337, 89919354, 17, 640x360 
0x1382CA98, 37353948781776584, 89919378, 89919384, 6, 640x360 
0x1382CA98, 37353948782056160, 89919414, 89919416, 2, 640x360 
0x1382CA98, 37353948782377808, 89919438, 89919447, 9, 640x360 
0x1382CA98, 37353948782699784, 89919468, 89919471, 3, 640x360 
0x1382CA98, 37353948783015824, 89919505, 89919516, 11, 640x360 
0x1382CA98, 37353948783342136, 89919541, 89919544, 3, 640x360 
0x1382CA98, 37353948783656264, 89919566, 89919569, 3, 640x360 
0x1382CA98, 37353948783979864, 89919602, 89919614, 12, 640x360 
0x1382CA98, 37353948784350864, 89919636, 89919643, 7, 640x360 
0x1382CA98, 37353948784637408, 89919680, 89919684, 4, 640x360 
0x1382CA98, 37353948784947776, 89919698, 89919701, 3, 640x360 
0x1382CA98, 37353948785263032, 89919728, 89919738, 10, 640x360 
0x1382CA98, 37353948785735200, 89919770, 89919775, 5, 640x360 
0x1382CA98, 37353948786059192, 89919801, 89919803, 2, 640x360 
0x1382CA98, 37353948786376176, 89919833, 89919838, 5, 640x360 
0x1382CA98, 37353948786699592, 89919872, 89919883, 11, 640x360 
0x1382CA98, 37353948787025608, 89919896, 89919904, 8, 640x360 
0x1382CA98, 37353948787381872, 89919931, 89919933, 2, 640x360 
0x1382CA98, 37353948787661800, 89919954, 89919961, 7, 640x360 
0x1382CA98, 37353948787977584, 89919997, 89920015, 18, 640x360 
0x1382CA98, 37353948788327208, 89920029, 89920031, 2, 640x360 
0x1382CA98, 37353948788616400, 89920068, 89920074, 6, 640x360 
0x1382CA98, 37353948788943528, 89920107, 89920114, 7, 640x360 
0x1382CA98, 37353948789263728, 89920130, 89920134, 4, 640x360 
0x1382CA98, 37353948789735256, 89920179, 89920183, 4, 640x360 
0x1382CA98, 37353948790060272, 89920210, 89920212, 2, 640x360 
0x1382CA98, 37353948790375016, 89920232, 89920234, 2, 640x360 
0x1382CA98, 37353948790697296, 89920263, 89920265, 2, 640x360 
0x1382CA98, 37353948791019416, 89920301, 89920303, 2, 640x360 
0x1382CA98, 37353948791341720, 89920330, 89920337, 7, 640x360 
0x1382CA98, 37353948791656616, 89920360, 89920363, 3, 640x360 
0x1382CA98, 37353948791985304, 89920392, 89920396, 4, 640x360 
0x1382CA98, 37353948792306776, 89920435, 89920442, 7, 640x360 
0x1382CA98, 37353948792623048, 89920469, 89920475, 6, 640x360 
0x1382CA98, 37353948792954984, 89920495, 89920501, 6, 640x360 
0x1382CA98, 37353948793273720, 89920528, 89920537, 9, 640x360 
0x1382CA98, 37353948793752360, 89920580, 89920583, 3, 640x360 
0x1382CA98, 37353948794055096, 89920606, 89920609, 3, 640x360 
0x1382CA98, 37353948794375296, 89920635, 89920640, 5, 640x360 
0x1382CA98, 37353948794696944, 89920672, 89920681, 9, 640x360 
0x1382CA98, 37353948795017072, 89920703, 89920713, 10, 640x360 
0x1382CA98, 37353948795338352, 89920735, 89920738, 3, 640x360 
0x1382CA98, 37353948795664992, 89920762, 89920766, 4, 640x360 
0x1382CA98, 37353948795986208, 89920802, 89920804, 2, 640x360 
0x1382CA98, 37353948796298872, 89920827, 89920833, 6, 640x360 
0x1382CA98, 37353948796617192, 89920863, 89920870, 7, 640x360 
0x1382CA98, 37353948796939648, 89920897, 89920909, 12, 640x360 
0x1382CA98, 37353948797261240, 89920921, 89920926, 5, 640x360 
0x1382CA98, 37353948797734720, 89920972, 89920975, 3, 640x360 
0x1382CA98, 37353948798054856, 89921005, 89921009, 4, 640x360 
0x1382CA98, 37353948798375424, 89921038, 89921043, 5, 640x360 
0x1382CA98, 37353948798694776, 89921070, 89921075, 5, 640x360 
0x1382CA98, 37353948799015296, 89921094, 89921101, 7, 640x360 
0x1382CA98, 37353948799338944, 89921131, 89921134, 3, 640x360 
0x1382CA98, 37353948799654984, 89921168, 89921171, 3, 640x360 
0x1382CA98, 37353948799979712, 89921199, 89921201, 2, 640x360 
0x1382CA98, 37353948800304624, 89921230, 89921231, 1, 640x360 
0x1382CA98, 37353948800617240, 89921261, 89921264, 3, 640x360 
0x1382CA98, 37353948800941344, 89921298, 89921300, 2, 640x360 
0x1382CA98, 37353948801263304, 89921331, 89921341, 10, 640x360 
0x1382CA98, 37353948801735144, 89921378, 89921384, 6, 640x360 
0x1382CA98, 37353948802057824, 89921438, 89921450, 12, 640x360 
0x1382CA98, 37353948802377176, 89921450, 89921478, 28, 640x360 
0x1382CA98, 37353948802703112, 89921495, 89921506, 11, 640x360 
0x1382CA98, 37353948803081512, 89921545, 89921568, 23, 640x360 
0x1382CA98, 37353948803663304, 89921582, 89921588, 6, 640x360 
0x1382CA98, 37353948803994664, 89921650, 89921655, 5, 640x360 
0x1382CA98, 37353948804645392, 89921668, 89921699, 31, 640x360 
0x1382CA98, 37353948804998264, 89921735, 89921758, 23, 640x360 
0x1382CA98, 37353948805792736, 89921798, 89921845, 47, 640x360 
0x1382CA98, 37353948806095048, 89921847, 89921868, 21, 640x360 
0x1382CA98, 37353948806394560, 89921868, 89921877, 9, 640x360 
0x1382CA98, 37353948806718280, 89921896, 89921901, 5, 640x360 
0x1382CA98, 37353948807129296, 89921933, 89921949, 16, 640x360 
0x1382CA98, 37353948807346800, 89921949, 89921964, 15, 640x360 
0x1382CA98, 37353948807693096, 89921980, 89921983, 3, 640x360 
0x1382CA98, 37353948807990736, 89921998, 89922001, 3, 640x360 
0x1382CA98, 37353948808314912, 89922030, 89922032, 2, 640x360 
0x1382CA98, 37353948808623472, 89922052, 89922055, 3, 640x360 
0x1382CA98, 37353948808942736, 89922090, 89922094, 4, 640x360 
0x1382CA98, 37353948809256696, 89922121, 89922133, 12, 640x360 
0x1382CA98, 37353948809579432, 89922157, 89922165, 8, 640x360 
0x1382CA98, 37353948810054496, 89922201, 89922203, 2, 640x360 
0x1382CA98, 37353948810381000, 89922234, 89922237, 3, 640x360 
0x1382CA98, 37353948810696368, 89922261, 89922264, 3, 640x360 
0x1382CA98, 37353948811030616, 89922298, 89922300, 2, 640x360 
0x1382CA98, 37353948811351904, 89922332, 89922338, 6, 640x360 
0x1382CA98, 37353948811656568, 89922363, 89922365, 2, 640x360 
0x1382CA98, 37353948811992544, 89922402, 89922409, 7, 640x360 
0x1382CA98, 37353948812298464, 89922436, 89922439, 3, 640x360 
0x1382CA98, 37353948812623536, 89922464, 89922466, 2, 640x360 
0x1382CA98, 37353948812935176, 89922492, 89922495, 3, 640x360 
0x1382CA98, 37353948813255280, 89922529, 89922531, 2, 640x360 
0x1382CA98, 37353948813584320, 89922558, 89922562, 4, 640x360 
0x1382CA98, 37353948814056144, 89922597, 89922602, 5, 640x360 
0x1382CA98, 37353948814375160, 89922639, 89922643, 4, 640x360 
0x1382CA98, 37353948814698232, 89922661, 89922668, 7, 640x360 
0x1382CA98, 37353948815014352, 89922694, 89922697, 3, 640x360 
0x1382CA98, 37353948815334368, 89922729, 89922732, 3, 640x360 
0x1382CA98, 37353948815655328, 89922761, 89922765, 4, 640x360 
0x1382CA98, 37353948815981304, 89922794, 89922804, 10, 640x360 
0x1382CA98, 37353948816306936, 89922833, 89922835, 2, 640x360 
0x1382CA98, 37353948816619880, 89922861, 89922868, 7, 640x360 
0x1382CA98, 37353948816946320, 89922885, 89922892, 7, 640x360 
0x1382CA98, 37353948817258616, 89922926, 89922931, 5, 640x360 
0x1382CA98, 37353948817575408, 89922951, 89922953, 2, 640x360 
0x1382CA98, 37353948818054048, 89923006, 89923009, 3, 640x360 
0x1382CA98, 37353948818377496, 89923038, 89923043, 5, 640x360 
0x1382CA98, 37353948818698400, 89923071, 89923081, 10, 640x360 
0x1382CA98, 37353948819016040, 89923101, 89923104, 3, 640x360 
0x1382CA98, 37353948819337704, 89923132, 89923141, 9, 640x360 
0x1382CA98, 37353948819654792, 89923154, 89923164, 10, 640x360 
0x1382CA98, 37353948819974328, 89923203, 89923210, 7, 640x360 
0x1382CA98, 37353948820295512, 89923220, 89923231, 11, 640x360 
0x1382CA98, 37353948820618408, 89923259, 89923267, 8, 640x360 
0x1382CA98, 37353948820945576, 89923284, 89923288, 4, 640x360 
0x1382CA98, 37353948821276672, 89923323, 89923332, 9, 640x360 
0x1382CA98, 37353948821604728, 89923373, 89923376, 3, 640x360 
0x1382CA98, 37353948822055768, 89923399, 89923403, 4, 640x360 
0x1382CA98, 37353948822375336, 89923433, 89923436, 3, 640x360 
0x1382CA98, 37353948822698544, 89923465, 89923468, 3, 640x360 
0x1382CA98, 37353948823018680, 89923502, 89923504, 2, 640x360 
0x1382CA98, 37353948823334376, 89923529, 89923538, 9, 640x360 
0x1382CA98, 37353948823654216, 89923561, 89923564, 3, 640x360 
0x1382CA98, 37353948823974232, 89923593, 89923595, 2, 640x360 
0x1382CA98, 37353948824298080, 89923624, 89923632, 8, 640x360 
0x1382CA98, 37353948824619592, 89923664, 89923670, 6, 640x360 
0x1382CA98, 37353948824950920, 89923685, 89923688, 3, 640x360 
0x1382CA98, 37353948825269176, 89923725, 89923728, 3, 640x360 
0x1382CA98, 37353948825575144, 89923756, 89923760, 4, 640x360 
0x1382CA98, 37353948826058224, 89923795, 89923798, 3, 640x360 
0x1382CA98, 37353948826374592, 89923831, 89923845, 14, 640x360 
0x1382CA98, 37353948826696416, 89923865, 89923868, 3, 640x360 
0x1382CA98, 37353948827029128, 89923899, 89923901, 2, 640x360 
0x1382CA98, 37353948827339232, 89923929, 89923932, 3, 640x360 
0x1382CA98, 37353948827660176, 89923962, 89923972, 10, 640x360 
0x1382CA98, 37353948827982192, 89923995, 89924004, 9, 640x360 
0x1382CA98, 37353948828298024, 89924039, 89924042, 3, 640x360 
0x1382CA98, 37353948828615280, 89924057, 89924065, 8, 640x360 
0x1382CA98, 37353948828978736, 89924107, 89924116, 9, 640x360 
0x1382CA98, 37353948829272600, 89924122, 89924128, 6, 640x360 
0x1382CA98, 37353948829576184, 89924157, 89924165, 8, 640x360 
0x1382CA98, 37353948830053624, 89924199, 89924201, 2, 640x360 
0x1382CA98, 37353948830379824, 89924231, 89924234, 3, 640x360 
0x1382CA98, 37353948830698280, 89924268, 89924270, 2, 640x360 
0x1382CA98, 37353948831014488, 89924290, 89924294, 4, 640x360 
0x1382CA98, 37353948831334640, 89924339, 89924343, 4, 640x360 
0x1382CA98, 37353948831658736, 89924362, 89924365, 3, 640x360 
0x1382CA98, 37353948831974896, 89924393, 89924396, 3, 640x360 
0x1382CA98, 37353948832299368, 89924421, 89924433, 12, 640x360 
0x1382CA98, 37353948832623352, 89924452, 89924456, 4, 640x360 
0x1382CA98, 37353948832944256, 89924485, 89924488, 3, 640x360 
0x1382CA98, 37353948833259184, 89924518, 89924521, 3, 640x360 
0x1382CA98, 37353948833576992, 89924558, 89924561, 3, 640x360 
0x1382CA98, 37353948834054424, 89924598, 89924601, 3, 640x360 
0x1382CA98, 37353948834374512, 89924629, 89924636, 7, 640x360 
0x1382CA98, 37353948834694544, 89924664, 89924666, 2, 640x360 
0x1382CA98, 37353948835015912, 89924693, 89924703, 10, 640x360 
0x1382CA98, 37353948835349896, 89924730, 89924733, 3, 640x360 
0x1382CA98, 37353948835658840, 89924755, 89924771, 16, 640x360 
0x1382CA98, 37353948835974312, 89924786, 89924793, 7, 640x360 
0x1382CA98, 37353948836293920, 89924828, 89924832, 4, 640x360 
0x1382CA98, 37353948836620056, 89924855, 89924858, 3, 640x360 
0x1382CA98, 37353948836936840, 89924886, 89924891, 5, 640x360 
0x1382CA98, 37353948837255312, 89924918, 89924921, 3, 640x360 
0x1382CA98, 37353948837575112, 89924955, 89924965, 10, 640x360 
0x1382CA98, 37353948837894976, 89924983, 89924986, 3, 640x360 
0x1382CA98, 37353948838378104, 89925034, 89925036, 2, 640x360 
0x1382CA98, 37353948838697520, 89925065, 89925067, 2, 640x360 
0x1382CA98, 37353948839017864, 89925097, 89925099, 2, 640x360 
0x1382CA98, 37353948839339232, 89925128, 89925130, 2, 640x360 
0x1382CA98, 37353948839654592, 89925162, 89925169, 7, 640x360 
0x1382CA98, 37353948839975376, 89925188, 89925191, 3, 640x360 
0x1382CA98, 37353948840298040, 89925220, 89925225, 5, 640x360 
0x1382CA98, 37353948840614744, 89925251, 89925253, 2, 640x360 
0x1382CA98, 37353948840942160, 89925283, 89925285, 2, 640x360 
0x1382CA98, 37353948841260560, 89925316, 89925318, 2, 640x360 
0x1382CA98, 37353948841577136, 89925349, 89925352, 3, 640x360 
0x1382CA98, 37353948841899288, 89925382, 89925384, 2, 640x360 
0x1382CA98, 37353948842378816, 89925441, 89925443, 2, 640x360 
0x1382CA98, 37353948842696240, 89925462, 89925467, 5, 640x360 
0x1382CA98, 37353948843014312, 89925496, 89925498, 2, 640x360 
0x1382CA98, 37353948843342016, 89925527, 89925539, 12, 640x360 
0x1382CA98, 37353948843654832, 89925559, 89925562, 3, 640x360 
0x1382CA98, 37353948843974584, 89925584, 89925586, 2, 640x360 
0x1382CA98, 37353948844294648, 89925628, 89925631, 3, 640x360 
0x1382CA98, 37353948844617216, 89925658, 89925661, 3, 640x360 
0x1382CA98, 37353948844941344, 89925685, 89925701, 16, 640x360 
0x1382CA98, 37353948845263792, 89925719, 89925723, 4, 640x360 
0x1382CA98, 37353948845604720, 89925756, 89925763, 7, 640x360 
0x1382CA98, 37353948845898128, 89925793, 89925795, 2, 640x360 
0x1382CA98, 37353948846378056, 89925834, 89925837, 3, 640x360 
0x1382CA98, 37353948846694160, 89925869, 89925873, 4, 640x360 
0x1382CA98, 37353948847034040, 89925900, 89925902, 2, 640x360 
0x1382CA98, 37353948847342464, 89925930, 89925932, 2, 640x360 
0x1382CA98, 37353948847654624, 89925963, 89925965, 2, 640x360 
0x1382CA98, 37353948848000488, 89925999, 89926004, 5, 640x360 
0x1382CA98, 37353948848294368, 89926029, 89926032, 3, 640x360 
0x1382CA98, 37353948848630224, 89926064, 89926066, 2, 640x360 
0x1382CA98, 37353948848968760, 89926094, 89926096, 2, 640x360 
0x1382CA98, 37353948849257624, 89926114, 89926116, 2, 640x360 
0x1382CA98, 37353948849574576, 89926158, 89926161, 3, 640x360 
0x1382CA98, 37353948849898088, 89926190, 89926192, 2, 640x360 
0x1382CA98, 37353948850378408, 89926233, 89926236, 3, 640x360 
0x1382CA98, 37353948850714760, 89926265, 89926268, 3, 640x360 
0x1382CA98, 37353948851014408, 89926301, 89926303, 2, 640x360 
0x1382CA98, 37353948851333864, 89926327, 89926330, 3, 640x360 
0x1382CA98, 37353948851653576, 89926363, 89926365, 2, 640x360 
0x1382CA98, 37353948851983280, 89926400, 89926413, 13, 640x360 
0x1382CA98, 37353948852297832, 89926434, 89926435, 1, 640x360 
0x1382CA98, 37353948852619920, 89926460, 89926468, 8, 640x360 
0x1382CA98, 37353948852934040, 89926492, 89926495, 3, 640x360 
0x1382CA98, 37353948853254368, 89926519, 89926525, 6, 640x360 
0x1382CA98, 37353948853574816, 89926559, 89926562, 3, 640x360 
0x1382CA98, 37353948853896720, 89926582, 89926585, 3, 640x360 
0x1382CA98, 37353948854373536, 89926635, 89926637, 2, 640x360 
0x1382CA98, 37353948854695928, 89926674, 89926680, 6, 640x360 
0x1382CA98, 37353948855015848, 89926695, 89926702, 7, 640x360 
0x1382CA98, 37353948855344160, 89926734, 89926736, 2, 640x360 
0x1382CA98, 37353948855654504, 89926762, 89926771, 9, 640x360 
0x1382CA98, 37353948855978136, 89926811, 89926822, 11, 640x360 
0x1382CA98, 37353948856317424, 89926831, 89926841, 10, 640x360 
0x1382CA98, 37353948856624152, 89926868, 89926875, 7, 640x360 
0x1382CA98, 37353948856944912, 89926897, 89926899, 2, 640x360 
0x1382CA98, 37353948857273920, 89926916, 89926918, 2, 640x360 
0x1382CA98, 37353948857574184, 89926957, 89926960, 3, 640x360 
0x1382CA98, 37353948857897568, 89926983, 89926987, 4, 640x360 
0x1382CA98, 37353948858373824, 89927031, 89927033, 2, 640x360 
0x1382CA98, 37353948858696664, 89927065, 89927069, 4, 640x360 
0x1382CA98, 37353948859014264, 89927096, 89927102, 6, 640x360 
0x1382CA98, 37353948859339312, 89927131, 89927134, 3, 640x360 
0x1382CA98, 37353948859665608, 89927169, 89927172, 3, 640x360 
0x1382CA98, 37353948859973240, 89927194, 89927204, 10, 640x360 
0x1382CA98, 37353948860293480, 89927220, 89927232, 12, 640x360 
0x1382CA98, 37353948860613616, 89927256, 89927264, 8, 640x360 
0x1382CA98, 37353948860939512, 89927291, 89927294, 3, 640x360 
0x1382CA98, 37353948861260776, 89927323, 89927326, 3, 640x360 
0x1382CA98, 37353948861574232, 89927355, 89927359, 4, 640x360 
0x1382CA98, 37353948861899552, 89927380, 89927382, 2, 640x360 
0x1382CA98, 37353948862373848, 89927438, 89927442, 4, 640x360 
0x1382CA98, 37353948862694144, 89927461, 89927467, 6, 640x360 
0x1382CA98, 37353948863014008, 89927495, 89927497, 2, 640x360 
0x1382CA98, 37353948863349184, 89927529, 89927531, 2, 640x360 
0x1382CA98, 37353948863665472, 89927565, 89927567, 2, 640x360 
0x1382CA98, 37353948863991032, 89927595, 89927597, 2, 640x360 
0x1382CA98, 37353948864315856, 89927630, 89927632, 2, 640x360 
0x1382CA98, 37353948864638632, 89927652, 89927657, 5, 640x360 
0x1382CA98, 37353948864934960, 89927683, 89927685, 2, 640x360 
0x1382CA98, 37353948865270208, 89927721, 89927726, 5, 640x360 
0x1382CA98, 37353948865575672, 89927754, 89927765, 11, 640x360 
0x1382CA98, 37353948865894352, 89927784, 89927787, 3, 640x360 
0x1382CA98, 37353948866214344, 89927816, 89927818, 2, 640x360 
0x1382CA98, 37353948866693792, 89927867, 89927869, 2, 640x360 
0x1382CA98, 37353948867017808, 89927895, 89927897, 2, 640x360 
0x1382CA98, 37353948867334256, 89927928, 89927938, 10, 640x360 
0x1382CA98, 37353948867654464, 89927953, 89927960, 7, 640x360 
0x1382CA98, 37353948867974088, 89927989, 89927992, 3, 640x360 
0x1382CA98, 37353948868294448, 89928020, 89928023, 3, 640x360 
0x1382CA98, 37353948868617504, 89928051, 89928055, 4, 640x360 
0x1382CA98, 37353948868934840, 89928083, 89928086, 3, 640x360 
0x1382CA98, 37353948869253808, 89928120, 89928124, 4, 640x360 
0x1382CA98, 37353948869574296, 89928150, 89928153, 3, 640x360 
0x1382CA98, 37353948869894344, 89928181, 89928183, 2, 640x360 
0x1382CA98, 37353948870223720, 89928213, 89928215, 2, 640x360 
0x1382CA98, 37353948870693560, 89928260, 89928263, 3, 640x360 
0x1382CA98, 37353948871017224, 89928293, 89928296, 3, 640x360 
0x1382CA98, 37353948871333528, 89928326, 89928329, 3, 640x360 
0x1382CA98, 37353948871654336, 89928362, 89928368, 6, 640x360 
0x1382CA98, 37353948871973880, 89928416, 89928426, 10, 640x360 
0x1382CA98, 37353948872293920, 89928439, 89928451, 12, 640x360 
0x1382CA98, 37353948872647704, 89928465, 89928477, 12, 640x360 
0x1382CA98, 37353948872939424, 89928492, 89928499, 7, 640x360 
0x1382CA98, 37353948873263784, 89928533, 89928541, 8, 640x360 
0x1382CA98, 37353948873595856, 89928566, 89928575, 9, 640x360 
0x1382CA98, 37353948873895520, 89928589, 89928602, 13, 640x360 
0x1382CA98, 37353948874229216, 89928628, 89928630, 2, 640x360 
0x1382CA98, 37353948874693056, 89928675, 89928684, 9, 640x360 
0x1382CA98, 37353948875021240, 89928709, 89928718, 9, 640x360 
0x1382CA98, 37353948875333472, 89928728, 89928734, 6, 640x360 
0x1382CA98, 37353948875655392, 89928767, 89928768, 1, 640x360 
0x1382CA98, 37353948875976248, 89928792, 89928797, 5, 640x360 
0x1382CA98, 37353948876295112, 89928826, 89928835, 9, 640x360 
0x1382CA98, 37353948876631280, 89928859, 89928862, 3, 640x360 
0x1382CA98, 37353948876936592, 89928885, 89928886, 1, 640x360 
0x1382CA98, 37353948877261896, 89928916, 89928918, 2, 640x360 
0x1382CA98, 37353948877573904, 89928949, 89928951, 2, 640x360 
0x1382CA98, 37353948877893088, 89928983, 89928985, 2, 640x360 
0x1382CA98, 37353948878213944, 89929018, 89929020, 2, 640x360 
0x1382CA98, 37353948878692752, 89929066, 89929068, 2, 640x360 
0x1382CA98, 37353948879014400, 89929096, 89929099, 3, 640x360 
0x1382CA98, 37353948879344872, 89929127, 89929138, 11, 640x360 
0x1382CA98, 37353948879657808, 89929167, 89929173, 6, 640x360 
0x1382CA98, 37353948879973760, 89929192, 89929196, 4, 640x360 
0x1382CA98, 37353948880298464, 89929235, 89929238, 3, 640x360 
0x1382CA98, 37353948880617176, 89929265, 89929267, 2, 640x360 
0x1382CA98, 37353948880945104, 89929292, 89929294, 2, 640x360 
0x1382CA98, 37353948881259560, 89929317, 89929320, 3, 640x360 
0x1382CA98, 37353948881574216, 89929348, 89929351, 3, 640x360 
0x1382CA98, 37353948881893392, 89929383, 89929386, 3, 640x360 
0x1382CA98, 37353948882216632, 89929412, 89929414, 2, 640x360 
0x1382CA98, 37353948882693472, 89929459, 89929465, 6, 640x360 
0x1382CA98, 37353948883013272, 89929496, 89929498, 2, 640x360 
0x1382CA98, 37353948883338608, 89929528, 89929533, 5, 640x360 
0x1382CA98, 37353948883658096, 89929555, 89929558, 3, 640x360 
0x1382CA98, 37353948883977944, 89929588, 89929593, 5, 640x360 
0x1382CA98, 37353948884300208, 89929626, 89929634, 8, 640x360 
0x1382CA98, 37353948884623688, 89929668, 89929669, 1, 640x360 
0x1382CA98, 37353948884940984, 89929685, 89929687, 2, 640x360 
0x1382CA98, 37353948885259088, 89929717, 89929721, 4, 640x360 
0x1382CA98, 37353948885574008, 89929758, 89929761, 3, 640x360 
0x1382CA98, 37353948885893144, 89929789, 89929792, 3, 640x360 
0x1382CA98, 37353948886213456, 89929818, 89929821, 3, 640x360 
0x1382CA98, 37353948886696920, 89929861, 89929871, 10, 640x360 
0x1382CA98, 37353948887012384, 89929894, 89929896, 2, 640x360 
0x1382CA98, 37353948887338984, 89929935, 89929937, 2, 640x360 
0x1382CA98, 37353948887655504, 89929967, 89929968, 1, 640x360 
0x1382CA98, 37353948887985824, 89930002, 89930008, 6, 640x360 
0x1382CA98, 37353948888299176, 89930031, 89930037, 6, 640x360 
0x1382CA98, 37353948888614936, 89930073, 89930082, 9, 640x360 
0x1382CA98, 37353948888954752, 89930098, 89930108, 10, 640x360 
0x1382CA98, 37353948889277944, 89930145, 89930164, 19, 640x360 
0x1382CA98, 37353948889644568, 89930231, 89930236, 5, 640x360 
0x1382CA98, 37353948890555192, 89930266, 89930268, 2, 640x360 
0x1382CA98, 37353948891032360, 89930305, 89930310, 5, 640x360 
0x1382CA98, 37353948891333544, 89930328, 89930331, 3, 640x360 
0x1382CA98, 37353948891652792, 89930369, 89930372, 3, 640x360 
0x1382CA98, 37353948891972616, 89930401, 89930403, 2, 640x360 
0x1382CA98, 37353948892293664, 89930418, 89930425, 7, 640x360 
0x1382CA98, 37353948892613128, 89930450, 89930453, 3, 640x360 
0x1382CA98, 37353948892935904, 89930483, 89930491, 8, 640x360 
0x1382CA98, 37353948893256592, 89930534, 89930538, 4, 640x360 
0x1382CA98, 37353948893574552, 89930566, 89930568, 2, 640x360 
0x1382CA98, 37353948893893992, 89930586, 89930604, 18, 640x360 
0x1382CA98, 37353948894224392, 89930618, 89930620, 2, 640x360 
0x1382CA98, 37353948894532736, 89930651, 89930654, 3, 640x360 
0x1382CA98, 37353948895016216, 89930701, 89930703, 2, 640x360 
0x1382CA98, 37353948895352728, 89930736, 89930743, 7, 640x360 
0x1382CA98, 37353948895652272, 89930772, 89930777, 5, 640x360 
0x1382CA98, 37353948895980088, 89930796, 89930798, 2, 640x360 
0x1382CA98, 37353948896296344, 89930823, 89930833, 10, 640x360 
0x1382CA98, 37353948896620224, 89930851, 89930855, 4, 640x360 
0x1382CA98, 37353948896933104, 89930881, 89930884, 3, 640x360 
0x1382CA98, 37353948897265872, 89930921, 89930924, 3, 640x360 
0x1382CA98, 37353948897573016, 89930954, 89930958, 4, 640x360 
0x1382CA98, 37353948897896640, 89930996, 89930998, 2, 640x360 
0x1382CA98, 37353948898217176, 89931015, 89931018, 3, 640x360 
0x1382CA98, 37353948898536104, 89931046, 89931049, 3, 640x360 
0x1382CA98, 37353948899020704, 89931092, 89931096, 4, 640x360 
0x1382CA98, 37353948899337288, 89931128, 89931142, 14, 640x360 
0x1382CA98, 37353948899655976, 89931155, 89931161, 6, 640x360 
0x1382CA98, 37353948899983832, 89931190, 89931200, 10, 640x360 
0x1382CA98, 37353948900302880, 89931218, 89931222, 4, 640x360 
0x1382CA98, 37353948900613488, 89931257, 89931264, 7, 640x360 
0x1382CA98, 37353948900939840, 89931283, 89931286, 3, 640x360 
0x1382CA98, 37353948901260256, 89931317, 89931320, 3, 640x360 
0x1382CA98, 37353948901573840, 89931363, 89931368, 5, 640x360 
0x1382CA98, 37353948901897248, 89931391, 89931393, 2, 640x360 
0x1382CA98, 37353948902216616, 89931418, 89931423, 5, 640x360 
0x1382CA98, 37353948902533128, 89931455, 89931459, 4, 640x360 
0x1382CA98, 37353948903016912, 89931496, 89931502, 6, 640x360 
0x1382CA98, 37353948903337304, 89931524, 89931527, 3, 640x360 
0x1382CA98, 37353948903654696, 89931558, 89931561, 3, 640x360 
0x1382CA98, 37353948903972408, 89931591, 89931593, 2, 640x360 
0x1382CA98, 37353948904293416, 89931633, 89931641, 8, 640x360 
0x1382CA98, 37353948904658272, 89931679, 89931689, 10, 640x360 
0x1382CA98, 37353948904960552, 89931699, 89931704, 5, 640x360 
0x1382CA98, 37353948905273448, 89931720, 89931726, 6, 640x360 
0x1382CA98, 37353948905576408, 89931760, 89931762, 2, 640x360 
0x1382CA98, 37353948905899160, 89931784, 89931786, 2, 640x360 
0x1382CA98, 37353948906213384, 89931811, 89931818, 7, 640x360 
0x1382CA98, 37353948906532312, 89931859, 89931866, 7, 640x360 
0x1382CA98, 37353948907021408, 89931895, 89931901, 6, 640x360 
0x1382CA98, 37353948907331976, 89931928, 89931930, 2, 640x360 
0x1382CA98, 37353948907654632, 89931960, 89931962, 2, 640x360 
0x1382CA98, 37353948907972248, 89931996, 89932002, 6, 640x360 
0x1382CA98, 37353948908292992, 89932024, 89932026, 2, 640x360 
0x1382CA98, 37353948908612544, 89932054, 89932059, 5, 640x360 
0x1382CA98, 37353948908953016, 89932086, 89932090, 4, 640x360 
0x1382CA98, 37353948909282528, 89932122, 89932126, 4, 640x360 
0x1382CA98, 37353948909642720, 89932159, 89932165, 6, 640x360 
0x1382CA98, 37353948909893480, 89932183, 89932185, 2, 640x360 
0x1382CA98, 37353948910212896, 89932215, 89932217, 2, 640x360 
0x1382CA98, 37353948910532544, 89932250, 89932258, 8, 640x360 
0x1382CA98, 37353948911011968, 89932302, 89932304, 2, 640x360 
0x1382CA98, 37353948911331904, 89932334, 89932338, 4, 640x360 
0x1382CA98, 37353948911652488, 89932362, 89932374, 12, 640x360 
0x1382CA98, 37353948911977968, 89932401, 89932404, 3, 640x360 
0x1382CA98, 37353948912293504, 89932439, 89932442, 3, 640x360 
0x1382CA98, 37353948912625184, 89932461, 89932464, 3, 640x360 
0x1382CA98, 37353948912942680, 89932494, 89932496, 2, 640x360 
0x1382CA98, 37353948913256224, 89932521, 89932527, 6, 640x360 
0x1382CA98, 37353948913577056, 89932547, 89932549, 2, 640x360 
0x1382CA98, 37353948913892232, 89932581, 89932587, 6, 640x360 
0x1382CA98, 37353948914212712, 89932619, 89932624, 5, 640x360 
0x1382CA98, 37353948914544200, 89932649, 89932651, 2, 640x360 
0x1382CA98, 37353948915015512, 89932694, 89932700, 6, 640x360 
0x1382CA98, 37353948915332600, 89932729, 89932735, 6, 640x360 
0x1382CA98, 37353948915656448, 89932762, 89932765, 3, 640x360 
0x1382CA98, 37353948915977016, 89932795, 89932801, 6, 640x360 
0x1382CA98, 37353948916292784, 89932819, 89932830, 11, 640x360 
0x1382CA98, 37353948916615960, 89932850, 89932852, 2, 640x360 
0x1382CA98, 37353948916936952, 89932885, 89932892, 7, 640x360 
0x1382CA98, 37353948917256432, 89932918, 89932923, 5, 640x360 
0x1382CA98, 37353948917575072, 89932953, 89932963, 10, 640x360 
0x1382CA98, 37353948917895640, 89932983, 89932985, 2, 640x360 
0x1382CA98, 37353948918212792, 89933014, 89933016, 2, 640x360 
0x1382CA98, 37353948918532512, 89933048, 89933050, 2, 640x360 
0x1382CA98, 37353948919338336, 89933137, 89933145, 8, 640x360 
0x1382CA98, 37353948919656256, 89933168, 89933170, 2, 640x360 
0x1382CA98, 37353948919977776, 89933197, 89933199, 2, 640x360 
0x1382CA98, 37353948920296624, 89933231, 89933232, 1, 640x360 
0x1382CA98, 37353948920617280, 89933263, 89933264, 1, 640x360 
0x1382CA98, 37353948920938896, 89933296, 89933298, 2, 640x360 
0x1382CA98, 37353948921272656, 89933324, 89933328, 4, 640x360 
0x1382CA98, 37353948921572392, 89933352, 89933357, 5, 640x360 
0x1382CA98, 37353948921891888, 89933381, 89933384, 3, 640x360 
0x1382CA98, 37353948922216472, 89933417, 89933419, 2, 640x360 
0x1382CA98, 37353948922534120, 89933455, 89933473, 18, 640x360 
0x1382CA98, 37353948922878224, 89933490, 89933505, 15, 640x360 
0x1382CA98, 37353948923332296, 89933534, 89933538, 4, 640x360 
0x1382CA98, 37353948923657448, 89933564, 89933566, 2, 640x360 
0x1382CA98, 37353948923984880, 89933600, 89933602, 2, 640x360 
0x1382CA98, 37353948924297744, 89933625, 89933628, 3, 640x360 
0x1382CA98, 37353948924625440, 89933656, 89933660, 4, 640x360 
0x1382CA98, 37353948924935464, 89933688, 89933692, 4, 640x360 
0x1382CA98, 37353948925269952, 89933723, 89933726, 3, 640x360 
0x1382CA98, 37353948925576624, 89933755, 89933760, 5, 640x360 
0x1382CA98, 37353948925891760, 89933788, 89933792, 4, 640x360 
0x1382CA98, 37353948926211848, 89933811, 89933817, 6, 640x360 
0x1382CA98, 37353948926538456, 89933854, 89933858, 4, 640x360 
0x1382CA98, 37353948926852160, 89933878, 89933885, 7, 640x360 
0x1382CA98, 37353948927331392, 89933927, 89933944, 17, 640x360 
0x1382CA98, 37353948927652072, 89933960, 89933963, 3, 640x360 
0x1382CA98, 37353948927971736, 89933992, 89933995, 3, 640x360 
0x1382CA98, 37353948928293736, 89934032, 89934038, 6, 640x360 
0x1382CA98, 37353948928621056, 89934053, 89934065, 12, 640x360 
0x1382CA98, 37353948928939184, 89934093, 89934096, 3, 640x360 
0x1382CA98, 37353948929258352, 89934125, 89934134, 9, 640x360 
0x1382CA98, 37353948929573752, 89934167, 89934171, 4, 640x360 
0x1382CA98, 37353948929891968, 89934185, 89934188, 3, 640x360 
0x1382CA98, 37353948930215528, 89934219, 89934225, 6, 640x360 
0x1382CA98, 37353948930531880, 89934250, 89934256, 6, 640x360 
0x1382CA98, 37353948930851872, 89934281, 89934282, 1, 640x360 
0x1382CA98, 37353948931331064, 89934334, 89934336, 2, 640x360 
0x1382CA98, 37353948931656544, 89934364, 89934365, 1, 640x360 
0x1382CA98, 37353948931976120, 89934400, 89934402, 2, 640x360 
0x1382CA98, 37353948932292088, 89934428, 89934430, 2, 640x360 
0x1382CA98, 37353948932619016, 89934453, 89934457, 4, 640x360 
0x1382CA98, 37353948932937248, 89934489, 89934491, 2, 640x360 
0x1382CA98, 37353948933261384, 89934526, 89934528, 2, 640x360 
0x1382CA98, 37353948933576104, 89934549, 89934551, 2, 640x360 
0x1382CA98, 37353948933895328, 89934591, 89934594, 3, 640x360 
0x1382CA98, 37353948934213632, 89934619, 89934621, 2, 640x360 
0x1382CA98, 37353948934534272, 89934645, 89934652, 7, 640x360 
0x1382CA98, 37353948934862984, 89934681, 89934683, 2, 640x360 
0x1382CA98, 37353948935336608, 89934733, 89934735, 2, 640x360 
0x1382CA98, 37353948935679528, 89934763, 89934776, 13, 640x360 
0x1382CA98, 37353948935976536, 89934797, 89934800, 3, 640x360 
0x1382CA98, 37353948936293064, 89934820, 89934827, 7, 640x360 
0x1382CA98, 37353948936617536, 89934854, 89934861, 7, 640x360 
0x1382CA98, 37353948936946440, 89934884, 89934888, 4, 640x360 
0x1382CA98, 37353948937282320, 89934921, 89934927, 6, 640x360 
0x1382CA98, 37353948937592872, 89934953, 89934958, 5, 640x360 
0x1382CA98, 37353948937895776, 89934985, 89934990, 5, 640x360 
0x1382CA98, 37353948938215664, 89935011, 89935014, 3, 640x360 
0x1382CA98, 37353948938540408, 89935054, 89935058, 4, 640x360 
0x1382CA98, 37353948938855720, 89935077, 89935083, 6, 640x360 
0x1382CA98, 37353948939331808, 89935134, 89935145, 11, 640x360 
0x1382CA98, 37353948939653472, 89935168, 89935183, 15, 640x360 
0x1382CA98, 37353948939982400, 89935196, 89935199, 3, 640x360 
0x1382CA98, 37353948940338536, 89935228, 89935231, 3, 640x360 
0x1382CA98, 37353948940671960, 89935262, 89935264, 2, 640x360 
0x1382CA98, 37353948940937976, 89935291, 89935294, 3, 640x360 
0x1382CA98, 37353948941258064, 89935321, 89935332, 11, 640x360 
0x1382CA98, 37353948941574672, 89935352, 89935355, 3, 640x360 
0x1382CA98, 37353948941891336, 89935388, 89935392, 4, 640x360 
0x1382CA98, 37353948942214928, 89935418, 89935426, 8, 640x360 
0x1382CA98, 37353948942533656, 89935451, 89935452, 1, 640x360 
0x1382CA98, 37353948942851600, 89935478, 89935484, 6, 640x360 
0x1382CA98, 37353948943336560, 89935534, 89935536, 2, 640x360 
0x1382CA98, 37353948943656760, 89935562, 89935573, 11, 640x360 
0x1382CA98, 37353948943978264, 89935597, 89935599, 2, 640x360 
0x1382CA98, 37353948944291008, 89935627, 89935636, 9, 640x360 
0x1382CA98, 37353948944611776, 89935665, 89935678, 13, 640x360 
0x1382CA98, 37353948944948344, 89935704, 89935709, 5, 640x360 
0x1382CA98, 37353948945261392, 89935734, 89935736, 2, 640x360 
0x1382CA98, 37353948945581592, 89935755, 89935760, 5, 640x360 
0x1382CA98, 37353948945892784, 89935798, 89935808, 10, 640x360 
0x1382CA98, 37353948946215312, 89935827, 89935830, 3, 640x360 
0x1382CA98, 37353948946535760, 89935853, 89935861, 8, 640x360 
0x1382CA98, 37353948946866056, 89935885, 89935892, 7, 640x360 
0x1382CA98, 37353948947175576, 89935914, 89935916, 2, 640x360 
0x1382CA98, 37353948947656320, 89935962, 89935969, 7, 640x360 
0x1382CA98, 37353948947976936, 89935998, 89936000, 2, 640x360 
0x1382CA98, 37353948948321400, 89936022, 89936027, 5, 640x360 
0x1382CA98, 37353948948610904, 89936053, 89936068, 15, 640x360 
0x1382CA98, 37353948948946320, 89936084, 89936087, 3, 640x360 
0x1382CA98, 37353948949268072, 89936117, 89936121, 4, 640x360 
0x1382CA98, 37353948949571600, 89936162, 89936172, 10, 640x360 
0x1382CA98, 37353948949943024, 89936186, 89936191, 5, 640x360 
0x1382CA98, 37353948950216432, 89936224, 89936227, 3, 640x360 
0x1382CA98, 37353948950531368, 89936247, 89936252, 5, 640x360 
0x1382CA98, 37353948950851216, 89936279, 89936286, 7, 640x360 
0x1382CA98, 37353948951171288, 89936310, 89936312, 2, 640x360 
0x1382CA98, 37353948951650752, 89936354, 89936366, 12, 640x360 
0x1382CA98, 37353948951975080, 89936395, 89936402, 7, 640x360 
0x1382CA98, 37353948952291328, 89936420, 89936424, 4, 640x360 
0x1382CA98, 37353948952610824, 89936457, 89936462, 5, 640x360 
0x1382CA98, 37353948952939496, 89936496, 89936499, 3, 640x360 
0x1382CA98, 37353948953266568, 89936523, 89936535, 12, 640x360 
0x1382CA98, 37353948953573352, 89936559, 89936562, 3, 640x360 
0x1382CA98, 37353948953913816, 89936583, 89936585, 2, 640x360 
0x1382CA98, 37353948954212304, 89936621, 89936632, 11, 640x360 
0x1382CA98, 37353948954531000, 89936645, 89936647, 2, 640x360 
0x1382CA98, 37353948954851728, 89936689, 89936694, 5, 640x360 
0x1382CA98, 37353948955179600, 89936711, 89936713, 2, 640x360 
0x1382CA98, 37353948955654544, 89936756, 89936766, 10, 640x360 
0x1382CA98, 37353948955972600, 89936801, 89936803, 2, 640x360 
0x1382CA98, 37353948956291088, 89936826, 89936834, 8, 640x360 
0x1382CA98, 37353948956615040, 89936863, 89936870, 7, 640x360 
0x1382CA98, 37353948956936584, 89936893, 89936896, 3, 640x360 
0x1382CA98, 37353948957251264, 89936926, 89936929, 3, 640x360 
0x1382CA98, 37353948957571616, 89936957, 89936961, 4, 640x360 
0x1382CA98, 37353948957894536, 89936993, 89936995, 2, 640x360 
0x1382CA98, 37353948958211728, 89937020, 89937025, 5, 640x360 
0x1382CA98, 37353948958544944, 89937050, 89937052, 2, 640x360 
0x1382CA98, 37353948958856400, 89937081, 89937083, 2, 640x360 
0x1382CA98, 37353948959175520, 89937114, 89937120, 6, 640x360 
0x1382CA98, 37353948959658456, 89937162, 89937165, 3, 640x360 
0x1382CA98, 37353948959975440, 89937195, 89937201, 6, 640x360 
0x1382CA98, 37353948960295592, 89937230, 89937233, 3, 640x360 
0x1382CA98, 37353948960616560, 89937260, 89937266, 6, 640x360 
0x1382CA98, 37353948960935936, 89937286, 89937290, 4, 640x360 
0x1382CA98, 37353948961253264, 89937315, 89937318, 3, 640x360 
0x1382CA98, 37353948961572488, 89937357, 89937360, 3, 640x360 
0x1382CA98, 37353948961899896, 89937397, 89937399, 2, 640x360 
0x1382CA98, 37353948962211152, 89937415, 89937418, 3, 640x360 
0x1382CA98, 37353948962537040, 89937457, 89937460, 3, 640x360 
0x1382CA98, 37353948962851936, 89937478, 89937481, 3, 640x360 
0x1382CA98, 37353948963171192, 89937519, 89937522, 3, 640x360 
0x1382CA98, 37353948963651024, 89937561, 89937563, 2, 640x360 
0x1382CA98, 37353948963970808, 89937586, 89937589, 3, 640x360 
0x1382CA98, 37353948964291744, 89937620, 89937626, 6, 640x360 
0x1382CA98, 37353948964613216, 89937652, 89937661, 9, 640x360 
0x1382CA98, 37353948964939952, 89937685, 89937689, 4, 640x360 
0x1382CA98, 37353948965254992, 89937717, 89937719, 2, 640x360 
0x1382CA98, 37353948965570944, 89937747, 89937749, 2, 640x360 
0x1382CA98, 37353948965890608, 89937785, 89937786, 1, 640x360 
0x1382CA98, 37353948966210496, 89937818, 89937820, 2, 640x360 
0x1382CA98, 37353948966531792, 89937844, 89937850, 6, 640x360 
0x1382CA98, 37353948966851384, 89937876, 89937879, 3, 640x360 
0x1382CA98, 37353948967171088, 89937919, 89937922, 3, 640x360 
0x1382CA98, 37353948967651056, 89937961, 89937964, 3, 640x360 
0x1382CA98, 37353948967971048, 89937986, 89937991, 5, 640x360 
0x1382CA98, 37353948968295344, 89938019, 89938025, 6, 640x360 
0x1382CA98, 37353948968611560, 89938056, 89938060, 4, 640x360 
0x1382CA98, 37353948968961960, 89938087, 89938099, 12, 640x360 
0x1382CA98, 37353948969251592, 89938119, 89938128, 9, 640x360 
0x1382CA98, 37353948969578096, 89938161, 89938163, 2, 640x360 
0x1382CA98, 37353948969890360, 89938183, 89938185, 2, 640x360 
0x1382CA98, 37353948970211248, 89938226, 89938235, 9, 640x360 
0x1382CA98, 37353948970531632, 89938247, 89938249, 2, 640x360 
0x1382CA98, 37353948970850560, 89938280, 89938283, 3, 640x360 
0x1382CA98, 37353948971170552, 89938318, 89938322, 4, 640x360 
0x1382CA98, 37353948971652576, 89938368, 89938371, 3, 640x360 
0x1382CA98, 37353948971970696, 89938398, 89938406, 8, 640x360 
0x1382CA98, 37353948972290416, 89938418, 89938421, 3, 640x360 
0x1382CA98, 37353948972614368, 89938458, 89938461, 3, 640x360 
0x1382CA98, 37353948972936264, 89938484, 89938486, 2, 640x360 
0x1382CA98, 37353948973253424, 89938527, 89938530, 3, 640x360 
0x1382CA98, 37353948973575368, 89938555, 89938559, 4, 640x360 
0x1382CA98, 37353948973890320, 89938586, 89938588, 2, 640x360 
0x1382CA98, 37353948974210712, 89938619, 89938621, 2, 640x360 
0x1382CA98, 37353948974530512, 89938644, 89938647, 3, 640x360 
0x1382CA98, 37353948974856488, 89938692, 89938695, 3, 640x360 
0x1382CA98, 37353948975171472, 89938714, 89938724, 10, 640x360 
0x1382CA98, 37353948975491760, 89938756, 89938759, 3, 640x360 
0x1382CA98, 37353948975974576, 89938788, 89938796, 8, 640x360 
0x1382CA98, 37353948976291272, 89938823, 89938832, 9, 640x360 
0x1382CA98, 37353948976624576, 89938861, 89938870, 9, 640x360 
0x1382CA98, 37353948976949616, 89938887, 89938901, 14, 640x360 
0x1382CA98, 37353948977276688, 89938920, 89938928, 8, 640x360 
0x1382CA98, 37353948977576112, 89938958, 89938962, 4, 640x360 
0x1382CA98, 37353948977892952, 89938981, 89938983, 2, 640x360 
0x1382CA98, 37353948978210320, 89939020, 89939025, 5, 640x360 
0x1382CA98, 37353948978541688, 89939059, 89939062, 3, 640x360 
0x1382CA98, 37353948978850424, 89939079, 89939086, 7, 640x360 
0x1382CA98, 37353948979170472, 89939112, 89939115, 3, 640x360 
0x1382CA98, 37353948979490408, 89939137, 89939145, 8, 640x360 
0x1382CA98, 37353948979974624, 89939191, 89939198, 7, 640x360 
0x1382CA98, 37353948980290776, 89939224, 89939231, 7, 640x360 
0x1382CA98, 37353948980611200, 89939264, 89939268, 4, 640x360 
0x1382CA98, 37353948980939696, 89939299, 89939301, 2, 640x360 
0x1382CA98, 37353948981252576, 89939321, 89939326, 5, 640x360 
0x1382CA98, 37353948981570568, 89939352, 89939360, 8, 640x360 
0x1382CA98, 37353948981896144, 89939390, 89939392, 2, 640x360 
0x1382CA98, 37353948982212096, 89939416, 89939418, 2, 640x360 
0x1382CA98, 37353948982530672, 89939450, 89939456, 6, 640x360 
0x1382CA98, 37353948982850328, 89939480, 89939482, 2, 640x360 
0x1382CA98, 37353948983174808, 89939522, 89939526, 4, 640x360 
0x1382CA98, 37353948983492024, 89939545, 89939553, 8, 640x360 
0x1382CA98, 37353948983973000, 89939589, 89939593, 4, 640x360 
0x1382CA98, 37353948984290824, 89939620, 89939632, 12, 640x360 
0x1382CA98, 37353948984616152, 89939659, 89939665, 6, 640x360 
0x1382CA98, 37353948984936808, 89939687, 89939700, 13, 640x360 
0x1382CA98, 37353948985255576, 89939723, 89939726, 3, 640x360 
0x1382CA98, 37353948985618632, 89939755, 89939764, 9, 640x360 
0x1382CA98, 37353948985894840, 89939792, 89939801, 9, 640x360 
0x1382CA98, 37353948986219336, 89939813, 89939815, 2, 640x360 
0x1382CA98, 37353948986530240, 89939845, 89939847, 2, 640x360 
0x1382CA98, 37353948986850264, 89939879, 89939881, 2, 640x360 
0x1382CA98, 37353948987170304, 89939917, 89939919, 2, 640x360 
0x1382CA98, 37353948987492120, 89939947, 89939949, 2, 640x360 
0x1382CA98, 37353948987974416, 89939997, 89940007, 10, 640x360 
0x1382CA98, 37353948988291160, 89940021, 89940026, 5, 640x360 
0x1382CA98, 37353948988611216, 89940054, 89940059, 5, 640x360 
0x1382CA98, 37353948988943136, 89940083, 89940086, 3, 640x360 
0x1382CA98, 37353948989260200, 89940123, 89940125, 2, 640x360 
0x1382CA98, 37353948989585616, 89940153, 89940161, 8, 640x360 
0x1382CA98, 37353948989891248, 89940185, 89940189, 4, 640x360 
0x1382CA98, 37353948990214576, 89940211, 89940216, 5, 640x360 
0x1382CA98, 37353948990530672, 89940245, 89940247, 2, 640x360 
0x1382CA98, 37353948990851184, 89940281, 89940283, 2, 640x360 
0x1382CA98, 37353948991171328, 89940321, 89940333, 12, 640x360 
0x1382CA98, 37353948991499976, 89940347, 89940349, 2, 640x360 
0x1382CA98, 37353948991970408, 89940394, 89940399, 5, 640x360 
0x1382CA98, 37353948992290096, 89940418, 89940421, 3, 640x360 
0x1382CA98, 37353948992610760, 89940453, 89940457, 4, 640x360 
0x1382CA98, 37353948992937336, 89940484, 89940487, 3, 640x360 
0x1382CA98, 37353948993253536, 89940517, 89940523, 6, 640x360 
0x1382CA98, 37353948993571272, 89940552, 89940567, 15, 640x360 
0x1382CA98, 37353948993904848, 89940584, 89940588, 4, 640x360 
0x1382CA98, 37353948994210704, 89940625, 89940628, 3, 640x360 
0x1382CA98, 37353948994530256, 89940660, 89940663, 3, 640x360 
0x1382CA98, 37353948994856360, 89940681, 89940694, 13, 640x360 
0x1382CA98, 37353948995175992, 89940715, 89940720, 5, 640x360 
0x1382CA98, 37353948995490528, 89940745, 89940749, 4, 640x360 
0x1382CA98, 37353948995977472, 89940791, 89940796, 5, 640x360 
0x1382CA98, 37353948996290488, 89940836, 89940842, 6, 640x360 
0x1382CA98, 37353948996638112, 89940869, 89940873, 4, 640x360 
0x1382CA98, 37353948996934744, 89940887, 89940900, 13, 640x360 
0x1382CA98, 37353948997284048, 89940929, 89940944, 15, 640x360 
0x1382CA98, 37353948997614928, 89940963, 89940966, 3, 640x360 
0x1382CA98, 37353948997890032, 89940994, 89941002, 8, 640x360 
0x1382CA98, 37353948998220576, 89941016, 89941018, 2, 640x360 
0x1382CA98, 37353948998529800, 89941057, 89941060, 3, 640x360 
0x1382CA98, 37353948998850648, 89941090, 89941094, 4, 640x360 
0x1382CA98, 37353948999174128, 89941124, 89941128, 4, 640x360 
0x1382CA98, 37353948999517512, 89941156, 89941167, 11, 640x360 
0x1382CA98, 37353948999812400, 89941184, 89941192, 8, 640x360 
0x1382CA98, 37353949000290608, 89941236, 89941239, 3, 640x360 
0x1382CA98, 37353949000634792, 89941264, 89941278, 14, 640x360 
0x1382CA98, 37353949000959304, 89941298, 89941302, 4, 640x360 
0x1382CA98, 37353949001254816, 89941330, 89941343, 13, 640x360 
0x1382CA98, 37353949001630072, 89941362, 89941366, 4, 640x360 
0x1382CA98, 37353949001897304, 89941418, 89941429, 11, 640x360 
0x1382CA98, 37353949002220344, 89941429, 89941434, 5, 640x360 
0x1382CA98, 37353949002544144, 89941464, 89941481, 17, 640x360 
0x1382CA98, 37353949002879344, 89941498, 89941514, 16, 640x360 
0x1382CA98, 37353949003175616, 89941527, 89941536, 9, 640x360 
0x1382CA98, 37353949003514240, 89941563, 89941566, 3, 640x360 
0x1382CA98, 37353949003813856, 89941595, 89941607, 12, 640x360 
0x1382CA98, 37353949004296712, 89941634, 89941637, 3, 640x360 
0x1382CA98, 37353949004633744, 89941683, 89941695, 12, 640x360 
0x1382CA98, 37353949004968288, 89941711, 89941717, 6, 640x360 
0x1382CA98, 37353949005299928, 89941739, 89941746, 7, 640x360 
0x1382CA98, 37353949005639600, 89941783, 89941794, 11, 640x360 
0x1382CA98, 37353949005900952, 89941800, 89941808, 8, 640x360 
0x1382CA98, 37353949006215824, 89941818, 89941828, 10, 640x360 
0x1382CA98, 37353949006529696, 89941862, 89941867, 5, 640x360 
0x1382CA98, 37353949006858624, 89941896, 89941916, 20, 640x360 
0x1382CA98, 37353949007200704, 89941936, 89941972, 36, 640x360 
0x1382CA98, 37353949007623480, 89941978, 89941985, 7, 640x360 
0x1382CA98, 37353949008016112, 89942011, 89942015, 4, 640x360 
0x1382CA98, 37353949008309608, 89942037, 89942052, 15, 640x360 
0x1382CA98, 37353949008635056, 89942081, 89942092, 11, 640x360 
0x1382CA98, 37353949008945496, 89942143, 89942146, 3, 640x360 
0x1382CA98, 37353949009346608, 89942165, 89942171, 6, 640x360 
0x1382CA98, 37353949009662424, 89942192, 89942197, 5, 640x360 
0x1382CA98, 37353949009943208, 89942200, 89942212, 12, 640x360 
0x1382CA98, 37353949010223168, 89942241, 89942251, 10, 640x360 
0x1382CA98, 37353949010560544, 89942262, 89942266, 4, 640x360 
0x1382CA98, 37353949010852824, 89942294, 89942297, 3, 640x360 
0x1382CA98, 37353949011170664, 89942321, 89942325, 4, 640x360 
0x1382CA98, 37353949011489728, 89942346, 89942348, 2, 640x360 
0x1382CA98, 37353949011813632, 89942380, 89942382, 2, 640x360 
0x1382CA98, 37353949012297056, 89942435, 89942440, 5, 640x360 
0x1382CA98, 37353949012626240, 89942469, 89942475, 6, 640x360 
0x1382CA98, 37353949012934968, 89942491, 89942502, 11, 640x360 
0x1382CA98, 37353949013251656, 89942521, 89942525, 4, 640x360 
0x1382CA98, 37353949013576480, 89942551, 89942554, 3, 640x360 
0x1382CA98, 37353949013892152, 89942590, 89942599, 9, 640x360 
0x1382CA98, 37353949014211608, 89942619, 89942626, 7, 640x360 
0x1382CA98, 37353949014537880, 89942650, 89942655, 5, 640x360 
0x1382CA98, 37353949014857224, 89942691, 89942694, 3, 640x360 
0x1382CA98, 37353949015191872, 89942715, 89942722, 7, 640x360 
0x1382CA98, 37353949015492688, 89942744, 89942747, 3, 640x360 
0x1382CA98, 37353949015820848, 89942787, 89942792, 5, 640x360 
0x1382CA98, 37353949016289704, 89942825, 89942841, 16, 640x360 
0x1382CA98, 37353949016624464, 89942879, 89942882, 3, 640x360 
0x1382CA98, 37353949016955264, 89942902, 89942904, 2, 640x360 
0x1382CA98, 37353949017257368, 89942926, 89942936, 10, 640x360 
0x1382CA98, 37353949017575032, 89942967, 89942983, 16, 640x360 
0x1382CA98, 37353949017915920, 89942997, 89943002, 5, 640x360 
0x1382CA98, 37353949018220624, 89943025, 89943048, 23, 640x360 
0x1382CA98, 37353949018542672, 89943069, 89943085, 16, 640x360 
0x1382CA98, 37353949018867240, 89943108, 89943116, 8, 640x360 
0x1382CA98, 37353949019205232, 89943141, 89943153, 12, 640x360 
0x1382CA98, 37353949019495352, 89943153, 89943162, 9, 640x360 
0x1382CA98, 37353949019817392, 89943197, 89943200, 3, 640x360 
0x1382CA98, 37353949020291664, 89943236, 89943239, 3, 640x360 
0x1382CA98, 37353949020623624, 89943261, 89943264, 3, 640x360 
0x1382CA98, 37353949020943808, 89943303, 89943308, 5, 640x360 
0x1382CA98, 37353949021253744, 89943328, 89943338, 10, 640x360 
0x1382CA98, 37353949021573392, 89943360, 89943363, 3, 640x360 
0x1382CA98, 37353949021890088, 89943391, 89943398, 7, 640x360 
0x1382CA98, 37353949022214840, 89943419, 89943422, 3, 640x360 
0x1382CA98, 37353949022535264, 89943455, 89943460, 5, 640x360 
0x1382CA98, 37353949022857784, 89943477, 89943485, 8, 640x360 
0x1382CA98, 37353949023172016, 89943514, 89943516, 2, 640x360 
0x1382CA98, 37353949023492632, 89943537, 89943549, 12, 640x360 
0x1382CA98, 37353949023813768, 89943581, 89943586, 5, 640x360 
0x1382CA98, 37353949024296944, 89943636, 89943638, 2, 640x360 
0x1382CA98, 37353949024613328, 89943662, 89943668, 6, 640x360 
0x1382CA98, 37353949024935992, 89943693, 89943697, 4, 640x360 
0x1382CA98, 37353949025255104, 89943716, 89943721, 5, 640x360 
0x1382CA98, 37353949025568680, 89943756, 89943760, 4, 640x360 
0x1382CA98, 37353949025889040, 89943790, 89943792, 2, 640x360 
0x1382CA98, 37353949026216392, 89943814, 89943816, 2, 640x360 
0x1382CA98, 37353949026529072, 89943845, 89943851, 6, 640x360 
0x1382CA98, 37353949026849144, 89943876, 89943880, 4, 640x360 
0x1382CA98, 37353949027169176, 89943914, 89943916, 2, 640x360 
0x1382CA98, 37353949027490960, 89943953, 89943960, 7, 640x360 
0x1382CA98, 37353949027809744, 89943989, 89943992, 3, 640x360 
0x1382CA98, 37353949028133568, 89944013, 89944015, 2, 640x360 
0x1382CA98, 37353949028622200, 89944056, 89944065, 9, 640x360 
0x1382CA98, 37353949028941304, 89944085, 89944087, 2, 640x360 
0x1382CA98, 37353949029253968, 89944118, 89944122, 4, 640x360 
0x1382CA98, 37353949029570032, 89944155, 89944165, 10, 640x360 
0x1382CA98, 37353949029889208, 89944184, 89944190, 6, 640x360 
0x1382CA98, 37353949030219224, 89944215, 89944222, 7, 640x360 
0x1382CA98, 37353949030529760, 89944244, 89944251, 7, 640x360 
0x1382CA98, 37353949030852792, 89944276, 89944282, 6, 640x360 
0x1382CA98, 37353949031169240, 89944315, 89944317, 2, 640x360 
0x1382CA98, 37353949031491512, 89944347, 89944355, 8, 640x360 
0x1382CA98, 37353949031809368, 89944377, 89944379, 2, 640x360 
0x1382CA98, 37353949032132696, 89944410, 89944412, 2, 640x360 
0x1382CA98, 37353949032612480, 89944459, 89944463, 4, 640x360 
0x1382CA98, 37353949032940304, 89944493, 89944500, 7, 640x360 
0x1382CA98, 37353949033283488, 89944530, 89944533, 3, 640x360 
0x1382CA98, 37353949033625312, 89944560, 89944563, 3, 640x360 
0x1382CA98, 37353949033921056, 89944603, 89944618, 15, 640x360 
0x1382CA98, 37353949034210088, 89944631, 89944633, 2, 640x360 
0x1382CA98, 37353949034529680, 89944651, 89944654, 3, 640x360 
0x1382CA98, 37353949034864792, 89944695, 89944700, 5, 640x360 
0x1382CA98, 37353949035171128, 89944724, 89944732, 8, 640x360 
0x1382CA98, 37353949035493456, 89944756, 89944760, 4, 640x360 
0x1382CA98, 37353949035809472, 89944781, 89944784, 3, 640x360 
0x1382CA98, 37353949036133784, 89944815, 89944817, 2, 640x360 
0x1382CA98, 37353949036620784, 89944873, 89944877, 4, 640x360 
0x1382CA98, 37353949036948152, 89944896, 89944914, 18, 640x360 
0x1382CA98, 37353949037312152, 89944936, 89944942, 6, 640x360 
0x1382CA98, 37353949037605072, 89944966, 89944979, 13, 640x360 
0x1382CA98, 37353949037928328, 89945001, 89945006, 5, 640x360 
0x1382CA98, 37353949038210904, 89945023, 89945029, 6, 640x360 
0x1382CA98, 37353949038528840, 89945057, 89945061, 4, 640x360 
0x1382CA98, 37353949038855480, 89945085, 89945086, 1, 640x360 
0x1382CA98, 37353949039181992, 89945124, 89945127, 3, 640x360 
0x1382CA98, 37353949039489112, 89945149, 89945152, 3, 640x360 
0x1382CA98, 37353949039821776, 89945179, 89945181, 2, 640x360 
0x1382CA98, 37353949040130232, 89945204, 89945221, 17, 640x360 
0x1382CA98, 37353949040609464, 89945253, 89945259, 6, 640x360 
0x1382CA98, 37353949040932400, 89945294, 89945297, 3, 640x360 
0x1382CA98, 37353949041249080, 89945320, 89945326, 6, 640x360 
0x1382CA98, 37353949041568960, 89945351, 89945353, 2, 640x360 
0x1382CA98, 37353949041888696, 89945386, 89945390, 4, 640x360 
0x1382CA98, 37353949042213840, 89945413, 89945416, 3, 640x360 
0x1382CA98, 37353949042529136, 89945444, 89945447, 3, 640x360 
0x1382CA98, 37353949042849960, 89945491, 89945494, 3, 640x360 
0x1382CA98, 37353949043169128, 89945515, 89945523, 8, 640x360 
0x1382CA98, 37353949043488896, 89945546, 89945548, 2, 640x360 
0x1382CA98, 37353949043816184, 89945585, 89945588, 3, 640x360 
0x1382CA98, 37353949044129112, 89945613, 89945619, 6, 640x360 
0x1382CA98, 37353949044623536, 89945656, 89945662, 6, 640x360 
0x1382CA98, 37353949044929464, 89945683, 89945685, 2, 640x360 
0x1382CA98, 37353949045254464, 89945724, 89945727, 3, 640x360 
0x1382CA98, 37353949045578584, 89945748, 89945750, 2, 640x360 
0x1382CA98, 37353949045888336, 89945782, 89945784, 2, 640x360 
0x1382CA98, 37353949046209032, 89945816, 89945818, 2, 640x360 
0x1382CA98, 37353949046529272, 89945844, 89945851, 7, 640x360 
0x1382CA98, 37353949046849096, 89945885, 89945887, 2, 640x360 
0x1382CA98, 37353949047169096, 89945909, 89945917, 8, 640x360 
0x1382CA98, 37353949047493968, 89945946, 89945954, 8, 640x360 
0x1382CA98, 37353949047811240, 89945973, 89945977, 4, 640x360 
0x1382CA98, 37353949048130088, 89946004, 89946017, 13, 640x360 
0x1382CA98, 37353949048610200, 89946072, 89946076, 4, 640x360 
0x1382CA98, 37353949048962512, 89946102, 89946109, 7, 640x360 
0x1382CA98, 37353949049273880, 89946124, 89946140, 16, 640x360 
0x1382CA98, 37353949049591624, 89946167, 89946173, 6, 640x360 
0x1382CA98, 37353949049915992, 89946192, 89946196, 4, 640x360 
0x1382CA98, 37353949050223248, 89946221, 89946231, 10, 640x360 
0x1382CA98, 37353949050531016, 89946250, 89946252, 2, 640x360 
0x1382CA98, 37353949050848296, 89946278, 89946284, 6, 640x360 
0x1382CA98, 37353949051168472, 89946308, 89946311, 3, 640x360 
0x1382CA98, 37353949051489736, 89946341, 89946352, 11, 640x360 
0x1382CA98, 37353949051810920, 89946381, 89946383, 2, 640x360 
0x1382CA98, 37353949052129152, 89946403, 89946410, 7, 640x360 
0x1382CA98, 37353949052622536, 89946460, 89946465, 5, 640x360 
0x1382CA98, 37353949052933176, 89946485, 89946490, 5, 640x360 
0x1382CA98, 37353949053256288, 89946522, 89946527, 5, 640x360 
0x1382CA98, 37353949053573552, 89946559, 89946561, 2, 640x360 
0x1382CA98, 37353949053890336, 89946581, 89946584, 3, 640x360 
0x1382CA98, 37353949054222064, 89946613, 89946616, 3, 640x360 
0x1382CA98, 37353949054528728, 89946644, 89946647, 3, 640x360 
0x1382CA98, 37353949054859104, 89946680, 89946687, 7, 640x360 
0x1382CA98, 37353949055169328, 89946722, 89946725, 3, 640x360 
0x1382CA98, 37353949055495640, 89946741, 89946750, 9, 640x360 
0x1382CA98, 37353949055812952, 89946780, 89946784, 4, 640x360 
0x1382CA98, 37353949056128376, 89946804, 89946815, 11, 640x360 
0x1382CA98, 37353949056448880, 89946837, 89946847, 10, 640x360 
0x1382CA98, 37353949056953376, 89946884, 89946886, 2, 640x360 
0x1382CA98, 37353949057248784, 89946926, 89946930, 4, 640x360 
0x1382CA98, 37353949057572240, 89946958, 89946962, 4, 640x360 
0x1382CA98, 37353949057888312, 89946992, 89946994, 2, 640x360 
0x1382CA98, 37353949058212016, 89947018, 89947023, 5, 640x360 
0x1382CA98, 37353949058532664, 89947045, 89947062, 17, 640x360 
0x1382CA98, 37353949058855576, 89947078, 89947085, 7, 640x360 
0x1382CA98, 37353949059175592, 89947107, 89947110, 3, 640x360 
0x1382CA98, 37353949059491264, 89947140, 89947144, 4, 640x360 
0x1382CA98, 37353949059816008, 89947177, 89947186, 9, 640x360 
0x1382CA98, 37353949060146216, 89947212, 89947213, 1, 640x360 
0x1382CA98, 37353949060450504, 89947246, 89947248, 2, 640x360 
0x1382CA98, 37353949060941032, 89947291, 89947300, 9, 640x360 
0x1382CA98, 37353949061258264, 89947317, 89947320, 3, 640x360 
0x1382CA98, 37353949061567984, 89947351, 89947352, 1, 640x360 
0x1382CA98, 37353949061888400, 89947385, 89947389, 4, 640x360 
0x1382CA98, 37353949062208272, 89947414, 89947417, 3, 640x360 
0x1382CA98, 37353949062528328, 89947446, 89947454, 8, 640x360 
0x1382CA98, 37353949062850040, 89947491, 89947498, 7, 640x360 
0x1382CA98, 37353949063171256, 89947523, 89947527, 4, 640x360 
0x1382CA98, 37353949063512312, 89947547, 89947550, 3, 640x360 
0x1382CA98, 37353949063834752, 89947578, 89947582, 4, 640x360 
0x1382CA98, 37353949064136488, 89947611, 89947616, 5, 640x360 
0x1382CA98, 37353949064448616, 89947645, 89947657, 12, 640x360 
0x1382CA98, 37353949064932480, 89947697, 89947703, 6, 640x360 
0x1382CA98, 37353949065248216, 89947728, 89947731, 3, 640x360 
0x1382CA98, 37353949065570384, 89947752, 89947756, 4, 640x360 
0x1382CA98, 37353949065893320, 89947780, 89947782, 2, 640x360 
0x1382CA98, 37353949066219872, 89947817, 89947819, 2, 640x360 
0x1382CA98, 37353949066531648, 89947844, 89947847, 3, 640x360 
0x1382CA98, 37353949066851944, 89947878, 89947884, 6, 640x360 
0x1382CA98, 37353949067172424, 89947910, 89947913, 3, 640x360 
0x1382CA98, 37353949067491264, 89947944, 89947946, 2, 640x360 
0x1382CA98, 37353949067813232, 89947972, 89947985, 13, 640x360 
0x1382CA98, 37353949068141064, 89948006, 89948014, 8, 640x360 
0x1382CA98, 37353949068448296, 89948040, 89948049, 9, 640x360 
0x1382CA98, 37353949068955640, 89948091, 89948100, 9, 640x360 
0x1382CA98, 37353949069252776, 89948138, 89948144, 6, 640x360 
0x1382CA98, 37353949069584128, 89948149, 89948152, 3, 640x360 
0x1382CA98, 37353949069887952, 89948185, 89948188, 3, 640x360 
0x1382CA98, 37353949070207592, 89948221, 89948231, 10, 640x360 
0x1382CA98, 37353949070527952, 89948246, 89948249, 3, 640x360 
0x1382CA98, 37353949070851784, 89948289, 89948300, 11, 640x360 
0x1382CA98, 37353949071180264, 89948313, 89948315, 2, 640x360 
0x1382CA98, 37353949071506944, 89948347, 89948349, 2, 640x360 
0x1382CA98, 37353949071819928, 89948379, 89948381, 2, 640x360 
0x1382CA98, 37353949072127912, 89948412, 89948414, 2, 640x360 
0x1382CA98, 37353949072448016, 89948438, 89948447, 9, 640x360 
0x1382CA98, 37353949072940456, 89948491, 89948499, 8, 640x360 
0x1382CA98, 37353949073247536, 89948516, 89948519, 3, 640x360 
0x1382CA98, 37353949073567960, 89948553, 89948558, 5, 640x360 
0x1382CA98, 37353949073887552, 89948581, 89948583, 2, 640x360 
0x1382CA98, 37353949074213296, 89948617, 89948620, 3, 640x360 
0x1382CA98, 37353949074537448, 89948651, 89948654, 3, 640x360 
0x1382CA98, 37353949074851568, 89948685, 89948687, 2, 640x360 
0x1382CA98, 37353949075171680, 89948715, 89948717, 2, 640x360 
0x1382CA98, 37353949075488256, 89948751, 89948754, 3, 640x360 
0x1382CA98, 37353949075812256, 89948778, 89948784, 6, 640x360 
0x1382CA98, 37353949076132560, 89948818, 89948820, 2, 640x360 
0x1382CA98, 37353949076452016, 89948846, 89948849, 3, 640x360 
0x1382CA98, 37353949076968376, 89948898, 89948911, 13, 640x360 
0x1382CA98, 37353949077270960, 89948930, 89948934, 4, 640x360 
0x1382CA98, 37353949077594952, 89948965, 89948975, 10, 640x360 
0x1382CA98, 37353949077891424, 89948987, 89948994, 7, 640x360 
0x1382CA98, 37353949078208664, 89949023, 89949026, 3, 640x360 
0x1382CA98, 37353949078534896, 89949052, 89949055, 3, 640x360 
0x1382CA98, 37353949078856544, 89949086, 89949091, 5, 640x360 
0x1382CA98, 37353949079172536, 89949112, 89949119, 7, 640x360 
0x1382CA98, 37353949079503664, 89949148, 89949153, 5, 640x360 
0x1382CA98, 37353949079812752, 89949179, 89949181, 2, 640x360 
0x1382CA98, 37353949080135048, 89949211, 89949218, 7, 640x360 
0x1382CA98, 37353949080451296, 89949236, 89949241, 5, 640x360 
0x1382CA98, 37353949080775008, 89949281, 89949288, 7, 640x360 
0x1382CA98, 37353949081248072, 89949321, 89949325, 4, 640x360 
0x1382CA98, 37353949081572040, 89949348, 89949350, 2, 640x360 
0x1382CA98, 37353949081888816, 89949385, 89949387, 2, 640x360 
0x1382CA98, 37353949082207728, 89949422, 89949425, 3, 640x360 
0x1382CA98, 37353949082527632, 89949455, 89949459, 4, 640x360 
0x1382CA98, 37353949082852360, 89949488, 89949492, 4, 640x360 
0x1382CA98, 37353949083175032, 89949511, 89949514, 3, 640x360 
0x1382CA98, 37353949083489808, 89949539, 89949543, 4, 640x360 
0x1382CA98, 37353949083808312, 89949569, 89949573, 4, 640x360 
0x1382CA98, 37353949084128344, 89949607, 89949616, 9, 640x360 
0x1382CA98, 37353949084452976, 89949639, 89949645, 6, 640x360 
0x1382CA98, 37353949084775136, 89949667, 89949670, 3, 640x360 
0x1382CA98, 37353949085253128, 89949718, 89949727, 9, 640x360 
0x1382CA98, 37353949085580984, 89949768, 89949771, 3, 640x360 
0x1382CA98, 37353949085887640, 89949792, 89949795, 3, 640x360 
0x1382CA98, 37353949086208112, 89949816, 89949818, 2, 640x360 
0x1382CA98, 37353949086531712, 89949849, 89949850, 1, 640x360 
0x1382CA98, 37353949086847472, 89949880, 89949882, 2, 640x360 
0x1382CA98, 37353949087171696, 89949913, 89949915, 2, 640x360 
0x1382CA98, 37353949087487936, 89949938, 89949942, 4, 640x360 
0x1382CA98, 37353949087811696, 89949969, 89949975, 6, 640x360 
0x1382CA98, 37353949088128736, 89950002, 89950004, 2, 640x360 
0x1382CA98, 37353949088449384, 89950040, 89950047, 7, 640x360 
0x1382CA98, 37353949088772560, 89950075, 89950082, 7, 640x360 
0x1382CA98, 37353949089250600, 89950128, 89950131, 3, 640x360 
0x1382CA98, 37353949089567616, 89950158, 89950161, 3, 640x360 
0x1382CA98, 37353949089887064, 89950181, 89950182, 1, 640x360 
0x1382CA98, 37353949090211032, 89950212, 89950215, 3, 640x360 
0x1382CA98, 37353949090537264, 89950248, 89950250, 2, 640x360 
0x1382CA98, 37353949090852776, 89950276, 89950278, 2, 640x360 
0x1382CA98, 37353949091168664, 89950307, 89950310, 3, 640x360 
0x1382CA98, 37353949091488056, 89950336, 89950342, 6, 640x360 
0x1382CA98, 37353949091807960, 89950370, 89950375, 5, 640x360 
0x1382CA98, 37353949092132112, 89950404, 89950414, 10, 640x360 
0x1382CA98, 37353949092451520, 89950436, 89950442, 6, 640x360 
0x1382CA98, 37353949092768632, 89950468, 89950470, 2, 640x360 
0x1382CA98, 37353949093248920, 89950520, 89950525, 5, 640x360 
0x1382CA98, 37353949093567912, 89950557, 89950559, 2, 640x360 
0x1382CA98, 37353949093889264, 89950581, 89950583, 2, 640x360 
0x1382CA98, 37353949094211504, 89950614, 89950616, 2, 640x360 
0x1382CA98, 37353949094527600, 89950646, 89950652, 6, 640x360 
0x1382CA98, 37353949094848320, 89950678, 89950684, 6, 640x360 
0x1382CA98, 37353949095168368, 89950706, 89950710, 4, 640x360 
0x1382CA98, 37353949095492096, 89950740, 89950742, 2, 640x360 
0x1382CA98, 37353949095807936, 89950772, 89950776, 4, 640x360 
0x1382CA98, 37353949096128320, 89950802, 89950808, 6, 640x360 
0x1382CA98, 37353949096448080, 89950834, 89950837, 3, 640x360 
0x1382CA98, 37353949096773672, 89950867, 89950873, 6, 640x360 
0x1382CA98, 37353949097249968, 89950921, 89950931, 10, 640x360 
0x1382CA98, 37353949097571480, 89950947, 89950950, 3, 640x360 
0x1382CA98, 37353949097888032, 89950981, 89950983, 2, 640x360 
0x1382CA98, 37353949098212056, 89951013, 89951016, 3, 640x360 
0x1382CA98, 37353949098527728, 89951044, 89951046, 2, 640x360 
0x1382CA98, 37353949098847736, 89951077, 89951083, 6, 640x360 
0x1382CA98, 37353949099168128, 89951110, 89951116, 6, 640x360 
0x1382CA98, 37353949099487920, 89951145, 89951147, 2, 640x360 
0x1382CA98, 37353949099811544, 89951171, 89951181, 10, 640x360 
0x1382CA98, 37353949100131088, 89951203, 89951212, 9, 640x360 
0x1382CA98, 37353949100447840, 89951240, 89951244, 4, 640x360 
0x1382CA98, 37353949100768512, 89951270, 89951280, 10, 640x360 
0x1382CA98, 37353949101247200, 89951316, 89951330, 14, 640x360 
0x1382CA98, 37353949101610192, 89951356, 89951361, 5, 640x360 
0x1382CA98, 37353949101943976, 89951390, 89951403, 13, 640x360 
0x1382CA98, 37353949102219672, 89951423, 89951426, 3, 640x360 
0x1382CA98, 37353949102532040, 89951451, 89951454, 3, 640x360 
0x1382CA98, 37353949102850048, 89951482, 89951483, 1, 640x360 
0x1382CA98, 37353949103171944, 89951514, 89951516, 2, 640x360 
0x1382CA98, 37353949103490856, 89951543, 89951546, 3, 640x360 
0x1382CA98, 37353949103807600, 89951569, 89951572, 3, 640x360 
0x1382CA98, 37353949104145368, 89951621, 89951627, 6, 640x360 
0x1382CA98, 37353949104452976, 89951659, 89951662, 3, 640x360 
0x1382CA98, 37353949104794312, 89951684, 89951686, 2, 640x360 
0x1382CA98, 37353949105247512, 89951733, 89951739, 6, 640x360 
0x1382CA98, 37353949105569288, 89951754, 89951760, 6, 640x360 
0x1382CA98, 37353949105893776, 89951788, 89951798, 10, 640x360 
0x1382CA98, 37353949106206904, 89951816, 89951818, 2, 640x360 
0x1382CA98, 37353949106526848, 89951848, 89951855, 7, 640x360 
0x1382CA98, 37353949106851024, 89951880, 89951891, 11, 640x360 
0x1382CA98, 37353949107170880, 89951914, 89951916, 2, 640x360 
0x1382CA98, 37353949107496576, 89951955, 89951977, 22, 640x360 
0x1382CA98, 37353949107807208, 89951983, 89951985, 2, 640x360 
0x1382CA98, 37353949108127968, 89952019, 89952021, 2, 640x360 
0x1382CA98, 37353949108448184, 89952041, 89952049, 8, 640x360 
0x1382CA98, 37353949108784856, 89952086, 89952090, 4, 640x360 
0x1382CA98, 37353949109093368, 89952110, 89952118, 8, 640x360 
0x1382CA98, 37353949109571304, 89952151, 89952153, 2, 640x360 
0x1382CA98, 37353949109886744, 89952185, 89952187, 2, 640x360 
0x1382CA98, 37353949110212184, 89952221, 89952226, 5, 640x360 
0x1382CA98, 37353949110531216, 89952254, 89952259, 5, 640x360 
0x1382CA98, 37353949110851920, 89952280, 89952282, 2, 640x360 
0x1382CA98, 37353949111167904, 89952314, 89952323, 9, 640x360 
0x1382CA98, 37353949111487832, 89952347, 89952360, 13, 640x360 
0x1382CA98, 37353949111807504, 89952374, 89952378, 4, 640x360 
0x1382CA98, 37353949112131160, 89952405, 89952411, 6, 640x360 
0x1382CA98, 37353949112455984, 89952437, 89952441, 4, 640x360 
0x1382CA98, 37353949112780072, 89952479, 89952481, 2, 640x360 
0x1382CA98, 37353949113110320, 89952502, 89952505, 3, 640x360 
0x1382CA98, 37353949113566432, 89952549, 89952552, 3, 640x360 
0x1382CA98, 37353949113886440, 89952586, 89952588, 2, 640x360 
0x1382CA98, 37353949114210472, 89952617, 89952619, 2, 640x360 
0x1382CA98, 37353949114526536, 89952655, 89952659, 4, 640x360 
0x1382CA98, 37353949114846584, 89952680, 89952683, 3, 640x360 
0x1382CA98, 37353949115171824, 89952713, 89952715, 2, 640x360 
0x1382CA98, 37353949115487024, 89952757, 89952764, 7, 640x360 
0x1382CA98, 37353949115812384, 89952782, 89952784, 2, 640x360 
0x1382CA98, 37353949116128856, 89952815, 89952816, 1, 640x360 
0x1382CA98, 37353949116447120, 89952838, 89952850, 12, 640x360 
0x1382CA98, 37353949116771400, 89952869, 89952872, 3, 640x360 
0x1382CA98, 37353949117113280, 89952901, 89952903, 2, 640x360 
0x1382CA98, 37353949117570496, 89952949, 89952951, 2, 640x360 
0x1382CA98, 37353949117893168, 89952980, 89952983, 3, 640x360 
0x1382CA98, 37353949118207176, 89953020, 89953023, 3, 640x360 
0x1382CA98, 37353949118529176, 89953046, 89953052, 6, 640x360 
0x1382CA98, 37353949118847216, 89953080, 89953083, 3, 640x360 
0x1382CA98, 37353949119167392, 89953118, 89953121, 3, 640x360 
0x1382CA98, 37353949119487512, 89953147, 89953156, 9, 640x360 
0x1382CA98, 37353949119807256, 89953177, 89953184, 7, 640x360 
0x1382CA98, 37353949120126944, 89953208, 89953217, 9, 640x360 
0x1382CA98, 37353949120448008, 89953235, 89953239, 4, 640x360 
0x1382CA98, 37353949120776368, 89953267, 89953270, 3, 640x360 
0x1382CA98, 37353949121111696, 89953301, 89953303, 2, 640x360 
0x1382CA98, 37353949121567112, 89953350, 89953352, 2, 640x360 
0x1382CA98, 37353949121887160, 89953383, 89953385, 2, 640x360 
0x1382CA98, 37353949122206296, 89953410, 89953416, 6, 640x360 
0x1382CA98, 37353949122531264, 89953447, 89953453, 6, 640x360 
0x1382CA98, 37353949122847344, 89953478, 89953481, 3, 640x360 
0x1382CA98, 37353949123167224, 89953509, 89953515, 6, 640x360 
0x1382CA98, 37353949123490728, 89953541, 89953546, 5, 640x360 
0x1382CA98, 37353949123810072, 89953574, 89953580, 6, 640x360 
0x1382CA98, 37353949124127072, 89953603, 89953606, 3, 640x360 
0x1382CA98, 37353949124447376, 89953635, 89953637, 2, 640x360 
0x1382CA98, 37353949124769120, 89953669, 89953671, 2, 640x360 
0x1382CA98, 37353949125087528, 89953701, 89953704, 3, 640x360 
0x1382CA98, 37353949125567856, 89953766, 89953775, 9, 640x360 
0x1382CA98, 37353949125891840, 89953786, 89953792, 6, 640x360 
0x1382CA98, 37353949126206608, 89953818, 89953820, 2, 640x360 
0x1382CA98, 37353949126535616, 89953849, 89953852, 3, 640x360 
0x1382CA98, 37353949126855784, 89953881, 89953883, 2, 640x360 
0x1382CA98, 37353949127167256, 89953913, 89953916, 3, 640x360 
0x1382CA98, 37353949127490304, 89953946, 89953958, 12, 640x360 
0x1382CA98, 37353949127811016, 89953975, 89953983, 8, 640x360 
0x1382CA98, 37353949128126816, 89954002, 89954005, 3, 640x360 
0x1382CA98, 37353949128447144, 89954034, 89954036, 2, 640x360 
0x1382CA98, 37353949128773232, 89954067, 89954069, 2, 640x360 
0x1382CA98, 37353949129108304, 89954101, 89954104, 3, 640x360 
0x1382CA98, 37353949129566888, 89954152, 89954159, 7, 640x360 
0x1382CA98, 37353949129886360, 89954185, 89954188, 3, 640x360 
0x1382CA98, 37353949130207720, 89954219, 89954223, 4, 640x360 
0x1382CA98, 37353949130528088, 89954251, 89954253, 2, 640x360 
0x1382CA98, 37353949130846840, 89954285, 89954287, 2, 640x360 
0x1382CA98, 37353949131167672, 89954313, 89954318, 5, 640x360 
0x1382CA98, 37353949131492336, 89954347, 89954351, 4, 640x360 
0x1382CA98, 37353949131816952, 89954386, 89954393, 7, 640x360 
0x1382CA98, 37353949132126560, 89954418, 89954421, 3, 640x360 
0x1382CA98, 37353949132465120, 89954448, 89954450, 2, 640x360 
0x1382CA98, 37353949132772624, 89954470, 89954479, 9, 640x360 
0x1382CA98, 37353949133089792, 89954508, 89954514, 6, 640x360 
0x1382CA98, 37353949133565880, 89954559, 89954562, 3, 640x360 
0x1382CA98, 37353949133888632, 89954582, 89954584, 2, 640x360 
0x1382CA98, 37353949134212096, 89954620, 89954626, 6, 640x360 
0x1382CA98, 37353949134531304, 89954650, 89954652, 2, 640x360 
0x1382CA98, 37353949134848096, 89954678, 89954685, 7, 640x360 
0x1382CA98, 37353949135172944, 89954720, 89954723, 3, 640x360 
0x1382CA98, 37353949135494792, 89954746, 89954761, 15, 640x360 
0x1382CA98, 37353949135813880, 89954780, 89954783, 3, 640x360 
0x1382CA98, 37353949136128376, 89954802, 89954805, 3, 640x360 
0x1382CA98, 37353949136449760, 89954833, 89954835, 2, 640x360 
0x1382CA98, 37353949136784576, 89954879, 89954884, 5, 640x360 
0x1382CA98, 37353949137119848, 89954932, 89954938, 6, 640x360 
0x1382CA98, 37353949137439032, 89954947, 89954951, 4, 640x360 
0x1382CA98, 37353949137885608, 89954991, 89954995, 4, 640x360 
0x1382CA98, 37353949138205936, 89955024, 89955026, 2, 640x360 
0x1382CA98, 37353949138526584, 89955060, 89955068, 8, 640x360 
0x1382CA98, 37353949138860080, 89955090, 89955094, 4, 640x360 
0x1382CA98, 37353949139170392, 89955113, 89955115, 2, 640x360 
0x1382CA98, 37353949139488408, 89955147, 89955152, 5, 640x360 
0x1382CA98, 37353949139832440, 89955182, 89955184, 2, 640x360 
0x1382CA98, 37353949140135880, 89955204, 89955210, 6, 640x360 
0x1382CA98, 37353949140446152, 89955245, 89955251, 6, 640x360 
0x1382CA98, 37353949140771048, 89955278, 89955281, 3, 640x360 
0x1382CA98, 37353949141088992, 89955309, 89955312, 3, 640x360 
0x1382CA98, 37353949141406888, 89955341, 89955343, 2, 640x360 
0x1382CA98, 37353949141885704, 89955381, 89955383, 2, 640x360 
0x1382CA98, 37353949142206264, 89955412, 89955418, 6, 640x360 
0x1382CA98, 37353949142526424, 89955463, 89955465, 2, 640x360 
0x1382CA98, 37353949142853224, 89955478, 89955486, 8, 640x360 
0x1382CA98, 37353949143165912, 89955515, 89955523, 8, 640x360 
0x1382CA98, 37353949143490896, 89955548, 89955550, 2, 640x360 
0x1382CA98, 37353949143805816, 89955580, 89955585, 5, 640x360 
0x1382CA98, 37353949144152016, 89955615, 89955616, 1, 640x360 
0x1382CA98, 37353949144449544, 89955641, 89955651, 10, 640x360 
0x1382CA98, 37353949144773256, 89955685, 89955688, 3, 640x360 
0x1382CA98, 37353949145086344, 89955709, 89955714, 5, 640x360 
0x1382CA98, 37353949145407576, 89955742, 89955745, 3, 640x360 
0x1382CA98, 37353949145885256, 89955784, 89955786, 2, 640x360 
0x1382CA98, 37353949146209336, 89955821, 89955824, 3, 640x360 
0x1382CA98, 37353949146532584, 89955849, 89955851, 2, 640x360 
0x1382CA98, 37353949146850992, 89955887, 89955892, 5, 640x360 
0x1382CA98, 37353949147165856, 89955911, 89955920, 9, 640x360 
0x1382CA98, 37353949147490488, 89955943, 89955946, 3, 640x360 
0x1382CA98, 37353949147806296, 89955981, 89955986, 5, 640x360 
0x1382CA98, 37353949148126616, 89956014, 89956016, 2, 640x360 
0x1382CA98, 37353949148453408, 89956042, 89956052, 10, 640x360 
0x1382CA98, 37353949148791296, 89956075, 89956082, 7, 640x360 
0x1382CA98, 37353949149091200, 89956101, 89956104, 3, 640x360 
0x1382CA98, 37353949149407248, 89956146, 89956149, 3, 640x360 
0x1382CA98, 37353949149886192, 89956179, 89956181, 2, 640x360 
0x1382CA98, 37353949150212752, 89956212, 89956221, 9, 640x360 
0x1382CA98, 37353949150526208, 89956246, 89956253, 7, 640x360 
0x1382CA98, 37353949150845536, 89956277, 89956279, 2, 640x360 
0x1382CA98, 37353949151165936, 89956311, 89956318, 7, 640x360 
0x1382CA98, 37353949151488152, 89956343, 89956345, 2, 640x360 
0x1382CA98, 37353949151811464, 89956380, 89956382, 2, 640x360 
0x1382CA98, 37353949152129560, 89956406, 89956410, 4, 640x360 
0x1382CA98, 37353949152446280, 89956435, 89956439, 4, 640x360 
0x1382CA98, 37353949152766088, 89956468, 89956472, 4, 640x360 
0x1382CA98, 37353949153118544, 89956512, 89956518, 6, 640x360 
0x1382CA98, 37353949153418960, 89956540, 89956544, 4, 640x360 
0x1382CA98, 37353949153885176, 89956587, 89956595, 8, 640x360 
0x1382CA98, 37353949154205688, 89956612, 89956614, 2, 640x360 
0x1382CA98, 37353949154529744, 89956646, 89956659, 13, 640x360 
0x1382CA98, 37353949154847032, 89956684, 89956687, 3, 640x360 
0x1382CA98, 37353949155166576, 89956714, 89956716, 2, 640x360 
0x1382CA98, 37353949155485544, 89956746, 89956758, 12, 640x360 
0x1382CA98, 37353949155805912, 89956778, 89956785, 7, 640x360 
0x1382CA98, 37353949156126584, 89956803, 89956815, 12, 640x360 
0x1382CA98, 37353949156453848, 89956835, 89956837, 2, 640x360 
0x1382CA98, 37353949156771352, 89956876, 89956878, 2, 640x360 
0x1382CA98, 37353949157089192, 89956925, 89956946, 21, 640x360 
0x1382CA98, 37353949157433080, 89956946, 89956959, 13, 640x360 
0x1382CA98, 37353949157886224, 89956987, 89956990, 3, 640x360 
0x1382CA98, 37353949158205488, 89957013, 89957016, 3, 640x360 
0x1382CA98, 37353949158539896, 89957049, 89957051, 2, 640x360 
0x1382CA98, 37353949158845880, 89957075, 89957078, 3, 640x360 
0x1382CA98, 37353949159166480, 89957105, 89957113, 8, 640x360 
0x1382CA98, 37353949159486808, 89957143, 89957147, 4, 640x360 
0x1382CA98, 37353949159810552, 89957181, 89957183, 2, 640x360 
0x1382CA98, 37353949160126208, 89957208, 89957212, 4, 640x360 
0x1382CA98, 37353949160445984, 89957241, 89957243, 2, 640x360 
0x1382CA98, 37353949160767568, 89957269, 89957275, 6, 640x360 
0x1382CA98, 37353949161095312, 89957305, 89957309, 4, 640x360 
0x1382CA98, 37353949161415848, 89957337, 89957342, 5, 640x360 
0x1382CA98, 37353949161730744, 89957364, 89957367, 3, 640x360 
0x1382CA98, 37353949162205424, 89957428, 89957430, 2, 640x360 
0x1382CA98, 37353949162525280, 89957458, 89957461, 3, 640x360 
0x1382CA98, 37353949162849776, 89957478, 89957481, 3, 640x360 
0x1382CA98, 37353949163170264, 89957510, 89957519, 9, 640x360 
0x1382CA98, 37353949163506176, 89957546, 89957553, 7, 640x360 
0x1382CA98, 37353949163810408, 89957577, 89957581, 4, 640x360 
0x1382CA98, 37353949164150704, 89957607, 89957611, 4, 640x360 
0x1382CA98, 37353949164445328, 89957636, 89957638, 2, 640x360 
0x1382CA98, 37353949164766224, 89957667, 89957670, 3, 640x360 
0x1382CA98, 37353949165091072, 89957700, 89957703, 3, 640x360 
0x1382CA98, 37353949165406496, 89957740, 89957743, 3, 640x360 
0x1382CA98, 37353949165725608, 89957773, 89957776, 3, 640x360 
0x1382CA98, 37353949166205856, 89957824, 89957826, 2, 640x360 
0x1382CA98, 37353949166529232, 89957847, 89957849, 2, 640x360 
0x1382CA98, 37353949166846192, 89957875, 89957878, 3, 640x360 
0x1382CA98, 37353949167165672, 89957918, 89957921, 3, 640x360 
0x1382CA98, 37353949167491168, 89957952, 89957954, 2, 640x360 
0x1382CA98, 37353949167813560, 89957981, 89957983, 2, 640x360 
0x1382CA98, 37353949168135304, 89958021, 89958026, 5, 640x360 
0x1382CA98, 37353949168455848, 89958039, 89958051, 12, 640x360 
0x1382CA98, 37353949168770264, 89958070, 89958073, 3, 640x360 
0x1382CA98, 37353949169089384, 89958106, 89958115, 9, 640x360 
0x1382CA98, 37353949169405808, 89958133, 89958135, 2, 640x360 
0x1382CA98, 37353949169726304, 89958174, 89958178, 4, 640x360 
0x1382CA98, 37353949170205152, 89958218, 89958221, 3, 640x360 
0x1382CA98, 37353949170525336, 89958251, 89958255, 4, 640x360 
0x1382CA98, 37353949170849128, 89958278, 89958281, 3, 640x360 
0x1382CA98, 37353949171170080, 89958313, 89958319, 6, 640x360 
0x1382CA98, 37353949171486264, 89958345, 89958347, 2, 640x360 
0x1382CA98, 37353949171818648, 89958392, 89958408, 16, 640x360 
0x1382CA98, 37353949172140728, 89958409, 89958422, 13, 640x360 
0x1382CA98, 37353949172466440, 89958445, 89958447, 2, 640x360 
0x1382CA98, 37353949172794384, 89958470, 89958473, 3, 640x360 
0x1382CA98, 37353949173085912, 89958503, 89958505, 2, 640x360 
0x1382CA98, 37353949173406648, 89958541, 89958544, 3, 640x360 
0x1382CA98, 37353949173726504, 89958569, 89958573, 4, 640x360 
0x1382CA98, 37353949174205200, 89958611, 89958614, 3, 640x360 
0x1382CA98, 37353949174539680, 89958649, 89958655, 6, 640x360 
0x1382CA98, 37353949174845504, 89958675, 89958679, 4, 640x360 
0x1382CA98, 37353949175166072, 89958714, 89958723, 9, 640x360 
0x1382CA98, 37353949175490152, 89958740, 89958743, 3, 640x360 
0x1382CA98, 37353949175806000, 89958776, 89958779, 3, 640x360 
0x1382CA98, 37353949176125752, 89958807, 89958809, 2, 640x360 
0x1382CA98, 37353949176449840, 89958842, 89958844, 2, 640x360 
0x1382CA98, 37353949176777016, 89958872, 89958876, 4, 640x360 
0x1382CA98, 37353949177086320, 89958903, 89958905, 2, 640x360 
0x1382CA98, 37353949177406200, 89958938, 89958942, 4, 640x360 
0x1382CA98, 37353949177732896, 89958975, 89958977, 2, 640x360 
0x1382CA98, 37353949178204976, 89959024, 89959027, 3, 640x360 
0x1382CA98, 37353949178525008, 89959059, 89959061, 2, 640x360 
0x1382CA98, 37353949178846464, 89959085, 89959088, 3, 640x360 
0x1382CA98, 37353949179169456, 89959121, 89959125, 4, 640x360 
0x1382CA98, 37353949179494424, 89959148, 89959151, 3, 640x360 
0x1382CA98, 37353949179805016, 89959186, 89959189, 3, 640x360 
0x1382CA98, 37353949180125880, 89959212, 89959218, 6, 640x360 
0x1382CA98, 37353949180445080, 89959244, 89959247, 3, 640x360 
0x1382CA98, 37353949180765088, 89959269, 89959274, 5, 640x360 
0x1382CA98, 37353949181088616, 89959301, 89959303, 2, 640x360 
0x1382CA98, 37353949181405720, 89959336, 89959343, 7, 640x360 
0x1382CA98, 37353949181725088, 89959374, 89959376, 2, 640x360 
0x1382CA98, 37353949182204664, 89959411, 89959418, 7, 640x360 
0x1382CA98, 37353949182528496, 89959447, 89959458, 11, 640x360 
0x1382CA98, 37353949182845696, 89959478, 89959486, 8, 640x360 
0x1382CA98, 37353949183168576, 89959510, 89959524, 14, 640x360 
0x1382CA98, 37353949183488656, 89959545, 89959547, 2, 640x360 
0x1382CA98, 37353949183804880, 89959575, 89959586, 11, 640x360 
0x1382CA98, 37353949184127032, 89959602, 89959606, 4, 640x360 
0x1382CA98, 37353949184448136, 89959640, 89959650, 10, 640x360 
0x1382CA98, 37353949184772792, 89959669, 89959682, 13, 640x360 
0x1382CA98, 37353949185089072, 89959701, 89959705, 4, 640x360 
0x1382CA98, 37353949185405984, 89959743, 89959745, 2, 640x360 
0x1382CA98, 37353949185732224, 89959763, 89959766, 3, 640x360 
0x1382CA98, 37353949186204696, 89959818, 89959820, 2, 640x360 
0x1382CA98, 37353949186530840, 89959853, 89959856, 3, 640x360 
0x1382CA98, 37353949186846768, 89959882, 89959884, 2, 640x360 
0x1382CA98, 37353949187177328, 89959921, 89959926, 5, 640x360 
0x1382CA98, 37353949187490880, 89959954, 89959959, 5, 640x360 
0x1382CA98, 37353949187805840, 89959980, 89959982, 2, 640x360 
0x1382CA98, 37353949188125544, 89960008, 89960014, 6, 640x360 
0x1382CA98, 37353949188459896, 89960046, 89960055, 9, 640x360 
0x1382CA98, 37353949188794632, 89960070, 89960073, 3, 640x360 
0x1382CA98, 37353949189112848, 89960102, 89960105, 3, 640x360 
0x1382CA98, 37353949189409096, 89960137, 89960140, 3, 640x360 
0x1382CA98, 37353949189729504, 89960169, 89960172, 3, 640x360 
0x1382CA98, 37353949190045912, 89960204, 89960209, 5, 640x360 
0x1382CA98, 37353949190534600, 89960253, 89960258, 5, 640x360 
0x1382CA98, 37353949190847224, 89960275, 89960281, 6, 640x360 
0x1382CA98, 37353949191165368, 89960312, 89960317, 5, 640x360 
0x1382CA98, 37353949191488592, 89960358, 89960361, 3, 640x360 
0x1382CA98, 37353949191806368, 89960380, 89960382, 2, 640x360 
0x1382CA98, 37353949192124944, 89960401, 89960403, 2, 640x360 
0x1382CA98, 37353949192447848, 89960442, 89960451, 9, 640x360 
0x1382CA98, 37353949192772312, 89960480, 89960482, 2, 640x360 
0x1382CA98, 37353949193100144, 89960500, 89960503, 3, 640x360 
0x1382CA98, 37353949193405696, 89960534, 89960538, 4, 640x360 
0x1382CA98, 37353949193724784, 89960576, 89960579, 3, 640x360 
0x1382CA98, 37353949194046696, 89960596, 89960605, 9, 640x360 
0x1382CA98, 37353949194524672, 89960646, 89960649, 3, 640x360 
0x1382CA98, 37353949194850376, 89960684, 89960690, 6, 640x360 
0x1382CA98, 37353949195165648, 89960710, 89960718, 8, 640x360 
0x1382CA98, 37353949195489272, 89960755, 89960767, 12, 640x360 
0x1382CA98, 37353949195806664, 89960791, 89960794, 3, 640x360 
0x1382CA98, 37353949196130144, 89960809, 89960818, 9, 640x360 
0x1382CA98, 37353949196446352, 89960841, 89960851, 10, 640x360 
0x1382CA98, 37353949196768520, 89960880, 89960885, 5, 640x360 
0x1382CA98, 37353949197094384, 89960911, 89960913, 2, 640x360 
0x1382CA98, 37353949197417960, 89960934, 89960937, 3, 640x360 
0x1382CA98, 37353949197725248, 89960968, 89960971, 3, 640x360 
0x1382CA98, 37353949198052248, 89961001, 89961003, 2, 640x360 
0x1382CA98, 37353949198524720, 89961047, 89961053, 6, 640x360 
0x1382CA98, 37353949198850416, 89961078, 89961081, 3, 640x360 
0x1382CA98, 37353949199173712, 89961119, 89961122, 3, 640x360 
0x1382CA98, 37353949199519408, 89961151, 89961154, 3, 640x360 
0x1382CA98, 37353949199811032, 89961191, 89961202, 11, 640x360 
0x1382CA98, 37353949200141608, 89961211, 89961230, 19, 640x360 
0x1382CA98, 37353949200453496, 89961242, 89961255, 13, 640x360 
0x1382CA98, 37353949200798896, 89961276, 89961282, 6, 640x360 
0x1382CA98, 37353949201086848, 89961310, 89961318, 8, 640x360 
0x1382CA98, 37353949201472736, 89961351, 89961361, 10, 640x360 
0x1382CA98, 37353949201733904, 89961398, 89961402, 4, 640x360 
0x1382CA98, 37353949202048744, 89961406, 89961418, 12, 640x360 
0x1382CA98, 37353949202539888, 89961455, 89961461, 6, 640x360 
0x1382CA98, 37353949202848536, 89961485, 89961492, 7, 640x360 
0x1382CA98, 37353949203168696, 89961507, 89961511, 4, 640x360 
0x1382CA98, 37353949203484032, 89961543, 89961545, 2, 640x360 
0x1382CA98, 37353949203804528, 89961573, 89961579, 6, 640x360 
0x1382CA98, 37353949204145392, 89961616, 89961628, 12, 640x360 
0x1382CA98, 37353949204459648, 89961650, 89961652, 2, 640x360 
0x1382CA98, 37353949204769600, 89961683, 89961685, 2, 640x360 
0x1382CA98, 37353949205104800, 89961715, 89961718, 3, 640x360 
0x1382CA98, 37353949205426480, 89961759, 89961764, 5, 640x360 
0x1382CA98, 37353949205737872, 89961779, 89961782, 3, 640x360 
0x1382CA98, 37353949206050728, 89961824, 89961826, 2, 640x360 
0x1382CA98, 37353949206525216, 89961863, 89961877, 14, 640x360 
0x1382CA98, 37353949206866136, 89961890, 89961917, 27, 640x360 
0x1382CA98, 37353949207165712, 89961919, 89961936, 17, 640x360 
0x1382CA98, 37353949207525816, 89961959, 89961975, 16, 640x360 
0x1382CA98, 37353949207848624, 89961987, 89962000, 13, 640x360 
0x1382CA98, 37353949208175568, 89962024, 89962043, 19, 640x360 
0x1382CA98, 37353949208465696, 89962066, 89962082, 16, 640x360 
0x1382CA98, 37353949208802616, 89962104, 89962119, 15, 640x360 
0x1382CA98, 37353949209119272, 89962134, 89962159, 25, 640x360 
0x1382CA98, 37353949209446064, 89962160, 89962169, 9, 640x360 
0x1382CA98, 37353949209776664, 89962185, 89962200, 15, 640x360 
0x1382CA98, 37353949210051248, 89962209, 89962215, 6, 640x360 
0x1382CA98, 37353949210527200, 89962257, 89962266, 9, 640x360 
0x1382CA98, 37353949210856448, 89962289, 89962293, 4, 640x360 
0x1382CA98, 37353949211164392, 89962309, 89962312, 3, 640x360 
0x1382CA98, 37353949211486288, 89962346, 89962353, 7, 640x360 
0x1382CA98, 37353949211812392, 89962374, 89962377, 3, 640x360 
0x1382CA98, 37353949212124280, 89962407, 89962409, 2, 640x360 
0x1382CA98, 37353949212444128, 89962436, 89962451, 15, 640x360 
0x1382CA98, 37353949212779088, 89962475, 89962477, 2, 640x360 
0x1382CA98, 37353949213099632, 89962502, 89962508, 6, 640x360 
0x1382CA98, 37353949213406432, 89962535, 89962542, 7, 640x360 
0x1382CA98, 37353949213727096, 89962580, 89962583, 3, 640x360 
0x1382CA98, 37353949214044672, 89962610, 89962612, 2, 640x360 
0x1382CA98, 37353949214523968, 89962652, 89962654, 2, 640x360 
0x1382CA98, 37353949214857408, 89962680, 89962683, 3, 640x360 
0x1382CA98, 37353949215169424, 89962711, 89962717, 6, 640x360 
0x1382CA98, 37353949215483968, 89962746, 89962748, 2, 640x360 
0x1382CA98, 37353949215804472, 89962780, 89962793, 13, 640x360 
0x1382CA98, 37353949216127280, 89962808, 89962810, 2, 640x360 
0x1382CA98, 37353949216444096, 89962836, 89962840, 4, 640x360 
0x1382CA98, 37353949216779672, 89962868, 89962870, 2, 640x360 
0x1382CA98, 37353949217089256, 89962911, 89962918, 7, 640x360 
0x1382CA98, 37353949217404976, 89962941, 89962944, 3, 640x360 
0x1382CA98, 37353949217729792, 89962964, 89962967, 3, 640x360 
0x1382CA98, 37353949218044336, 89962996, 89963003, 7, 640x360 
0x1382CA98, 37353949218369120, 89963028, 89963035, 7, 640x360 
0x1382CA98, 37353949218851568, 89963077, 89963079, 2, 640x360 
0x1382CA98, 37353949219164784, 89963114, 89963121, 7, 640x360 
0x1382CA98, 37353949219488328, 89963145, 89963148, 3, 640x360 
0x1382CA98, 37353949219806112, 89963176, 89963184, 8, 640x360 
0x1382CA98, 37353949220125664, 89963212, 89963219, 7, 640x360 
0x1382CA98, 37353949220446736, 89963245, 89963248, 3, 640x360 
0x1382CA98, 37353949220788608, 89963278, 89963281, 3, 640x360 
0x1382CA98, 37353949221112160, 89963308, 89963321, 13, 640x360 
0x1382CA98, 37353949221422088, 89963345, 89963351, 6, 640x360 
0x1382CA98, 37353949221724024, 89963376, 89963378, 2, 640x360 
0x1382CA98, 37353949222043992, 89963407, 89963416, 9, 640x360 
0x1382CA98, 37353949222843976, 89963479, 89963482, 3, 640x360 
0x1382CA98, 37353949223164520, 89963509, 89963512, 3, 640x360 
0x1382CA98, 37353949223484208, 89963542, 89963545, 3, 640x360 
0x1382CA98, 37353949223804520, 89963571, 89963576, 5, 640x360 
0x1382CA98, 37353949224124432, 89963603, 89963606, 3, 640x360 
0x1382CA98, 37353949224451192, 89963641, 89963644, 3, 640x360 
0x1382CA98, 37353949224765024, 89963670, 89963676, 6, 640x360 
0x1382CA98, 37353949225083960, 89963705, 89963710, 5, 640x360 
0x1382CA98, 37353949225404184, 89963737, 89963742, 5, 640x360 
0x1382CA98, 37353949225724664, 89963768, 89963770, 2, 640x360 
0x1382CA98, 37353949226044712, 89963795, 89963798, 3, 640x360 
0x1382CA98, 37353949226368384, 89963828, 89963832, 4, 640x360 
0x1382CA98, 37353949226844712, 89963885, 89963887, 2, 640x360 
0x1382CA98, 37353949227168784, 89963912, 89963919, 7, 640x360 
0x1382CA98, 37353949227484064, 89963945, 89963947, 2, 640x360 
0x1382CA98, 37353949227806008, 89963971, 89963982, 11, 640x360 
0x1382CA98, 37353949228128120, 89964001, 89964004, 3, 640x360 
0x1382CA98, 37353949228444472, 89964038, 89964043, 5, 640x360 
0x1382CA98, 37353949228764432, 89964070, 89964078, 8, 640x360 
0x1382CA98, 37353949229089488, 89964107, 89964110, 3, 640x360 
0x1382CA98, 37353949229411152, 89964132, 89964135, 3, 640x360 
0x1382CA98, 37353949229729632, 89964169, 89964172, 3, 640x360 
0x1382CA98, 37353949230049904, 89964201, 89964203, 2, 640x360 
0x1382CA98, 37353949230364880, 89964231, 89964233, 2, 640x360 
0x1382CA98, 37353949230843776, 89964276, 89964284, 8, 640x360 
0x1382CA98, 37353949231185472, 89964314, 89964322, 8, 640x360 
0x1382CA98, 37353949231483672, 89964343, 89964346, 3, 640x360 
0x1382CA98, 37353949231814760, 89964387, 89964393, 6, 640x360 
0x1382CA98, 37353949232129168, 89964420, 89964423, 3, 640x360 
0x1382CA98, 37353949232451912, 89964441, 89964448, 7, 640x360 
0x1382CA98, 37353949232767944, 89964467, 89964469, 2, 640x360 
0x1382CA98, 37353949233088392, 89964502, 89964506, 4, 640x360 
0x1382CA98, 37353949233403880, 89964538, 89964542, 4, 640x360 
0x1382CA98, 37353949233725144, 89964569, 89964571, 2, 640x360 
0x1382CA98, 37353949234043904, 89964598, 89964601, 3, 640x360 
0x1382CA98, 37353949234364216, 89964631, 89964633, 2, 640x360 
0x1382CA98, 37353949234847536, 89964681, 89964683, 2, 640x360 
0x1382CA98, 37353949235168328, 89964707, 89964710, 3, 640x360 
0x1382CA98, 37353949235483456, 89964740, 89964742, 2, 640x360 
0x1382CA98, 37353949235805400, 89964770, 89964776, 6, 640x360 
0x1382CA98, 37353949236124280, 89964801, 89964804, 3, 640x360 
0x1382CA98, 37353949236445480, 89964834, 89964841, 7, 640x360 
0x1382CA98, 37353949236776896, 89964867, 89964869, 2, 640x360 
0x1382CA98, 37353949237087592, 89964901, 89964904, 3, 640x360 
0x1382CA98, 37353949237424176, 89964933, 89964935, 2, 640x360 
0x1382CA98, 37353949237728992, 89964967, 89964976, 9, 640x360 
0x1382CA98, 37353949238044968, 89964996, 89965004, 8, 640x360 
0x1382CA98, 37353949238364816, 89965036, 89965042, 6, 640x360 
0x1382CA98, 37353949238849824, 89965077, 89965080, 3, 640x360 
0x1382CA98, 37353949239163632, 89965112, 89965115, 3, 640x360 
0x1382CA98, 37353949239487640, 89965138, 89965150, 12, 640x360 
0x1382CA98, 37353949239849520, 89965185, 89965190, 5, 640x360 
0x1382CA98, 37353949240125904, 89965220, 89965223, 3, 640x360 
0x1382CA98, 37353949240449088, 89965246, 89965248, 2, 640x360 
0x1382CA98, 37353949240782976, 89965273, 89965276, 3, 640x360 
0x1382CA98, 37353949241090792, 89965304, 89965311, 7, 640x360 
0x1382CA98, 37353949241455120, 89965356, 89965367, 11, 640x360 
0x1382CA98, 37353949241724864, 89965382, 89965386, 4, 640x360 
0x1382CA98, 37353949242055496, 89965420, 89965424, 4, 640x360 
0x1382CA98, 37353949242378848, 89965436, 89965448, 12, 640x360 
0x1382CA98, 37353949242716592, 89965468, 89965472, 4, 640x360 
0x1382CA98, 37353949243166448, 89965519, 89965521, 2, 640x360 
0x1382CA98, 37353949243485944, 89965554, 89965558, 4, 640x360 
0x1382CA98, 37353949243812600, 89965576, 89965588, 12, 640x360 
0x1382CA98, 37353949244131440, 89965624, 89965634, 10, 640x360 
0x1382CA98, 37353949244455088, 89965645, 89965647, 2, 640x360 
0x1382CA98, 37353949244767328, 89965670, 89965676, 6, 640x360 
0x1382CA98, 37353949245083760, 89965702, 89965706, 4, 640x360 
0x1382CA98, 37353949245403232, 89965737, 89965748, 11, 640x360 
0x1382CA98, 37353949245727360, 89965764, 89965767, 3, 640x360 
0x1382CA98, 37353949246043688, 89965796, 89965799, 3, 640x360 
0x1382CA98, 37353949246392808, 89965833, 89965835, 2, 640x360 
0x1382CA98, 37353949246684672, 89965859, 89965866, 7, 640x360 
0x1382CA98, 37353949247166288, 89965912, 89965914, 2, 640x360 
0x1382CA98, 37353949247483840, 89965947, 89965949, 2, 640x360 
0x1382CA98, 37353949247804024, 89965979, 89965982, 3, 640x360 
0x1382CA98, 37353949248131928, 89966010, 89966019, 9, 640x360 
0x1382CA98, 37353949248446192, 89966036, 89966043, 7, 640x360 
0x1382CA98, 37353949248768016, 89966067, 89966070, 3, 640x360 
0x1382CA98, 37353949249114200, 89966110, 89966114, 4, 640x360 
0x1382CA98, 37353949249408856, 89966142, 89966144, 2, 640x360 
0x1382CA98, 37353949249727560, 89966167, 89966170, 3, 640x360 
0x1382CA98, 37353949250046544, 89966201, 89966207, 6, 640x360 
0x1382CA98, 37353949250367192, 89966240, 89966250, 10, 640x360 
0x1382CA98, 37353949250691096, 89966269, 89966275, 6, 640x360 
0x1382CA98, 37353949251166688, 89966320, 89966323, 3, 640x360 
0x1382CA98, 37353949251482816, 89966356, 89966359, 3, 640x360 
0x1382CA98, 37353949251802720, 89966375, 89966378, 3, 640x360 
0x1382CA98, 37353949252123024, 89966404, 89966420, 16, 640x360 
0x1382CA98, 37353949252454240, 89966437, 89966443, 6, 640x360 
0x1382CA98, 37353949252764576, 89966468, 89966470, 2, 640x360 
0x1382CA98, 37353949253089056, 89966500, 89966502, 2, 640x360 
0x1382CA98, 37353949253410512, 89966540, 89966543, 3, 640x360 
0x1382CA98, 37353949253727880, 89966570, 89966575, 5, 640x360 
0x1382CA98, 37353949254043984, 89966595, 89966597, 2, 640x360 
0x1382CA98, 37353949254368792, 89966632, 89966635, 3, 640x360 
0x1382CA98, 37353949254685552, 89966668, 89966670, 2, 640x360 
0x1382CA98, 37353949255166120, 89966715, 89966717, 2, 640x360 
0x1382CA98, 37353949255482792, 89966747, 89966749, 2, 640x360 
0x1382CA98, 37353949255809736, 89966780, 89966782, 2, 640x360 
0x1382CA98, 37353949256124640, 89966805, 89966811, 6, 640x360 
0x1382CA98, 37353949256447632, 89966836, 89966841, 5, 640x360 
0x1382CA98, 37353949256763584, 89966867, 89966870, 3, 640x360 
0x1382CA98, 37353949257084000, 89966900, 89966902, 2, 640x360 
0x1382CA98, 37353949257412632, 89966931, 89966934, 3, 640x360 
0x1382CA98, 37353949257728784, 89966963, 89966965, 2, 640x360 
0x1382CA98, 37353949258047696, 89966995, 89967000, 5, 640x360 
0x1382CA98, 37353949258368912, 89967032, 89967034, 2, 640x360 
0x1382CA98, 37353949258686960, 89967059, 89967062, 3, 640x360 
0x1382CA98, 37353949259163792, 89967106, 89967109, 3, 640x360 
0x1382CA98, 37353949259483312, 89967142, 89967146, 4, 640x360 
0x1382CA98, 37353949259806984, 89967171, 89967177, 6, 640x360 
0x1382CA98, 37353949260123200, 89967202, 89967213, 11, 640x360 
0x1382CA98, 37353949260443736, 89967233, 89967235, 2, 640x360 
0x1382CA98, 37353949260768504, 89967268, 89967271, 3, 640x360 
0x1382CA98, 37353949261093608, 89967301, 89967303, 2, 640x360 
0x1382CA98, 37353949261426752, 89967334, 89967336, 2, 640x360 
0x1382CA98, 37353949261723528, 89967366, 89967368, 2, 640x360 
0x1382CA98, 37353949262043320, 89967399, 89967403, 4, 640x360 
0x1382CA98, 37353949262369720, 89967435, 89967438, 3, 640x360 
0x1382CA98, 37353949262684400, 89967465, 89967472, 7, 640x360 
0x1382CA98, 37353949263166800, 89967514, 89967522, 8, 640x360 
0x1382CA98, 37353949263486384, 89967537, 89967545, 8, 640x360 
0x1382CA98, 37353949263810376, 89967585, 89967588, 3, 640x360 
0x1382CA98, 37353949264126400, 89967613, 89967619, 6, 640x360 
0x1382CA98, 37353949264448256, 89967638, 89967647, 9, 640x360 
0x1382CA98, 37353949264769784, 89967678, 89967686, 8, 640x360 
0x1382CA98, 37353949265083000, 89967707, 89967717, 10, 640x360 
0x1382CA98, 37353949265407024, 89967735, 89967742, 7, 640x360 
0x1382CA98, 37353949265725456, 89967775, 89967779, 4, 640x360 
0x1382CA98, 37353949266047968, 89967802, 89967805, 3, 640x360 
0x1382CA98, 37353949266369712, 89967840, 89967852, 12, 640x360 
0x1382CA98, 37353949266700032, 89967869, 89967872, 3, 640x360 
0x1382CA98, 37353949267166992, 89967919, 89967921, 2, 640x360 
0x1382CA98, 37353949267485680, 89967951, 89967953, 2, 640x360 
0x1382CA98, 37353949267806720, 89967985, 89967987, 2, 640x360 
0x1382CA98, 37353949268186536, 89968013, 89968016, 3, 640x360 
0x1382CA98, 37353949268446736, 89968055, 89968068, 13, 640x360 
0x1382CA98, 37353949268777368, 89968086, 89968089, 3, 640x360 
0x1382CA98, 37353949269085408, 89968118, 89968141, 23, 640x360 
0x1382CA98, 37353949269419336, 89968149, 89968151, 2, 640x360 
0x1382CA98, 37353949269723368, 89968169, 89968173, 4, 640x360 
0x1382CA98, 37353949270051688, 89968207, 89968211, 4, 640x360 
0x1382CA98, 37353949270366096, 89968234, 89968235, 1, 640x360 
0x1382CA98, 37353949270684344, 89968262, 89968265, 3, 640x360 
0x1382CA98, 37353949271002640, 89968306, 89968311, 5, 640x360 
0x1382CA98, 37353949271486696, 89968347, 89968349, 2, 640x360 
0x1382CA98, 37353949271804448, 89968381, 89968389, 8, 640x360 
0x1382CA98, 37353949272122192, 89968404, 89968409, 5, 640x360 
0x1382CA98, 37353949272442944, 89968435, 89968441, 6, 640x360 
0x1382CA98, 37353949272768528, 89968472, 89968481, 9, 640x360 
0x1382CA98, 37353949273093216, 89968509, 89968511, 2, 640x360 
0x1382CA98, 37353949273408048, 89968533, 89968536, 3, 640x360 
0x1382CA98, 37353949273722880, 89968566, 89968568, 2, 640x360 
0x1382CA98, 37353949274047232, 89968605, 89968614, 9, 640x360 
0x1382CA98, 37353949274364328, 89968628, 89968634, 6, 640x360 
0x1382CA98, 37353949274696776, 89968665, 89968667, 2, 640x360 
0x1382CA98, 37353949275009696, 89968690, 89968707, 17, 640x360 
0x1382CA98, 37353949275482936, 89968750, 89968758, 8, 640x360 
0x1382CA98, 37353949275808416, 89968791, 89968798, 7, 640x360 
0x1382CA98, 37353949276139928, 89968816, 89968818, 2, 640x360 
0x1382CA98, 37353949276454992, 89968847, 89968862, 15, 640x360 
0x1382CA98, 37353949276821528, 89968886, 89968888, 2, 640x360 
0x1382CA98, 37353949277107552, 89968918, 89968919, 1, 640x360 
0x1382CA98, 37353949277407008, 89968944, 89968947, 3, 640x360 
0x1382CA98, 37353949277722416, 89968968, 89968971, 3, 640x360 
0x1382CA98, 37353949278042448, 89969007, 89969011, 4, 640x360 
0x1382CA98, 37353949278366336, 89969028, 89969031, 3, 640x360 
0x1382CA98, 37353949278683752, 89969065, 89969067, 2, 640x360 
0x1382CA98, 37353949279009824, 89969099, 89969101, 2, 640x360 
0x1382CA98, 37353949279488224, 89969151, 89969153, 2, 640x360 
0x1382CA98, 37353949279823696, 89969182, 89969184, 2, 640x360 
0x1382CA98, 37353949280125576, 89969222, 89969228, 6, 640x360 
0x1382CA98, 37353949280464056, 89969241, 89969245, 4, 640x360 
0x1382CA98, 37353949280774392, 89969272, 89969278, 6, 640x360 
0x1382CA98, 37353949281094192, 89969316, 89969319, 3, 640x360 
0x1382CA98, 37353949281413720, 89969343, 89969345, 2, 640x360 
0x1382CA98, 37353949281726824, 89969372, 89969385, 13, 640x360 
0x1382CA98, 37353949282047880, 89969412, 89969423, 11, 640x360 
0x1382CA98, 37353949282369560, 89969446, 89969449, 3, 640x360 
0x1382CA98, 37353949282684976, 89969475, 89969478, 3, 640x360 
0x1382CA98, 37353949283015480, 89969500, 89969503, 3, 640x360 
0x1382CA98, 37353949283484320, 89969554, 89969557, 3, 640x360 
0x1382CA98, 37353949283802408, 89969582, 89969584, 2, 640x360 
0x1382CA98, 37353949284121768, 89969603, 89969606, 3, 640x360 
0x1382CA98, 37353949284455304, 89969636, 89969641, 5, 640x360 
0x1382CA98, 37353949284768696, 89969677, 89969684, 7, 640x360 
0x1382CA98, 37353949285089072, 89969707, 89969714, 7, 640x360 
0x1382CA98, 37353949285402016, 89969737, 89969741, 4, 640x360 
0x1382CA98, 37353949285721944, 89969777, 89969779, 2, 640x360 
0x1382CA98, 37353949286050608, 89969799, 89969806, 7, 640x360 
0x1382CA98, 37353949286362808, 89969834, 89969837, 3, 640x360 
0x1382CA98, 37353949286687920, 89969870, 89969872, 2, 640x360 
0x1382CA98, 37353949287006088, 89969898, 89969904, 6, 640x360 
0x1382CA98, 37353949287486704, 89969952, 89969958, 6, 640x360 
0x1382CA98, 37353949287813560, 89969974, 89969979, 5, 640x360 
0x1382CA98, 37353949288159080, 89970017, 89970026, 9, 640x360 
0x1382CA98, 37353949288475696, 89970064, 89970069, 5, 640x360 
0x1382CA98, 37353949288778432, 89970082, 89970085, 3, 640x360 
0x1382CA98, 37353949289098568, 89970114, 89970116, 2, 640x360 
0x1382CA98, 37353949289403112, 89970146, 89970152, 6, 640x360 
0x1382CA98, 37353949289722088, 89970185, 89970187, 2, 640x360 
0x1382CA98, 37353949290047368, 89970203, 89970209, 6, 640x360 
0x1382CA98, 37353949290362280, 89970229, 89970232, 3, 640x360 
0x1382CA98, 37353949290682416, 89970270, 89970273, 3, 640x360 
0x1382CA98, 37353949291007240, 89970297, 89970305, 8, 640x360 
0x1382CA98, 37353949291491008, 89970348, 89970350, 2, 640x360 
0x1382CA98, 37353949291801704, 89970370, 89970376, 6, 640x360 
0x1382CA98, 37353949292122264, 89970416, 89970418, 2, 640x360 
0x1382CA98, 37353949292446320, 89970440, 89970448, 8, 640x360 
0x1382CA98, 37353949292762488, 89970472, 89970484, 12, 640x360 
0x1382CA98, 37353949293083552, 89970512, 89970519, 7, 640x360 
0x1382CA98, 37353949293402440, 89970533, 89970535, 2, 640x360 
0x1382CA98, 37353949293721856, 89970564, 89970566, 2, 640x360 
0x1382CA98, 37353949294042072, 89970595, 89970603, 8, 640x360 
0x1382CA98, 37353949294362544, 89970631, 89970633, 2, 640x360 
0x1382CA98, 37353949294682576, 89970662, 89970670, 8, 640x360 
0x1382CA98, 37353949295007312, 89970697, 89970700, 3, 640x360 
0x1382CA98, 37353949295322296, 89970724, 89970735, 11, 640x360 
0x1382CA98, 37353949295804768, 89970774, 89970783, 9, 640x360 
0x1382CA98, 37353949296135680, 89970810, 89970816, 6, 640x360 
0x1382CA98, 37353949296446080, 89970843, 89970853, 10, 640x360 
0x1382CA98, 37353949296793888, 89970871, 89970885, 14, 640x360 
0x1382CA98, 37353949297082232, 89970904, 89970919, 15, 640x360 
0x1382CA98, 37353949297408184, 89970941, 89970949, 8, 640x360 
0x1382CA98, 37353949297721792, 89970972, 89970982, 10, 640x360 
0x1382CA98, 37353949298041904, 89971007, 89971010, 3, 640x360 
0x1382CA98, 37353949298362832, 89971042, 89971044, 2, 640x360 
0x1382CA98, 37353949298685664, 89971062, 89971070, 8, 640x360 
0x1382CA98, 37353949299004168, 89971092, 89971096, 4, 640x360 
0x1382CA98, 37353949299321992, 89971130, 89971133, 3, 640x360 
0x1382CA98, 37353949299804456, 89971186, 89971191, 5, 640x360 
0x1382CA98, 37353949300136968, 89971216, 89971219, 3, 640x360 
0x1382CA98, 37353949300447400, 89971251, 89971253, 2, 640x360 
0x1382CA98, 37353949300772064, 89971298, 89971313, 15, 640x360 
0x1382CA98, 37353949301100864, 89971320, 89971327, 7, 640x360 
0x1382CA98, 37353949301417408, 89971339, 89971349, 10, 640x360 
0x1382CA98, 37353949301727136, 89971371, 89971373, 2, 640x360 
0x1382CA98, 37353949302045912, 89971397, 89971400, 3, 640x360 
0x1382CA98, 37353949302362568, 89971435, 89971438, 3, 640x360 
0x1382CA98, 37353949302687144, 89971462, 89971465, 3, 640x360 
0x1382CA98, 37353949303013824, 89971499, 89971502, 3, 640x360 
0x1382CA98, 37353949303322768, 89971529, 89971533, 4, 640x360 
0x1382CA98, 37353949303801928, 89971570, 89971572, 2, 640x360 
0x1382CA98, 37353949304133816, 89971610, 89971612, 2, 640x360 
0x1382CA98, 37353949304441456, 89971636, 89971639, 3, 640x360 
0x1382CA98, 37353949304783936, 89971673, 89971682, 9, 640x360 
0x1382CA98, 37353949305118872, 89971712, 89971716, 4, 640x360 
0x1382CA98, 37353949305402840, 89971741, 89971744, 3, 640x360 
0x1382CA98, 37353949305721640, 89971776, 89971777, 1, 640x360 
0x1382CA98, 37353949306041568, 89971805, 89971810, 5, 640x360 
0x1382CA98, 37353949306366712, 89971833, 89971840, 7, 640x360 
0x1382CA98, 37353949306682784, 89971875, 89971878, 3, 640x360 
0x1382CA98, 37353949307006872, 89971898, 89971907, 9, 640x360 
0x1382CA98, 37353949307326568, 89971932, 89971934, 2, 640x360 
0x1382CA98, 37353949307802024, 89971971, 89971978, 7, 640x360 
0x1382CA98, 37353949308124792, 89972012, 89972020, 8, 640x360 
0x1382CA98, 37353949308450960, 89972042, 89972048, 6, 640x360 
0x1382CA98, 37353949308766616, 89972074, 89972083, 9, 640x360 
0x1382CA98, 37353949309083560, 89972105, 89972111, 6, 640x360 
0x1382CA98, 37353949309441416, 89972138, 89972143, 5, 640x360 
0x1382CA98, 37353949309722032, 89972169, 89972172, 3, 640x360 
0x1382CA98, 37353949310052168, 89972201, 89972203, 2, 640x360 
0x1382CA98, 37353949310369216, 89972234, 89972236, 2, 640x360 
0x1382CA98, 37353949310694648, 89972277, 89972279, 2, 640x360 
0x1382CA98, 37353949311003160, 89972301, 89972303, 2, 640x360 
0x1382CA98, 37353949311321768, 89972331, 89972333, 2, 640x360 
0x1382CA98, 37353949311823648, 89972385, 89972395, 10, 640x360 
0x1382CA98, 37353949312146432, 89972414, 89972416, 2, 640x360 
0x1382CA98, 37353949312443536, 89972442, 89972453, 11, 640x360 
0x1382CA98, 37353949312766824, 89972470, 89972474, 4, 640x360 
0x1382CA98, 37353949313083992, 89972507, 89972510, 3, 640x360 
0x1382CA98, 37353949313410536, 89972534, 89972537, 3, 640x360 
0x1382CA98, 37353949313724296, 89972564, 89972567, 3, 640x360 
0x1382CA98, 37353949314045192, 89972601, 89972607, 6, 640x360 
0x1382CA98, 37353949314362232, 89972638, 89972644, 6, 640x360 
0x1382CA98, 37353949314691472, 89972671, 89972676, 5, 640x360 
0x1382CA98, 37353949315006960, 89972697, 89972700, 3, 640x360 
0x1382CA98, 37353949315333616, 89972730, 89972738, 8, 640x360 
0x1382CA98, 37353949315804144, 89972792, 89972806, 14, 640x360 
0x1382CA98, 37353949316152448, 89972816, 89972818, 2, 640x360 
0x1382CA98, 37353949316443328, 89972843, 89972845, 2, 640x360 
0x1382CA98, 37353949316777016, 89972879, 89972881, 2, 640x360 
0x1382CA98, 37353949317086016, 89972912, 89972920, 8, 640x360 
0x1382CA98, 37353949317406440, 89972945, 89972947, 2, 640x360 
0x1382CA98, 37353949317721288, 89972966, 89972968, 2, 640x360 
0x1382CA98, 37353949318045040, 89973000, 89973002, 2, 640x360 
0x1382CA98, 37353949318361232, 89973044, 89973046, 2, 640x360 
0x1382CA98, 37353949318681496, 89973075, 89973078, 3, 640x360 
0x1382CA98, 37353949319004264, 89973095, 89973099, 4, 640x360 
0x1382CA98, 37353949319329160, 89973132, 89973134, 2, 640x360 
0x1382CA98, 37353949319805808, 89973175, 89973183, 8, 640x360 
0x1382CA98, 37353949320127848, 89973204, 89973215, 11, 640x360 
0x1382CA98, 37353949320444008, 89973243, 89973250, 7, 640x360 
0x1382CA98, 37353949320770808, 89973276, 89973283, 7, 640x360 
0x1382CA98, 37353949321083208, 89973308, 89973310, 2, 640x360 
0x1382CA98, 37353949321419216, 89973343, 89973345, 2, 640x360 
0x1382CA98, 37353949321723584, 89973366, 89973369, 3, 640x360 
0x1382CA98, 37353949322041112, 89973398, 89973401, 3, 640x360 
0x1382CA98, 37353949322361104, 89973431, 89973433, 2, 640x360 
0x1382CA98, 37353949322682240, 89973463, 89973465, 2, 640x360 
0x1382CA98, 37353949323008000, 89973500, 89973501, 1, 640x360 
0x1382CA98, 37353949323328552, 89973535, 89973537, 2, 640x360 
0x1382CA98, 37353949323641360, 89973566, 89973568, 2, 640x360 
0x1382CA98, 37353949324121520, 89973605, 89973611, 6, 640x360 
0x1382CA98, 37353949324442000, 89973637, 89973642, 5, 640x360 
0x1382CA98, 37353949324784856, 89973685, 89973687, 2, 640x360 
0x1382CA98, 37353949325084896, 89973704, 89973710, 6, 640x360 
0x1382CA98, 37353949325404120, 89973737, 89973741, 4, 640x360 
0x1382CA98, 37353949325725400, 89973765, 89973767, 2, 640x360 
0x1382CA98, 37353949326045488, 89973810, 89973812, 2, 640x360 
0x1382CA98, 37353949326361864, 89973838, 89973849, 11, 640x360 
0x1382CA98, 37353949326685296, 89973884, 89973886, 2, 640x360 
0x1382CA98, 37353949327010016, 89973910, 89973914, 4, 640x360 
0x1382CA98, 37353949327322296, 89973929, 89973938, 9, 640x360 
0x1382CA98, 37353949327642576, 89973959, 89973962, 3, 640x360 
0x1382CA98, 37353949328122112, 89974008, 89974014, 6, 640x360 
0x1382CA98, 37353949328443080, 89974037, 89974045, 8, 640x360 
0x1382CA98, 37353949328761192, 89974078, 89974080, 2, 640x360 
0x1382CA98, 37353949329082360, 89974116, 89974118, 2, 640x360 
0x1382CA98, 37353949329401656, 89974145, 89974148, 3, 640x360 
0x1382CA98, 37353949329738592, 89974171, 89974177, 6, 640x360 
0x1382CA98, 37353949330052296, 89974211, 89974214, 3, 640x360 
0x1382CA98, 37353949330365032, 89974243, 89974259, 16, 640x360 
0x1382CA98, 37353949330689264, 89974281, 89974285, 4, 640x360 
0x1382CA98, 37353949331022248, 89974302, 89974308, 6, 640x360 
0x1382CA98, 37353949331321224, 89974336, 89974338, 2, 640x360 
0x1382CA98, 37353949331665024, 89974364, 89974366, 2, 640x360 
0x1382CA98, 37353949332126216, 89974408, 89974417, 9, 640x360 
0x1382CA98, 37353949332443880, 89974445, 89974451, 6, 640x360 
0x1382CA98, 37353949332781408, 89974476, 89974483, 7, 640x360 
0x1382CA98, 37353949333086880, 89974507, 89974517, 10, 640x360 
0x1382CA98, 37353949333400752, 89974543, 89974546, 3, 640x360 
0x1382CA98, 37353949333722128, 89974567, 89974569, 2, 640x360 
0x1382CA98, 37353949334040608, 89974598, 89974600, 2, 640x360 
0x1382CA98, 37353949334361184, 89974636, 89974638, 2, 640x360 
0x1382CA98, 37353949334686296, 89974662, 89974664, 2, 640x360 
0x1382CA98, 37353949335001128, 89974694, 89974696, 2, 640x360 
0x1382CA98, 37353949335321680, 89974721, 89974733, 12, 640x360 
0x1382CA98, 37353949335641616, 89974764, 89974766, 2, 640x360 
0x1382CA98, 37353949336121424, 89974804, 89974808, 4, 640x360 
0x1382CA98, 37353949336448232, 89974845, 89974848, 3, 640x360 
0x1382CA98, 37353949336765064, 89974868, 89974872, 4, 640x360 
0x1382CA98, 37353949337085232, 89974901, 89974903, 2, 640x360 
0x1382CA98, 37353949337422328, 89974932, 89974934, 2, 640x360 
0x1382CA98, 37353949337721680, 89974963, 89974966, 3, 640x360 
0x1382CA98, 37353949338041584, 89974999, 89975004, 5, 640x360 
0x1382CA98, 37353949338361864, 89975031, 89975033, 2, 640x360 
0x1382CA98, 37353949338681640, 89975062, 89975068, 6, 640x360 
0x1382CA98, 37353949339001936, 89975094, 89975102, 8, 640x360 
0x1382CA98, 37353949339331080, 89975140, 89975148, 8, 640x360 
0x1382CA98, 37353949339675592, 89975163, 89975166, 3, 640x360 
0x1382CA98, 37353949340120752, 89975207, 89975211, 4, 640x360 
0x1382CA98, 37353949340440584, 89975241, 89975243, 2, 640x360 
0x1382CA98, 37353949340760400, 89975274, 89975276, 2, 640x360 
0x1382CA98, 37353949341083904, 89975300, 89975303, 3, 640x360 
0x1382CA98, 37353949341401552, 89975337, 89975339, 2, 640x360 
0x1382CA98, 37353949341721536, 89975364, 89975366, 2, 640x360 
0x1382CA98, 37353949342040984, 89975400, 89975407, 7, 640x360 
0x1382CA98, 37353949342365040, 89975436, 89975438, 2, 640x360 
0x1382CA98, 37353949342681480, 89975463, 89975471, 8, 640x360 
0x1382CA98, 37353949343009664, 89975497, 89975506, 9, 640x360 
0x1382CA98, 37353949343322224, 89975531, 89975533, 2, 640x360 
0x1382CA98, 37353949343640752, 89975571, 89975577, 6, 640x360 
0x1382CA98, 37353949344126000, 89975608, 89975617, 9, 640x360 
0x1382CA98, 37353949344450360, 89975647, 89975649, 2, 640x360 
0x1382CA98, 37353949344778816, 89975669, 89975672, 3, 640x360 
0x1382CA98, 37353949345096480, 89975703, 89975706, 3, 640x360 
0x1382CA98, 37353949345404448, 89975738, 89975751, 13, 640x360 
0x1382CA98, 37353949345720400, 89975769, 89975771, 2, 640x360 
0x1382CA98, 37353949346040440, 89975800, 89975802, 2, 640x360 
0x1382CA98, 37353949346360792, 89975832, 89975834, 2, 640x360 
0x1382CA98, 37353949346681824, 89975864, 89975866, 2, 640x360 
0x1382CA98, 37353949347001480, 89975896, 89975898, 2, 640x360 
0x1382CA98, 37353949347326736, 89975927, 89975936, 9, 640x360 
0x1382CA98, 37353949347643960, 89975961, 89975963, 2, 640x360 
0x1382CA98, 37353949348120896, 89976010, 89976013, 3, 640x360 
0x1382CA98, 37353949348441400, 89976036, 89976040, 4, 640x360 
0x1382CA98, 37353949348771976, 89976076, 89976078, 2, 640x360 
0x1382CA98, 37353949349083168, 89976105, 89976109, 4, 640x360 
0x1382CA98, 37353949349400600, 89976143, 89976145, 2, 640x360 
0x1382CA98, 37353949349724680, 89976168, 89976173, 5, 640x360 
0x1382CA98, 37353949350041072, 89976201, 89976203, 2, 640x360 
0x1382CA98, 37353949350361088, 89976231, 89976234, 3, 640x360 
0x1382CA98, 37353949350689472, 89976262, 89976265, 3, 640x360 
0x1382CA98, 37353949351002840, 89976299, 89976306, 7, 640x360 
0x1382CA98, 37353949351321072, 89976327, 89976330, 3, 640x360 
0x1382CA98, 37353949351641528, 89976362, 89976373, 11, 640x360 
0x1382CA98, 37353949351960736, 89976393, 89976401, 8, 640x360 
0x1382CA98, 37353949352457560, 89976446, 89976449, 3, 640x360 
0x1382CA98, 37353949352761584, 89976471, 89976478, 7, 640x360 
0x1382CA98, 37353949353095344, 89976505, 89976511, 6, 640x360 
0x1382CA98, 37353949353419896, 89976537, 89976539, 2, 640x360 
0x1382CA98, 37353949353724784, 89976565, 89976574, 9, 640x360 
0x1382CA98, 37353949354040192, 89976605, 89976615, 10, 640x360 
0x1382CA98, 37353949354360656, 89976630, 89976633, 3, 640x360 
0x1382CA98, 37353949354683072, 89976666, 89976672, 6, 640x360 
0x1382CA98, 37353949355005240, 89976696, 89976698, 2, 640x360 
0x1382CA98, 37353949355320336, 89976723, 89976731, 8, 640x360 
0x1382CA98, 37353949355642592, 89976766, 89976768, 2, 640x360 
0x1382CA98, 37353949355965296, 89976806, 89976812, 6, 640x360 
0x1382CA98, 37353949356450256, 89976846, 89976848, 2, 640x360 
0x1382CA98, 37353949356777832, 89976889, 89976903, 14, 640x360 
0x1382CA98, 37353949357080736, 89976911, 89976921, 10, 640x360 
0x1382CA98, 37353949357413568, 89976964, 89976983, 19, 640x360 
0x1382CA98, 37353949357727824, 89977012, 89977020, 8, 640x360 
0x1382CA98, 37353949358069216, 89977020, 89977030, 10, 640x360 
0x1382CA98, 37353949358368816, 89977050, 89977062, 12, 640x360 
0x1382CA98, 37353949358697216, 89977079, 89977081, 2, 640x360 
0x1382CA98, 37353949359008008, 89977103, 89977106, 3, 640x360 
0x1382CA98, 37353949359320456, 89977130, 89977135, 5, 640x360 
0x1382CA98, 37353949359640792, 89977164, 89977174, 10, 640x360 
0x1382CA98, 37353949359960536, 89977193, 89977195, 2, 640x360 
0x1382CA98, 37353949360440024, 89977240, 89977244, 4, 640x360 
0x1382CA98, 37353949360760312, 89977274, 89977277, 3, 640x360 
0x1382CA98, 37353949361083016, 89977308, 89977311, 3, 640x360 
0x1382CA98, 37353949361403896, 89977333, 89977335, 2, 640x360 
0x1382CA98, 37353949361726232, 89977366, 89977375, 9, 640x360 
0x1382CA98, 37353949362043736, 89977398, 89977399, 1, 640x360 
0x1382CA98, 37353949362363640, 89977429, 89977434, 5, 640x360 
0x1382CA98, 37353949362684488, 89977465, 89977470, 5, 640x360 
0x1382CA98, 37353949363019128, 89977498, 89977501, 3, 640x360 
0x1382CA98, 37353949363324720, 89977537, 89977541, 4, 640x360 
0x1382CA98, 37353949363663152, 89977569, 89977571, 2, 640x360 
0x1382CA98, 37353949363964872, 89977587, 89977591, 4, 640x360 
0x1382CA98, 37353949364441528, 89977642, 89977650, 8, 640x360 
0x1382CA98, 37353949364790472, 89977685, 89977687, 2, 640x360 
0x1382CA98, 37353949365083488, 89977708, 89977716, 8, 640x360 
0x1382CA98, 37353949365403760, 89977735, 89977736, 1, 640x360 
0x1382CA98, 37353949365723560, 89977767, 89977769, 2, 640x360 
0x1382CA98, 37353949366040736, 89977807, 89977810, 3, 640x360 
0x1382CA98, 37353949366364672, 89977835, 89977838, 3, 640x360 
0x1382CA98, 37353949366684296, 89977863, 89977866, 3, 640x360 
0x1382CA98, 37353949367001072, 89977897, 89977899, 2, 640x360 
0x1382CA98, 37353949367323912, 89977930, 89977933, 3, 640x360 
0x1382CA98, 37353949367640504, 89977955, 89977965, 10, 640x360 
0x1382CA98, 37353949367964944, 89977999, 89978002, 3, 640x360 
0x1382CA98, 37353949368442920, 89978042, 89978047, 5, 640x360 
0x1382CA98, 37353949368808832, 89978074, 89978084, 10, 640x360 
0x1382CA98, 37353949369091520, 89978114, 89978125, 11, 640x360 
0x1382CA98, 37353949369406360, 89978134, 89978137, 3, 640x360 
0x1382CA98, 37353949369724040, 89978176, 89978178, 2, 640x360 
0x1382CA98, 37353949370043832, 89978205, 89978212, 7, 640x360 
0x1382CA98, 37353949370362808, 89978236, 89978238, 2, 640x360 
0x1382CA98, 37353949370679864, 89978264, 89978270, 6, 640x360 
0x1382CA98, 37353949371000664, 89978295, 89978297, 2, 640x360 
0x1382CA98, 37353949371320776, 89978321, 89978324, 3, 640x360 
0x1382CA98, 37353949371640720, 89978362, 89978364, 2, 640x360 
0x1382CA98, 37353949371960864, 89978388, 89978393, 5, 640x360 
0x1382CA98, 37353949372442664, 89978435, 89978438, 3, 640x360 
0x1382CA98, 37353949372761752, 89978471, 89978476, 5, 640x360 
0x1382CA98, 37353949373082504, 89978502, 89978504, 2, 640x360 
0x1382CA98, 37353949373400640, 89978533, 89978535, 2, 640x360 
0x1382CA98, 37353949373721368, 89978564, 89978567, 3, 640x360 
0x1382CA98, 37353949374040232, 89978603, 89978607, 4, 640x360 
0x1382CA98, 37353949374363928, 89978629, 89978633, 4, 640x360 
0x1382CA98, 37353949374683160, 89978662, 89978666, 4, 640x360 
0x1382CA98, 37353949375005208, 89978708, 89978724, 16, 640x360 
0x1382CA98, 37353949375327696, 89978735, 89978741, 6, 640x360 
0x1382CA98, 37353949375642120, 89978756, 89978768, 12, 640x360 
0x1382CA98, 37353949375960672, 89978797, 89978799, 2, 640x360 
0x1382CA98, 37353949376443560, 89978841, 89978850, 9, 640x360 
0x1382CA98, 37353949376787088, 89978879, 89978885, 6, 640x360 
0x1382CA98, 37353949377080288, 89978910, 89978913, 3, 640x360 
0x1382CA98, 37353949377400776, 89978945, 89978947, 2, 640x360 
0x1382CA98, 37353949377729256, 89978966, 89978969, 3, 640x360 
0x1382CA98, 37353949378039992, 89978997, 89979000, 3, 640x360 
0x1382CA98, 37353949378359800, 89979029, 89979035, 6, 640x360 
0x1382CA98, 37353949378683872, 89979062, 89979065, 3, 640x360 
0x1382CA98, 37353949379000448, 89979093, 89979101, 8, 640x360 
0x1382CA98, 37353949379320736, 89979124, 89979132, 8, 640x360 
0x1382CA98, 37353949379640760, 89979156, 89979163, 7, 640x360 
0x1382CA98, 37353949379960760, 89979190, 89979199, 9, 640x360 
0x1382CA98, 37353949380283824, 89979222, 89979230, 8, 640x360 
0x1382CA98, 37353949380760192, 89979267, 89979270, 3, 640x360 
0x1382CA98, 37353949381081560, 89979300, 89979303, 3, 640x360 
0x1382CA98, 37353949381403384, 89979334, 89979336, 2, 640x360 
0x1382CA98, 37353949381725656, 89979365, 89979368, 3, 640x360 
0x1382CA98, 37353949382039848, 89979396, 89979401, 5, 640x360 
0x1382CA98, 37353949382364040, 89979427, 89979431, 4, 640x360 
0x1382CA98, 37353949382680712, 89979464, 89979466, 2, 640x360 
0x1382CA98, 37353949383004264, 89979494, 89979501, 7, 640x360 
0x1382CA98, 37353949383331960, 89979525, 89979534, 9, 640x360 
0x1382CA98, 37353949383640672, 89979556, 89979563, 7, 640x360 
0x1382CA98, 37353949383960728, 89979591, 89979594, 3, 640x360 
0x1382CA98, 37353949384280888, 89979620, 89979628, 8, 640x360 
0x1382CA98, 37353949384760256, 89979667, 89979672, 5, 640x360 
0x1382CA98, 37353949385088256, 89979703, 89979706, 3, 640x360 
0x1382CA98, 37353949385425776, 89979734, 89979737, 3, 640x360 
0x1382CA98, 37353949385722376, 89979765, 89979767, 2, 640x360 
0x1382CA98, 37353949386043112, 89979797, 89979800, 3, 640x360 
0x1382CA98, 37353949386366008, 89979840, 89979847, 7, 640x360 
0x1382CA98, 37353949386683472, 89979869, 89979877, 8, 640x360 
0x1382CA98, 37353949387006144, 89979898, 89979910, 12, 640x360 
0x1382CA98, 37353949387326200, 89979936, 89979956, 20, 640x360 
0x1382CA98, 37353949387649776, 89979968, 89979971, 3, 640x360 
0x1382CA98, 37353949387968640, 89980012, 89980026, 14, 640x360 
0x1382CA98, 37353949388306328, 89980036, 89980048, 12, 640x360 
0x1382CA98, 37353949388767520, 89980080, 89980085, 5, 640x360 
0x1382CA98, 37353949389079344, 89980105, 89980111, 6, 640x360 
0x1382CA98, 37353949389405992, 89980146, 89980148, 2, 640x360 
0x1382CA98, 37353949389719672, 89980171, 89980178, 7, 640x360 
0x1382CA98, 37353949390043488, 89980217, 89980223, 6, 640x360 
0x1382CA98, 37353949390362960, 89980234, 89980241, 7, 640x360 
0x1382CA98, 37353949390679800, 89980266, 89980272, 6, 640x360 
0x1382CA98, 37353949390999640, 89980309, 89980319, 10, 640x360 
0x1382CA98, 37353949391319816, 89980336, 89980339, 3, 640x360 
0x1382CA98, 37353949391647824, 89980372, 89980375, 3, 640x360 
0x1382CA98, 37353949391959752, 89980391, 89980395, 4, 640x360 
0x1382CA98, 37353949392297056, 89980437, 89980441, 4, 640x360 
0x1382CA98, 37353949392775256, 89980474, 89980483, 9, 640x360 
0x1382CA98, 37353949393101992, 89980506, 89980512, 6, 640x360 
0x1382CA98, 37353949393401912, 89980535, 89980537, 2, 640x360 
0x1382CA98, 37353949393720952, 89980569, 89980572, 3, 640x360 
0x1382CA98, 37353949394041872, 89980608, 89980611, 3, 640x360 
0x1382CA98, 37353949394362680, 89980635, 89980637, 2, 640x360 
0x1382CA98, 37353949394682608, 89980672, 89980676, 4, 640x360 
0x1382CA98, 37353949395000088, 89980695, 89980703, 8, 640x360 
0x1382CA98, 37353949395320440, 89980729, 89980732, 3, 640x360 
0x1382CA98, 37353949395639576, 89980769, 89980771, 2, 640x360 
0x1382CA98, 37353949395959840, 89980802, 89980805, 3, 640x360 
0x1382CA98, 37353949396281776, 89980835, 89980837, 2, 640x360 
0x1382CA98, 37353949396768672, 89980869, 89980872, 3, 640x360 
0x1382CA98, 37353949397080224, 89980911, 89980917, 6, 640x360 
0x1382CA98, 37353949397399560, 89980944, 89980951, 7, 640x360 
0x1382CA98, 37353949397720768, 89980969, 89980972, 3, 640x360 
0x1382CA98, 37353949398043496, 89981002, 89981004, 2, 640x360 
0x1382CA98, 37353949398359632, 89981037, 89981040, 3, 640x360 
0x1382CA98, 37353949398679288, 89981061, 89981064, 3, 640x360 
0x1382CA98, 37353949399010280, 89981094, 89981106, 12, 640x360 
0x1382CA98, 37353949399324496, 89981142, 89981145, 3, 640x360 
0x1382CA98, 37353949399642056, 89981164, 89981173, 9, 640x360 
0x1382CA98, 37353949399960448, 89981193, 89981204, 11, 640x360 
0x1382CA98, 37353949400282968, 89981227, 89981230, 3, 640x360 
0x1382CA98, 37353949400776816, 89981279, 89981281, 2, 640x360 
0x1382CA98, 37353949401088400, 89981300, 89981303, 3, 640x360 
0x1382CA98, 37353949401399800, 89981336, 89981339, 3, 640x360 
0x1382CA98, 37353949401724360, 89981367, 89981370, 3, 640x360 
0x1382CA98, 37353949402040416, 89981399, 89981401, 2, 640x360 
0x1382CA98, 37353949402359744, 89981436, 89981438, 2, 640x360 
0x1382CA98, 37353949402679584, 89981470, 89981473, 3, 640x360 
0x1382CA98, 37353949403008008, 89981495, 89981502, 7, 640x360 
0x1382CA98, 37353949403325384, 89981529, 89981535, 6, 640x360 
0x1382CA98, 37353949403643832, 89981565, 89981570, 5, 640x360 
0x1382CA98, 37353949403959792, 89981596, 89981599, 3, 640x360 
0x1382CA98, 37353949404289408, 89981622, 89981633, 11, 640x360 
0x1382CA98, 37353949404609464, 89981669, 89981671, 2, 640x360 
0x1382CA98, 37353949405080568, 89981710, 89981717, 7, 640x360 
0x1382CA98, 37353949405399064, 89981743, 89981752, 9, 640x360 
0x1382CA98, 37353949405719328, 89981764, 89981770, 6, 640x360 
0x1382CA98, 37353949406038976, 89981798, 89981800, 2, 640x360 
0x1382CA98, 37353949406366392, 89981836, 89981842, 6, 640x360 
0x1382CA98, 37353949406680128, 89981868, 89981872, 4, 640x360 
0x1382CA98, 37353949407009256, 89981909, 89981920, 11, 640x360 
0x1382CA98, 37353949407338288, 89981935, 89981937, 2, 640x360 
0x1382CA98, 37353949407646024, 89981985, 89981996, 11, 640x360 
0x1382CA98, 37353949407978320, 89982016, 89982021, 5, 640x360 
0x1382CA98, 37353949408299032, 89982042, 89982044, 2, 640x360 
0x1382CA98, 37353949408623888, 89982065, 89982069, 4, 640x360 
0x1382CA98, 37353949409099840, 89982119, 89982150, 31, 640x360 
0x1382CA98, 37353949409434424, 89982168, 89982195, 27, 640x360 
0x1382CA98, 37353949409732128, 89982195, 89982208, 13, 640x360 
0x1382CA98, 37353949410051392, 89982244, 89982256, 12, 640x360 
0x1382CA98, 37353949410388224, 89982258, 89982268, 10, 640x360 
0x1382CA98, 37353949410686392, 89982273, 89982313, 40, 640x360 
0x1382CA98, 37353949411025840, 89982313, 89982362, 49, 640x360 
0x1382CA98, 37353949411334624, 89982363, 89982385, 22, 640x360 
0x1382CA98, 37353949411706432, 89982386, 89982425, 39, 640x360 
0x1382CA98, 37353949411991040, 89982442, 89982461, 19, 640x360 
0x1382CA98, 37353949412625288, 89982470, 89982476, 6, 640x360 
0x1382CA98, 37353949413084928, 89982526, 89982528, 2, 640x360 
0x1382CA98, 37353949413402304, 89982550, 89982555, 5, 640x360 
0x1382CA98, 37353949413725800, 89982580, 89982582, 2, 640x360 
0x1382CA98, 37353949414044968, 89982608, 89982612, 4, 640x360 
0x1382CA98, 37353949414366096, 89982633, 89982635, 2, 640x360 
0x1382CA98, 37353949414678648, 89982664, 89982667, 3, 640x360 
0x1382CA98, 37353949415000872, 89982707, 89982710, 3, 640x360 
0x1382CA98, 37353949415322824, 89982733, 89982736, 3, 640x360 
0x1382CA98, 37353949415645408, 89982760, 89982769, 9, 640x360 
0x1382CA98, 37353949415960256, 89982792, 89982800, 8, 640x360 
0x1382CA98, 37353949416278888, 89982827, 89982831, 4, 640x360 
0x1382CA98, 37353949416609056, 89982863, 89982872, 9, 640x360 
0x1382CA98, 37353949417089712, 89982901, 89982905, 4, 640x360 
0x1382CA98, 37353949417403712, 89982944, 89982946, 2, 640x360 
0x1382CA98, 37353949417726080, 89982977, 89982979, 2, 640x360 
0x1382CA98, 37353949418042608, 89983000, 89983002, 2, 640x360 
0x1382CA98, 37353949418358608, 89983031, 89983034, 3, 640x360 
0x1382CA98, 37353949418693360, 89983065, 89983067, 2, 640x360 
0x1382CA98, 37353949419010896, 89983098, 89983099, 1, 640x360 
0x1382CA98, 37353949419333208, 89983134, 89983136, 2, 640x360 
0x1382CA98, 37353949419641792, 89983170, 89983173, 3, 640x360 
0x1382CA98, 37353949419968736, 89983205, 89983212, 7, 640x360 
0x1382CA98, 37353949420283848, 89983225, 89983236, 11, 640x360 
0x1382CA98, 37353949420616960, 89983264, 89983272, 8, 640x360 
0x1382CA98, 37353949421079480, 89983310, 89983313, 3, 640x360 
0x1382CA98, 37353949421426536, 89983344, 89983347, 3, 640x360 
0x1382CA98, 37353949421743232, 89983371, 89983382, 11, 640x360 
0x1382CA98, 37353949422038568, 89983404, 89983409, 5, 640x360 
0x1382CA98, 37353949422362904, 89983442, 89983444, 2, 640x360 
0x1382CA98, 37353949422680032, 89983465, 89983470, 5, 640x360 
0x1382CA98, 37353949422998552, 89983496, 89983504, 8, 640x360 
0x1382CA98, 37353949423318776, 89983529, 89983535, 6, 640x360 
0x1382CA98, 37353949423642504, 89983557, 89983560, 3, 640x360 
0x1382CA98, 37353949423958528, 89983584, 89983587, 3, 640x360 
0x1382CA98, 37353949424283120, 89983619, 89983622, 3, 640x360 
0x1382CA98, 37353949424605224, 89983659, 89983671, 12, 640x360 
0x1382CA98, 37353949425086304, 89983701, 89983703, 2, 640x360 
0x1382CA98, 37353949425422824, 89983742, 89983744, 2, 640x360 
0x1382CA98, 37353949425718128, 89983770, 89983773, 3, 640x360 
0x1382CA98, 37353949426042752, 89983803, 89983807, 4, 640x360 
0x1382CA98, 37353949426358448, 89983830, 89983832, 2, 640x360 
0x1382CA98, 37353949426683736, 89983861, 89983869, 8, 640x360 
0x1382CA98, 37353949427038840, 89983898, 89983901, 3, 640x360 
0x1382CA98, 37353949427364592, 89983933, 89983935, 2, 640x360 
0x1382CA98, 37353949427673664, 89983963, 89983966, 3, 640x360 
0x1382CA98, 37353949428004352, 89983997, 89983999, 2, 640x360 
0x1382CA98, 37353949428283896, 89984023, 89984027, 4, 640x360 
0x1382CA98, 37353949428608296, 89984054, 89984059, 5, 640x360 
0x1382CA98, 37353949429083664, 89984111, 89984114, 3, 640x360 
0x1382CA98, 37353949429410144, 89984143, 89984149, 6, 640x360 
0x1382CA98, 37353949429717960, 89984175, 89984183, 8, 640x360 
0x1382CA98, 37353949430042648, 89984203, 89984206, 3, 640x360 
0x1382CA98, 37353949430361688, 89984230, 89984233, 3, 640x360 
0x1382CA98, 37353949430685736, 89984264, 89984266, 2, 640x360 
0x1382CA98, 37353949431006328, 89984309, 89984314, 5, 640x360 
0x1382CA98, 37353949431321720, 89984329, 89984335, 6, 640x360 
0x1382CA98, 37353949431642168, 89984361, 89984363, 2, 640x360 
0x1382CA98, 37353949431959384, 89984387, 89984399, 12, 640x360 
0x1382CA98, 37353949432281344, 89984419, 89984424, 5, 640x360 
0x1382CA98, 37353949432609320, 89984452, 89984455, 3, 640x360 
0x1382CA98, 37353949432929288, 89984492, 89984495, 3, 640x360 
0x1382CA98, 37353949433398920, 89984536, 89984543, 7, 640x360 
0x1382CA98, 37353949433722160, 89984571, 89984575, 4, 640x360 
0x1382CA98, 37353949434038344, 89984595, 89984601, 6, 640x360 
0x1382CA98, 37353949434368336, 89984633, 89984637, 4, 640x360 
0x1382CA98, 37353949434679032, 89984664, 89984666, 2, 640x360 
0x1382CA98, 37353949435001256, 89984697, 89984699, 2, 640x360 
0x1382CA98, 37353949435322312, 89984733, 89984735, 2, 640x360 
0x1382CA98, 37353949435643760, 89984763, 89984766, 3, 640x360 
0x1382CA98, 37353949435967784, 89984790, 89984801, 11, 640x360 
0x1382CA98, 37353949436293240, 89984828, 89984836, 8, 640x360 
0x1382CA98, 37353949436608168, 89984861, 89984863, 2, 640x360 
0x1382CA98, 37353949436920280, 89984893, 89984895, 2, 640x360 
0x1382CA98, 37353949437397704, 89984937, 89984941, 4, 640x360 
0x1382CA98, 37353949437721392, 89984964, 89984967, 3, 640x360 
0x1382CA98, 37353949438039240, 89985008, 89985010, 2, 640x360 
0x1382CA98, 37353949438358088, 89985031, 89985034, 3, 640x360 
0x1382CA98, 37353949438688120, 89985062, 89985064, 2, 640x360 
0x1382CA98, 37353949439013240, 89985100, 89985105, 5, 640x360 
0x1382CA98, 37353949439322680, 89985129, 89985137, 8, 640x360 
0x1382CA98, 37353949439639192, 89985164, 89985166, 2, 640x360 
0x1382CA98, 37353949439964776, 89985191, 89985193, 2, 640x360 
0x1382CA98, 37353949440279264, 89985217, 89985220, 3, 640x360 
0x1382CA98, 37353949440607872, 89985251, 89985259, 8, 640x360 
0x1382CA98, 37353949440933160, 89985285, 89985289, 4, 640x360 
0x1382CA98, 37353949441399368, 89985336, 89985340, 4, 640x360 
0x1382CA98, 37353949441722936, 89985378, 89985381, 3, 640x360 
0x1382CA98, 37353949442042744, 89985400, 89985402, 2, 640x360 
0x1382CA98, 37353949442360600, 89985431, 89985440, 9, 640x360 
0x1382CA98, 37353949442682112, 89985463, 89985470, 7, 640x360 
0x1382CA98, 37353949443004072, 89985495, 89985498, 3, 640x360 
0x1382CA98, 37353949443325520, 89985534, 89985541, 7, 640x360 
0x1382CA98, 37353949443641344, 89985564, 89985566, 2, 640x360 
0x1382CA98, 37353949443963816, 89985591, 89985600, 9, 640x360 
0x1382CA98, 37353949444298112, 89985625, 89985628, 3, 640x360 
0x1382CA98, 37353949444626944, 89985659, 89985666, 7, 640x360 
0x1382CA98, 37353949444946192, 89985689, 89985702, 13, 640x360 
0x1382CA98, 37353949445401424, 89985736, 89985738, 2, 640x360 
0x1382CA98, 37353949445729928, 89985778, 89985780, 2, 640x360 
0x1382CA98, 37353949446038024, 89985808, 89985811, 3, 640x360 
0x1382CA98, 37353949446362160, 89985833, 89985835, 2, 640x360 
0x1382CA98, 37353949446678352, 89985870, 89985873, 3, 640x360 
0x1382CA98, 37353949446998320, 89985895, 89985898, 3, 640x360 
0x1382CA98, 37353949447319848, 89985930, 89985932, 2, 640x360 
0x1382CA98, 37353949447643280, 89985964, 89985967, 3, 640x360 
0x1382CA98, 37353949447972032, 89985989, 89986009, 20, 640x360 
0x1382CA98, 37353949448315152, 89986034, 89986037, 3, 640x360 
0x1382CA98, 37353949448625160, 89986058, 89986061, 3, 640x360 
0x1382CA98, 37353949448919344, 89986099, 89986101, 2, 640x360 
0x1382CA98, 37353949449397816, 89986142, 89986144, 2, 640x360 
0x1382CA98, 37353949449732008, 89986175, 89986178, 3, 640x360 
0x1382CA98, 37353949450041632, 89986207, 89986213, 6, 640x360 
0x1382CA98, 37353949450358448, 89986237, 89986242, 5, 640x360 
0x1382CA98, 37353949450678664, 89986269, 89986271, 2, 640x360 
0x1382CA98, 37353949451000360, 89986298, 89986300, 2, 640x360 
0x1382CA98, 37353949451317712, 89986326, 89986333, 7, 640x360 
0x1382CA98, 37353949451638512, 89986357, 89986366, 9, 640x360 
0x1382CA98, 37353949451958464, 89986390, 89986402, 12, 640x360 
0x1382CA98, 37353949452301016, 89986423, 89986432, 9, 640x360 
0x1382CA98, 37353949452606000, 89986454, 89986458, 4, 640x360 
0x1382CA98, 37353949452923360, 89986492, 89986501, 9, 640x360 
0x1382CA98, 37353949453397336, 89986535, 89986538, 3, 640x360 
0x1382CA98, 37353949453721280, 89986572, 89986577, 5, 640x360 
0x1382CA98, 37353949454040752, 89986599, 89986602, 3, 640x360 
0x1382CA98, 37353949454360912, 89986641, 89986644, 3, 640x360 
0x1382CA98, 37353949454677544, 89986668, 89986670, 2, 640x360 
0x1382CA98, 37353949455051112, 89986706, 89986717, 11, 640x360 
0x1382CA98, 37353949455321432, 89986732, 89986734, 2, 640x360 
0x1382CA98, 37353949455654864, 89986772, 89986777, 5, 640x360 
0x1382CA98, 37353949455958168, 89986791, 89986800, 9, 640x360 
0x1382CA98, 37353949456296536, 89986827, 89986834, 7, 640x360 
0x1382CA98, 37353949456605192, 89986860, 89986862, 2, 640x360 
0x1382CA98, 37353949456922296, 89986887, 89986890, 3, 640x360 
0x1382CA98, 37353949457397008, 89986942, 89986945, 3, 640x360 
0x1382CA98, 37353949457721976, 89986966, 89986969, 3, 640x360 
0x1382CA98, 37353949458037560, 89986998, 89987007, 9, 640x360 
0x1382CA98, 37353949458357904, 89987029, 89987037, 8, 640x360 
0x1382CA98, 37353949458679208, 89987065, 89987067, 2, 640x360 
0x1382CA98, 37353949459006672, 89987110, 89987117, 7, 640x360 
0x1382CA98, 37353949459325952, 89987139, 89987145, 6, 640x360 
0x1382CA98, 37353949459648280, 89987171, 89987174, 3, 640x360 
0x1382CA98, 37353949459962352, 89987206, 89987212, 6, 640x360 
0x1382CA98, 37353949460299592, 89987230, 89987236, 6, 640x360 
0x1382CA98, 37353949460605776, 89987259, 89987261, 2, 640x360 
0x1382CA98, 37353949460920072, 89987285, 89987287, 2, 640x360 
0x1382CA98, 37353949461238016, 89987326, 89987329, 3, 640x360 
0x1382CA98, 37353949461717272, 89987366, 89987369, 3, 640x360 
0x1382CA98, 37353949462037784, 89987409, 89987411, 2, 640x360 
0x1382CA98, 37353949462358112, 89987432, 89987435, 3, 640x360 
0x1382CA98, 37353949462678680, 89987463, 89987478, 15, 640x360 
0x1382CA98, 37353949463038992, 89987500, 89987503, 3, 640x360 
0x1382CA98, 37353949463329136, 89987535, 89987537, 2, 640x360 
0x1382CA98, 37353949463652504, 89987576, 89987580, 4, 640x360 
0x1382CA98, 37353949463960160, 89987599, 89987601, 2, 640x360 
0x1382CA98, 37353949464293560, 89987625, 89987637, 12, 640x360 
0x1382CA98, 37353949464604720, 89987659, 89987662, 3, 640x360 
0x1382CA98, 37353949464923584, 89987692, 89987695, 3, 640x360 
0x1382CA98, 37353949465237544, 89987726, 89987729, 3, 640x360 
0x1382CA98, 37353949465721136, 89987775, 89987778, 3, 640x360 
0x1382CA98, 37353949466041168, 89987797, 89987803, 6, 640x360 
0x1382CA98, 37353949466357776, 89987830, 89987836, 6, 640x360 
0x1382CA98, 37353949466677672, 89987861, 89987863, 2, 640x360 
0x1382CA98, 37353949467005248, 89987898, 89987900, 2, 640x360 
0x1382CA98, 37353949467323336, 89987925, 89987928, 3, 640x360 
0x1382CA98, 37353949467646920, 89987954, 89987957, 3, 640x360 
0x1382CA98, 37353949467958248, 89987985, 89987987, 2, 640x360 
0x1382CA98, 37353949468279472, 89988020, 89988023, 3, 640x360 
0x1382CA98, 37353949468607144, 89988052, 89988056, 4, 640x360 
0x1382CA98, 37353949468940408, 89988093, 89988100, 7, 640x360 
0x1382CA98, 37353949469294920, 89988125, 89988129, 4, 640x360 
0x1382CA98, 37353949469717104, 89988171, 89988175, 4, 640x360 
0x1382CA98, 37353949470053488, 89988221, 89988233, 12, 640x360 
0x1382CA98, 37353949470379928, 89988248, 89988251, 3, 640x360 
0x1382CA98, 37353949470684928, 89988268, 89988270, 2, 640x360 
0x1382CA98, 37353949470997056, 89988297, 89988299, 2, 640x360 
0x1382CA98, 37353949471317328, 89988327, 89988330, 3, 640x360 
0x1382CA98, 37353949471638088, 89988363, 89988365, 2, 640x360 
0x1382CA98, 37353949471961176, 89988389, 89988397, 8, 640x360 
0x1382CA98, 37353949472282376, 89988424, 89988427, 3, 640x360 
0x1382CA98, 37353949472605664, 89988453, 89988455, 2, 640x360 
0x1382CA98, 37353949472917952, 89988485, 89988487, 2, 640x360 
0x1382CA98, 37353949473242560, 89988525, 89988528, 3, 640x360 
0x1382CA98, 37353949473717096, 89988563, 89988565, 2, 640x360 
0x1382CA98, 37353949474037200, 89988600, 89988604, 4, 640x360 
0x1382CA98, 37353949474357896, 89988638, 89988643, 5, 640x360 
0x1382CA98, 37353949474688128, 89988664, 89988671, 7, 640x360 
0x1382CA98, 37353949474999536, 89988696, 89988702, 6, 640x360 
0x1382CA98, 37353949475318168, 89988726, 89988740, 14, 640x360 
0x1382CA98, 37353949475642808, 89988771, 89988773, 2, 640x360 
0x1382CA98, 37353949475957552, 89988790, 89988803, 13, 640x360 
0x1382CA98, 37353949476300496, 89988824, 89988831, 7, 640x360 
0x1382CA98, 37353949476621024, 89988856, 89988869, 13, 640x360 
0x1382CA98, 37353949476924296, 89988886, 89988889, 3, 640x360 
0x1382CA98, 37353949477241712, 89988921, 89988923, 2, 640x360 
0x1382CA98, 37353949477717040, 89988972, 89988976, 4, 640x360 
0x1382CA98, 37353949478039528, 89989009, 89989011, 2, 640x360 
0x1382CA98, 37353949478361536, 89989030, 89989036, 6, 640x360 
0x1382CA98, 37353949478676816, 89989062, 89989070, 8, 640x360 
0x1382CA98, 37353949478997432, 89989097, 89989099, 2, 640x360 
0x1382CA98, 37353949479322112, 89989131, 89989133, 2, 640x360 
0x1382CA98, 37353949479643872, 89989157, 89989163, 6, 640x360 
0x1382CA98, 37353949479961256, 89989189, 89989201, 12, 640x360 
0x1382CA98, 37353949480278856, 89989220, 89989223, 3, 640x360 
0x1382CA98, 37353949480605368, 89989258, 89989265, 7, 640x360 
0x1382CA98, 37353949480922312, 89989289, 89989295, 6, 640x360 
0x1382CA98, 37353949481237184, 89989321, 89989325, 4, 640x360 
0x1382CA98, 37353949481717328, 89989368, 89989371, 3, 640x360 
0x1382CA98, 37353949482050472, 89989410, 89989413, 3, 640x360 
0x1382CA98, 37353949482356984, 89989433, 89989435, 2, 640x360 
0x1382CA98, 37353949482676984, 89989463, 89989469, 6, 640x360 
0x1382CA98, 37353949483003840, 89989496, 89989498, 2, 640x360 
0x1382CA98, 37353949483317552, 89989532, 89989556, 24, 640x360 
0x1382CA98, 37353949483638248, 89989576, 89989579, 3, 640x360 
0x1382CA98, 37353949483961160, 89989595, 89989598, 3, 640x360 
0x1382CA98, 37353949484279464, 89989627, 89989630, 3, 640x360 
0x1382CA98, 37353949484606232, 89989657, 89989661, 4, 640x360 
0x1382CA98, 37353949484917440, 89989688, 89989695, 7, 640x360 
0x1382CA98, 37353949485244640, 89989720, 89989723, 3, 640x360 
0x1382CA98, 37353949485720664, 89989776, 89989778, 2, 640x360 
0x1382CA98, 37353949486037496, 89989801, 89989803, 2, 640x360 
0x1382CA98, 37353949486362792, 89989833, 89989839, 6, 640x360 
0x1382CA98, 37353949486680080, 89989864, 89989869, 5, 640x360 
0x1382CA98, 37353949486996936, 89989896, 89989898, 2, 640x360 
0x1382CA98, 37353949487320512, 89989933, 89989935, 2, 640x360 
0x1382CA98, 37353949487642336, 89989964, 89989971, 7, 640x360 
0x1382CA98, 37353949487957456, 89989995, 89989998, 3, 640x360 
0x1382CA98, 37353949488277800, 89990022, 89990026, 4, 640x360 
0x1382CA98, 37353949488602280, 89990054, 89990056, 2, 640x360 
0x1382CA98, 37353949488919744, 89990085, 89990088, 3, 640x360 
0x1382CA98, 37353949489249240, 89990116, 89990119, 3, 640x360 
0x1382CA98, 37353949489561368, 89990155, 89990161, 6, 640x360 
0x1382CA98, 37353949490046912, 89990209, 89990212, 3, 640x360 
0x1382CA98, 37353949490364456, 89990242, 89990248, 6, 640x360 
0x1382CA98, 37353949490739912, 89990279, 89990282, 3, 640x360 
0x1382CA98, 37353949490997616, 89990298, 89990309, 11, 640x360 
0x1382CA98, 37353949491324016, 89990338, 89990345, 7, 640x360 
0x1382CA98, 37353949491638656, 89990374, 89990384, 10, 640x360 
0x1382CA98, 37353949491967488, 89990404, 89990411, 7, 640x360 
0x1382CA98, 37353949492287896, 89990425, 89990433, 8, 640x360 
0x1382CA98, 37353949492604728, 89990454, 89990456, 2, 640x360 
0x1382CA98, 37353949492923552, 89990492, 89990500, 8, 640x360 
0x1382CA98, 37353949493237176, 89990527, 89990529, 2, 640x360 
0x1382CA98, 37353949493556856, 89990550, 89990558, 8, 640x360 
0x1382CA98, 37353949494036136, 89990604, 89990607, 3, 640x360 
0x1382CA98, 37353949494357608, 89990638, 89990642, 4, 640x360 
0x1382CA98, 37353949494676960, 89990663, 89990666, 3, 640x360 
0x1382CA98, 37353949495001024, 89990697, 89990699, 2, 640x360 
0x1382CA98, 37353949495321168, 89990726, 89990730, 4, 640x360 
0x1382CA98, 37353949495640864, 89990760, 89990767, 7, 640x360 
0x1382CA98, 37353949495957400, 89990790, 89990801, 11, 640x360 
0x1382CA98, 37353949496279704, 89990824, 89990832, 8, 640x360 
0x1382CA98, 37353949496604976, 89990854, 89990858, 4, 640x360 
0x1382CA98, 37353949496926128, 89990891, 89990895, 4, 640x360 
0x1382CA98, 37353949497242184, 89990919, 89990924, 5, 640x360 
0x1382CA98, 37353949497564264, 89990956, 89990961, 5, 640x360 
0x1382CA98, 37353949498036928, 89991001, 89991003, 2, 640x360 
0x1382CA98, 37353949498360584, 89991037, 89991043, 6, 640x360 
0x1382CA98, 37353949498676096, 89991071, 89991074, 3, 640x360 
0x1382CA98, 37353949498996096, 89991097, 89991099, 2, 640x360 
0x1382CA98, 37353949499320528, 89991135, 89991137, 2, 640x360 
0x1382CA98, 37353949499641848, 89991168, 89991182, 14, 640x360 
0x1382CA98, 37353949499962536, 89991206, 89991214, 8, 640x360 
0x1382CA98, 37353949500306216, 89991233, 89991235, 2, 640x360 
0x1382CA98, 37353949500602304, 89991260, 89991263, 3, 640x360 
0x1382CA98, 37353949500919856, 89991288, 89991290, 2, 640x360 
0x1382CA98, 37353949501236632, 89991318, 89991319, 1, 640x360 
0x1382CA98, 37353949501562120, 89991358, 89991361, 3, 640x360 
0x1382CA98, 37353949502036984, 89991395, 89991398, 3, 640x360 
0x1382CA98, 37353949502360600, 89991429, 89991432, 3, 640x360 
0x1382CA98, 37353949502680432, 89991460, 89991462, 2, 640x360 
0x1382CA98, 37353949502997032, 89991498, 89991501, 3, 640x360 
0x1382CA98, 37353949503317160, 89991529, 89991533, 4, 640x360 
0x1382CA98, 37353949503636888, 89991565, 89991568, 3, 640x360 
0x1382CA98, 37353949503972136, 89991602, 89991612, 10, 640x360 
0x1382CA98, 37353949504289512, 89991630, 89991636, 6, 640x360 
0x1382CA98, 37353949504619952, 89991663, 89991674, 11, 640x360 
0x1382CA98, 37353949504921016, 89991687, 89991693, 6, 640x360 
0x1382CA98, 37353949505240888, 89991722, 89991732, 10, 640x360 
0x1382CA98, 37353949505560504, 89991752, 89991755, 3, 640x360 
0x1382CA98, 37353949506035856, 89991804, 89991810, 6, 640x360 
0x1382CA98, 37353949506367160, 89991842, 89991851, 9, 640x360 
0x1382CA98, 37353949506690496, 89991876, 89991883, 7, 640x360 
0x1382CA98, 37353949506998736, 89991903, 89991905, 2, 640x360 
0x1382CA98, 37353949507316496, 89991931, 89991933, 2, 640x360 
0x1382CA98, 37353949507646136, 89991965, 89991972, 7, 640x360 
0x1382CA98, 37353949507957000, 89991998, 89992000, 2, 640x360 
0x1382CA98, 37353949508297832, 89992039, 89992050, 11, 640x360 
0x1382CA98, 37353949508606088, 89992062, 89992071, 9, 640x360 
0x1382CA98, 37353949508937248, 89992099, 89992101, 2, 640x360 
0x1382CA98, 37353949509248248, 89992128, 89992131, 3, 640x360 
0x1382CA98, 37353949509560096, 89992151, 89992154, 3, 640x360 
0x1382CA98, 37353949510035632, 89992197, 89992199, 2, 640x360 
0x1382CA98, 37353949510360000, 89992234, 89992238, 4, 640x360 
0x1382CA98, 37353949510687800, 89992272, 89992287, 15, 640x360 
0x1382CA98, 37353949511016984, 89992302, 89992306, 4, 640x360 
0x1382CA98, 37353949511355640, 89992333, 89992348, 15, 640x360 
0x1382CA98, 37353949511672432, 89992371, 89992381, 10, 640x360 
0x1382CA98, 37353949511973888, 89992403, 89992408, 5, 640x360 
0x1382CA98, 37353949512286944, 89992430, 89992432, 2, 640x360 
0x1382CA98, 37353949512600072, 89992454, 89992456, 2, 640x360 
0x1382CA98, 37353949512928136, 89992491, 89992502, 11, 640x360 
0x1382CA98, 37353949513244560, 89992523, 89992526, 3, 640x360 
0x1382CA98, 37353949513556104, 89992551, 89992553, 2, 640x360 
0x1382CA98, 37353949513876136, 89992580, 89992582, 2, 640x360 
0x1382CA98, 37353949514359800, 89992633, 89992636, 3, 640x360 
0x1382CA98, 37353949514679152, 89992674, 89992677, 3, 640x360 
0x1382CA98, 37353949515001808, 89992697, 89992699, 2, 640x360 
0x1382CA98, 37353949515319408, 89992730, 89992732, 2, 640x360 
0x1382CA98, 37353949515636696, 89992761, 89992763, 2, 640x360 
0x1382CA98, 37353949515956632, 89992792, 89992796, 4, 640x360 
0x1382CA98, 37353949516276200, 89992824, 89992828, 4, 640x360 
0x1382CA98, 37353949516610320, 89992855, 89992868, 13, 640x360 
0x1382CA98, 37353949516937760, 89992911, 89992922, 11, 640x360 
0x1382CA98, 37353949517237208, 89992931, 89992946, 15, 640x360 
0x1382CA98, 37353949517601280, 89992965, 89992975, 10, 640x360 
0x1382CA98, 37353949517898584, 89992983, 89992986, 3, 640x360 
0x1382CA98, 37353949518357064, 89993042, 89993051, 9, 640x360 
0x1382CA98, 37353949518678304, 89993081, 89993093, 12, 640x360 
0x1382CA98, 37353949519005120, 89993114, 89993120, 6, 640x360 
0x1382CA98, 37353949519325416, 89993141, 89993152, 11, 640x360 
0x1382CA98, 37353949519644824, 89993179, 89993188, 9, 640x360 
0x1382CA98, 37353949519974984, 89993215, 89993218, 3, 640x360 
0x1382CA98, 37353949520292360, 89993235, 89993239, 4, 640x360 
0x1382CA98, 37353949520616760, 89993267, 89993274, 7, 640x360 
0x1382CA98, 37353949520936080, 89993317, 89993326, 9, 640x360 
0x1382CA98, 37353949521239000, 89993327, 89993331, 4, 640x360 
0x1382CA98, 37353949521559760, 89993362, 89993364, 2, 640x360 
0x1382CA98, 37353949521879472, 89993398, 89993404, 6, 640x360 
0x1382CA98, 37353949522355864, 89993439, 89993450, 11, 640x360 
0x1382CA98, 37353949522679888, 89993475, 89993483, 8, 640x360 
0x1382CA98, 37353949522997936, 89993496, 89993505, 9, 640x360 
0x1382CA98, 37353949523315704, 89993532, 89993534, 2, 640x360 
0x1382CA98, 37353949523636480, 89993561, 89993564, 3, 640x360 
0x1382CA98, 37353949523960840, 89993591, 89993601, 10, 640x360 
0x1382CA98, 37353949524292624, 89993624, 89993632, 8, 640x360 
0x1382CA98, 37353949524602456, 89993660, 89993667, 7, 640x360 
0x1382CA98, 37353949524919016, 89993691, 89993694, 3, 640x360 
0x1382CA98, 37353949525243184, 89993721, 89993723, 2, 640x360 
0x1382CA98, 37353949525555832, 89993759, 89993768, 9, 640x360 
0x1382CA98, 37353949525876152, 89993784, 89993787, 3, 640x360 
0x1382CA98, 37353949526355776, 89993842, 89993852, 10, 640x360 
0x1382CA98, 37353949526680392, 89993880, 89993891, 11, 640x360 
0x1382CA98, 37353949527017128, 89993900, 89993902, 2, 640x360 
0x1382CA98, 37353949527362192, 89993931, 89993933, 2, 640x360 
0x1382CA98, 37353949527646328, 89993974, 89993978, 4, 640x360 
0x1382CA98, 37353949527959272, 89993998, 89994004, 6, 640x360 
0x1382CA98, 37353949528295968, 89994037, 89994043, 6, 640x360 
0x1382CA98, 37353949528617168, 89994074, 89994078, 4, 640x360 
0x1382CA98, 37353949528918264, 89994096, 89994098, 2, 640x360 
0x1382CA98, 37353949529241952, 89994120, 89994124, 4, 640x360 
0x1382CA98, 37353949529560096, 89994159, 89994167, 8, 640x360 
0x1382CA98, 37353949529877312, 89994188, 89994191, 3, 640x360 
0x1382CA98, 37353949530363168, 89994228, 89994238, 10, 640x360 
0x1382CA98, 37353949530678544, 89994265, 89994267, 2, 640x360 
0x1382CA98, 37353949530995840, 89994302, 89994305, 3, 640x360 
0x1382CA98, 37353949531326848, 89994339, 89994342, 3, 640x360 
0x1382CA98, 37353949531638080, 89994363, 89994366, 3, 640x360 
0x1382CA98, 37353949531956184, 89994402, 89994404, 2, 640x360 
0x1382CA98, 37353949532283416, 89994426, 89994430, 4, 640x360 
0x1382CA98, 37353949532596520, 89994453, 89994455, 2, 640x360 
0x1382CA98, 37353949532924208, 89994487, 89994501, 14, 640x360 
0x1382CA98, 37353949533239344, 89994520, 89994530, 10, 640x360 
0x1382CA98, 37353949533555816, 89994553, 89994556, 3, 640x360 
0x1382CA98, 37353949533875672, 89994582, 89994584, 2, 640x360 
0x1382CA98, 37353949534355848, 89994636, 89994638, 2, 640x360 
0x1382CA98, 37353949534676024, 89994663, 89994669, 6, 640x360 
0x1382CA98, 37353949535007864, 89994703, 89994705, 2, 640x360 
0x1382CA98, 37353949535330936, 89994732, 89994734, 2, 640x360 
0x1382CA98, 37353949535646584, 89994765, 89994767, 2, 640x360 
0x1382CA98, 37353949535974840, 89994801, 89994803, 2, 640x360 
0x1382CA98, 37353949536311000, 89994834, 89994836, 2, 640x360 
0x1382CA98, 37353949536625448, 89994864, 89994867, 3, 640x360 
0x1382CA98, 37353949536920632, 89994901, 89994903, 2, 640x360 
0x1382CA98, 37353949537235544, 89994933, 89994936, 3, 640x360 
0x1382CA98, 37353949537556392, 89994977, 89994985, 8, 640x360 
0x1382CA98, 37353949537882560, 89995015, 89995024, 9, 640x360 
0x1382CA98, 37353949538366752, 89995046, 89995048, 2, 640x360 
0x1382CA98, 37353949538675080, 89995070, 89995072, 2, 640x360 
0x1382CA98, 37353949538999432, 89995109, 89995120, 11, 640x360 
0x1382CA98, 37353949539336264, 89995136, 89995139, 3, 640x360 
0x1382CA98, 37353949539639152, 89995158, 89995169, 11, 640x360 
0x1382CA98, 37353949539959248, 89995196, 89995199, 3, 640x360 
0x1382CA98, 37353949540275864, 89995219, 89995222, 3, 640x360 
0x1382CA98, 37353949540615440, 89995258, 89995265, 7, 640x360 
0x1382CA98, 37353949540916176, 89995298, 89995305, 7, 640x360 
0x1382CA98, 37353949541238976, 89995320, 89995324, 4, 640x360 
0x1382CA98, 37353949541555448, 89995349, 89995352, 3, 640x360 
0x1382CA98, 37353949541875544, 89995382, 89995384, 2, 640x360 
0x1382CA98, 37353949542196088, 89995430, 89995437, 7, 640x360 
0x1382CA98, 37353949542677808, 89995466, 89995473, 7, 640x360 
0x1382CA98, 37353949542996152, 89995497, 89995499, 2, 640x360 
0x1382CA98, 37353949543316104, 89995537, 89995540, 3, 640x360 
0x1382CA98, 37353949543639216, 89995562, 89995570, 8, 640x360 
0x1382CA98, 37353949543959760, 89995588, 89995601, 13, 640x360 
0x1382CA98, 37353949544292320, 89995635, 89995637, 2, 640x360 
0x1382CA98, 37353949544604552, 89995654, 89995659, 5, 640x360 
0x1382CA98, 37353949544919320, 89995691, 89995703, 12, 640x360 
0x1382CA98, 37353949545240328, 89995720, 89995724, 4, 640x360 
0x1382CA98, 37353949545556328, 89995753, 89995755, 2, 640x360 
0x1382CA98, 37353949545875984, 89995780, 89995787, 7, 640x360 
0x1382CA98, 37353949546200928, 89995813, 89995821, 8, 640x360 
0x1382CA98, 37353949546688688, 89995866, 89995868, 2, 640x360 
0x1382CA98, 37353949546998264, 89995898, 89995901, 3, 640x360 
0x1382CA98, 37353949547317224, 89995943, 89995957, 14, 640x360 
0x1382CA98, 37353949547639648, 89995975, 89995978, 3, 640x360 
0x1382CA98, 37353949547955792, 89995991, 89995996, 5, 640x360 
0x1382CA98, 37353949548275488, 89996017, 89996019, 2, 640x360 
0x1382CA98, 37353949548601272, 89996057, 89996062, 5, 640x360 
0x1382CA98, 37353949548915880, 89996094, 89996097, 3, 640x360 
0x1382CA98, 37353949549236128, 89996130, 89996133, 3, 640x360 
0x1382CA98, 37353949549555568, 89996158, 89996161, 3, 640x360 
0x1382CA98, 37353949549875496, 89996188, 89996193, 5, 640x360 
0x1382CA98, 37353949550198504, 89996213, 89996219, 6, 640x360 
0x1382CA98, 37353949550679416, 89996260, 89996262, 2, 640x360 
0x1382CA98, 37353949550995512, 89996300, 89996308, 8, 640x360 
0x1382CA98, 37353949551315128, 89996330, 89996332, 2, 640x360 
0x1382CA98, 37353949551640520, 89996357, 89996368, 11, 640x360 
0x1382CA98, 37353949551955624, 89996395, 89996398, 3, 640x360 
0x1382CA98, 37353949552275544, 89996427, 89996429, 2, 640x360 
0x1382CA98, 37353949552601392, 89996452, 89996455, 3, 640x360 
0x1382CA98, 37353949552919056, 89996483, 89996486, 3, 640x360 
0x1382CA98, 37353949553235976, 89996519, 89996521, 2, 640x360 
0x1382CA98, 37353949553562208, 89996552, 89996558, 6, 640x360 
0x1382CA98, 37353949553875936, 89996595, 89996599, 4, 640x360 
0x1382CA98, 37353949554199112, 89996621, 89996628, 7, 640x360 
0x1382CA98, 37353949554690032, 89996669, 89996671, 2, 640x360 
0x1382CA98, 37353949554994928, 89996699, 89996701, 2, 640x360 
0x1382CA98, 37353949555318880, 89996730, 89996733, 3, 640x360 
0x1382CA98, 37353949555635064, 89996759, 89996767, 8, 640x360 
0x1382CA98, 37353949555955040, 89996790, 89996800, 10, 640x360 
0x1382CA98, 37353949556293864, 89996825, 89996833, 8, 640x360 
0x1382CA98, 37353949556605128, 89996859, 89996869, 10, 640x360 
0x1382CA98, 37353949556952240, 89996886, 89996888, 2, 640x360 
0x1382CA98, 37353949557235064, 89996927, 89996930, 3, 640x360 
0x1382CA98, 37353949557559208, 89996961, 89996963, 2, 640x360 
0x1382CA98, 37353949557878936, 89996981, 89996984, 3, 640x360 
0x1382CA98, 37353949558199552, 89997012, 89997020, 8, 640x360 
0x1382CA98, 37353949558684696, 89997064, 89997066, 2, 640x360 
0x1382CA98, 37353949558998656, 89997098, 89997107, 9, 640x360 
0x1382CA98, 37353949559324224, 89997133, 89997146, 13, 640x360 
0x1382CA98, 37353949559653184, 89997186, 89997195, 9, 640x360 
0x1382CA98, 37353949560185608, 89997233, 89997250, 17, 640x360 
0x1382CA98, 37353949560364704, 89997257, 89997264, 7, 640x360 
0x1382CA98, 37353949560637624, 89997268, 89997271, 3, 640x360 
0x1382CA98, 37353949560935040, 89997299, 89997301, 2, 640x360 
0x1382CA98, 37353949561235912, 89997341, 89997344, 3, 640x360 
0x1382CA98, 37353949561561584, 89997360, 89997363, 3, 640x360 
0x1382CA98, 37353949561887288, 89997383, 89997386, 3, 640x360 
0x1382CA98, 37353949562199392, 89997417, 89997418, 1, 640x360 
0x1382CA98, 37353949562680192, 89997471, 89997475, 4, 640x360 
0x1382CA98, 37353949563045000, 89997498, 89997500, 2, 640x360 
0x1382CA98, 37353949563353728, 89997531, 89997534, 3, 640x360 
0x1382CA98, 37353949563638888, 89997558, 89997562, 4, 640x360 
0x1382CA98, 37353949563961760, 89997593, 89997602, 9, 640x360 
0x1382CA98, 37353949564279424, 89997629, 89997636, 7, 640x360 
0x1382CA98, 37353949564606048, 89997652, 89997657, 5, 640x360 
0x1382CA98, 37353949564920288, 89997686, 89997689, 3, 640x360 
0x1382CA98, 37353949565234912, 89997727, 89997736, 9, 640x360 
0x1382CA98, 37353949565555656, 89997760, 89997763, 3, 640x360 
0x1382CA98, 37353949565874664, 89997789, 89997800, 11, 640x360 
0x1382CA98, 37353949566199160, 89997814, 89997816, 2, 640x360 
0x1382CA98, 37353949566680392, 89997869, 89997871, 2, 640x360 
0x1382CA98, 37353949567000456, 89997903, 89997905, 2, 640x360 
0x1382CA98, 37353949567317144, 89997936, 89997937, 1, 640x360 
0x1382CA98, 37353949567635216, 89997965, 89997974, 9, 640x360 
0x1382CA98, 37353949567954792, 89997989, 89998002, 13, 640x360 
0x1382CA98, 37353949568278216, 89998020, 89998023, 3, 640x360 
0x1382CA98, 37353949568601568, 89998052, 89998058, 6, 640x360 
0x1382CA98, 37353949568915376, 89998085, 89998088, 3, 640x360 
0x1382CA98, 37353949569234680, 89998126, 89998130, 4, 640x360 
0x1382CA98, 37353949569566192, 89998152, 89998158, 6, 640x360 
0x1382CA98, 37353949569874760, 89998183, 89998185, 2, 640x360 
0x1382CA98, 37353949570195816, 89998220, 89998224, 4, 640x360 
0x1382CA98, 37353949571000768, 89998297, 89998307, 10, 640x360 
0x1382CA98, 37353949571319080, 89998331, 89998335, 4, 640x360 
0x1382CA98, 37353949571650792, 89998356, 89998370, 14, 640x360 
0x1382CA98, 37353949571955528, 89998392, 89998400, 8, 640x360 
0x1382CA98, 37353949572277184, 89998425, 89998434, 9, 640x360 
0x1382CA98, 37353949572601496, 89998457, 89998465, 8, 640x360 
0x1382CA98, 37353949572918200, 89998487, 89998490, 3, 640x360 
0x1382CA98, 37353949573234504, 89998514, 89998516, 2, 640x360 
0x1382CA98, 37353949573554696, 89998553, 89998555, 2, 640x360 
0x1382CA98, 37353949573874776, 89998588, 89998593, 5, 640x360 
0x1382CA98, 37353949574195064, 89998621, 89998624, 3, 640x360 
0x1382CA98, 37353949574515848, 89998645, 89998651, 6, 640x360 
0x1382CA98, 37353949575004136, 89998696, 89998703, 7, 640x360 
0x1382CA98, 37353949575314776, 89998733, 89998743, 10, 640x360 
0x1382CA98, 37353949575634944, 89998756, 89998767, 11, 640x360 
0x1382CA98, 37353949575964664, 89998798, 89998801, 3, 640x360 
0x1382CA98, 37353949576294728, 89998831, 89998834, 3, 640x360 
0x1382CA98, 37353949576614632, 89998862, 89998876, 14, 640x360 
0x1382CA98, 37353949576940120, 89998910, 89998913, 3, 640x360 
0x1382CA98, 37353949577238280, 89998936, 89998940, 4, 640x360 
0x1382CA98, 37353949577564048, 89998962, 89998970, 8, 640x360 
0x1382CA98, 37353949577878880, 89998989, 89998996, 7, 640x360 
0x1382CA98, 37353949578194680, 89999014, 89999016, 2, 640x360 
0x1382CA98, 37353949578514944, 89999046, 89999049, 3, 640x360 
0x1382CA98, 37353949578999016, 89999100, 89999106, 6, 640x360 
0x1382CA98, 37353949579315384, 89999131, 89999133, 2, 640x360 
0x1382CA98, 37353949579636024, 89999157, 89999168, 11, 640x360 
0x1382CA98, 37353949579959264, 89999196, 89999203, 7, 640x360 
0x1382CA98, 37353949580281696, 89999226, 89999232, 6, 640x360 
0x1382CA98, 37353949580600640, 89999259, 89999267, 8, 640x360 
0x1382CA98, 37353949580919112, 89999291, 89999298, 7, 640x360 
0x1382CA98, 37353949581234848, 89999315, 89999317, 2, 640x360 
0x1382CA98, 37353949581554960, 89999351, 89999354, 3, 640x360 
0x1382CA98, 37353949581878768, 89999388, 89999393, 5, 640x360 
0x1382CA98, 37353949582200200, 89999415, 89999419, 4, 640x360 
0x1382CA98, 37353949582519200, 89999448, 89999450, 2, 640x360 
0x1382CA98, 37353949582994704, 89999498, 89999501, 3, 640x360 
0x1382CA98, 37353949583318480, 89999525, 89999532, 7, 640x360 
0x1382CA98, 37353949583634912, 89999561, 89999564, 3, 640x360 
0x1382CA98, 37353949583954392, 89999598, 89999606, 8, 640x360 
0x1382CA98, 37353949584292856, 89999625, 89999633, 8, 640x360 
0x1382CA98, 37353949584601608, 89999652, 89999656, 4, 640x360 
0x1382CA98, 37353949584916040, 89999693, 89999708, 15, 640x360 
0x1382CA98, 37353949585237696, 89999727, 89999733, 6, 640x360 
0x1382CA98, 37353949585555064, 89999754, 89999758, 4, 640x360 
0x1382CA98, 37353949585874464, 89999785, 89999786, 1, 640x360 
0x1382CA98, 37353949586194776, 89999813, 89999816, 3, 640x360 
0x1382CA98, 37353949586519032, 89999845, 89999847, 2, 640x360 
0x1382CA98, 37353949586997960, 89999896, 89999909, 13, 640x360 
0x1382CA98, 37353949587314672, 89999926, 89999929, 3, 640x360 
0x1382CA98, 37353949587638752, 89999956, 89999967, 11, 640x360 
0x1382CA98, 37353949587954440, 89999989, 89999998, 9, 640x360 
0x1382CA98, 37353949588288808, 90000019, 90000022, 3, 640x360 
0x1382CA98, 37353949588595720, 90000051, 90000054, 3, 640x360 
0x1382CA98, 37353949588939296, 90000086, 90000089, 3, 640x360 
0x1382CA98, 37353949589254368, 90000127, 90000134, 7, 640x360 
0x1382CA98, 37353949589554952, 90000158, 90000161, 3, 640x360 
0x1382CA98, 37353949589874680, 90000181, 90000184, 3, 640x360 
0x1382CA98, 37353949590199176, 90000212, 90000218, 6, 640x360 
0x1382CA98, 37353949590515208, 90000245, 90000251, 6, 640x360 
0x1382CA98, 37353949591005376, 90000292, 90000294, 2, 640x360 
0x1382CA98, 37353949591313888, 90000329, 90000331, 2, 640x360 
0x1382CA98, 37353949591634384, 90000363, 90000365, 2, 640x360 
0x1382CA98, 37353949591958288, 90000393, 90000395, 2, 640x360 
0x1382CA98, 37353949592276024, 90000418, 90000420, 2, 640x360 
0x1382CA98, 37353949592595024, 90000449, 90000452, 3, 640x360 
0x1382CA98, 37353949592925864, 90000482, 90000485, 3, 640x360 
0x1382CA98, 37353949593235064, 90000519, 90000521, 2, 640x360 
0x1382CA98, 37353949593555256, 90000551, 90000553, 2, 640x360 
0x1382CA98, 37353949593875056, 90000582, 90000585, 3, 640x360 
0x1382CA98, 37353949594199632, 90000613, 90000615, 2, 640x360 
0x1382CA98, 37353949594519208, 90000650, 90000652, 2, 640x360 
0x1382CA98, 37353949594835000, 90000676, 90000678, 2, 640x360 
0x1382CA98, 37353949595316568, 90000722, 90000731, 9, 640x360 
0x1382CA98, 37353949595634400, 90000755, 90000761, 6, 640x360 
0x1382CA98, 37353949595958608, 90000795, 90000797, 2, 640x360 
0x1382CA98, 37353949596275968, 90000829, 90000832, 3, 640x360 
0x1382CA98, 37353949596611104, 90000852, 90000856, 4, 640x360 
0x1382CA98, 37353949596914672, 90000885, 90000887, 2, 640x360 
0x1382CA98, 37353949597237848, 90000918, 90000921, 3, 640x360 
0x1382CA98, 37353949597557984, 90000948, 90000951, 3, 640x360 
0x1382CA98, 37353949597893648, 90000985, 90000999, 14, 640x360 
0x1382CA98, 37353949598194896, 90001028, 90001035, 7, 640x360 
0x1382CA98, 37353949598523088, 90001045, 90001052, 7, 640x360 
0x1382CA98, 37353949598843744, 90001096, 90001102, 6, 640x360 
0x1382CA98, 37353949599313600, 90001127, 90001134, 7, 640x360 
0x1382CA98, 37353949599639776, 90001161, 90001167, 6, 640x360 
0x1382CA98, 37353949599960088, 90001190, 90001203, 13, 640x360 
0x1382CA98, 37353949600297912, 90001221, 90001227, 6, 640x360 
0x1382CA98, 37353949600608480, 90001255, 90001266, 11, 640x360 
0x1382CA98, 37353949600918616, 90001289, 90001299, 10, 640x360 
0x1382CA98, 37353949601233600, 90001325, 90001328, 3, 640x360 
0x1382CA98, 37353949601557744, 90001350, 90001353, 3, 640x360 
0x1382CA98, 37353949601873728, 90001384, 90001386, 2, 640x360 
0x1382CA98, 37353949602194320, 90001420, 90001422, 2, 640x360 
0x1382CA98, 37353949602514040, 90001454, 90001457, 3, 640x360 
0x1382CA98, 37353949602837728, 90001480, 90001482, 2, 640x360 
0x1382CA98, 37353949603323720, 90001526, 90001528, 2, 640x360 
0x1382CA98, 37353949603638680, 90001557, 90001562, 5, 640x360 
0x1382CA98, 37353949603955624, 90001589, 90001595, 6, 640x360 
0x1382CA98, 37353949604274376, 90001621, 90001623, 2, 640x360 
0x1382CA98, 37353949604599872, 90001653, 90001659, 6, 640x360 
0x1382CA98, 37353949604920272, 90001683, 90001686, 3, 640x360 
0x1382CA98, 37353949605239568, 90001728, 90001732, 4, 640x360 
0x1382CA98, 37353949605554976, 90001755, 90001767, 12, 640x360 
0x1382CA98, 37353949605878368, 90001786, 90001795, 9, 640x360 
0x1382CA98, 37353949606193704, 90001826, 90001830, 4, 640x360 
0x1382CA98, 37353949606521504, 90001852, 90001859, 7, 640x360 
0x1382CA98, 37353949606833928, 90001895, 90001902, 7, 640x360 
0x1382CA98, 37353949607322648, 90001938, 90001945, 7, 640x360 
0x1382CA98, 37353949607634520, 90001968, 90001970, 2, 640x360 
0x1382CA98, 37353949607964576, 90002003, 90002010, 7, 640x360 
0x1382CA98, 37353949608280424, 90002022, 90002028, 6, 640x360 
0x1382CA98, 37353949608599344, 90002054, 90002061, 7, 640x360 
0x1382CA98, 37353949608914552, 90002094, 90002102, 8, 640x360 
0x1382CA98, 37353949609261032, 90002132, 90002150, 18, 640x360 
0x1382CA98, 37353949609560544, 90002154, 90002161, 7, 640x360 
0x1382CA98, 37353949609925152, 90002199, 90002202, 3, 640x360 
0x1382CA98, 37353949610205400, 90002229, 90002232, 3, 640x360 
0x1382CA98, 37353949610524496, 90002259, 90002269, 10, 640x360 
0x1382CA98, 37353949610847528, 90002293, 90002295, 2, 640x360 
0x1382CA98, 37353949611313528, 90002353, 90002358, 5, 640x360 
0x1382CA98, 37353949611645096, 90002380, 90002393, 13, 640x360 
0x1382CA98, 37353949611986776, 90002413, 90002434, 21, 640x360 
0x1382CA98, 37353949612293816, 90002462, 90002469, 7, 640x360 
0x1382CA98, 37353949612631016, 90002485, 90002517, 32, 640x360 
0x1382CA98, 37353949612970536, 90002527, 90002537, 10, 640x360 
0x1382CA98, 37353949613325720, 90002549, 90002556, 7, 640x360 
0x1382CA98, 37353949613570248, 90002561, 90002569, 8, 640x360 
0x1382CA98, 37353949613894808, 90002613, 90002644, 31, 640x360 
0x1382CA98, 37353949614233656, 90002645, 90002676, 31, 640x360 
0x1382CA98, 37353949614641736, 90002717, 90002726, 9, 640x360 
0x1382CA98, 37353949615320328, 90002752, 90002768, 16, 640x360 
0x1382CA98, 37353949615638504, 90002789, 90002795, 6, 640x360 
0x1382CA98, 37353949615959616, 90002826, 90002834, 8, 640x360 
0x1382CA98, 37353949616292768, 90002841, 90002859, 18, 640x360 
0x1382CA98, 37353949616599128, 90002884, 90002893, 9, 640x360 
0x1382CA98, 37353949616967048, 90002914, 90002932, 18, 640x360 
0x1382CA98, 37353949617312736, 90002937, 90002953, 16, 640x360 
0x1382CA98, 37353949617553264, 90002966, 90002978, 12, 640x360 
0x1382CA98, 37353949617885040, 90002987, 90002998, 11, 640x360 
0x1382CA98, 37353949618197880, 90003029, 90003033, 4, 640x360 
0x1382CA98, 37353949618518752, 90003049, 90003063, 14, 640x360 
0x1382CA98, 37353949618833936, 90003080, 90003084, 4, 640x360 
0x1382CA98, 37353949619314544, 90003124, 90003136, 12, 640x360 
0x1382CA98, 37353949619632792, 90003158, 90003168, 10, 640x360 
0x1382CA98, 37353949619955152, 90003204, 90003207, 3, 640x360 
0x1382CA98, 37353949620285304, 90003238, 90003243, 5, 640x360 
0x1382CA98, 37353949620598040, 90003264, 90003270, 6, 640x360 
0x1382CA98, 37353949620928088, 90003297, 90003300, 3, 640x360 
0x1382CA98, 37353949621241664, 90003317, 90003319, 2, 640x360 
0x1382CA98, 37353949621553272, 90003348, 90003353, 5, 640x360 
0x1382CA98, 37353949621873512, 90003381, 90003383, 2, 640x360 
0x1382CA98, 37353949622193824, 90003412, 90003419, 7, 640x360 
0x1382CA98, 37353949622513976, 90003445, 90003452, 7, 640x360 
0x1382CA98, 37353949622841216, 90003480, 90003487, 7, 640x360 
0x1382CA98, 37353949623632728, 90003567, 90003570, 3, 640x360 
0x1382CA98, 37353949623965752, 90003595, 90003602, 7, 640x360 
0x1382CA98, 37353949624279448, 90003627, 90003636, 9, 640x360 
0x1382CA98, 37353949624597976, 90003653, 90003656, 3, 640x360 
0x1382CA98, 37353949624919408, 90003686, 90003690, 4, 640x360 
0x1382CA98, 37353949625232832, 90003730, 90003739, 9, 640x360 
0x1382CA98, 37353949625561504, 90003753, 90003762, 9, 640x360 
0x1382CA98, 37353949625873040, 90003785, 90003788, 3, 640x360 
0x1382CA98, 37353949626193256, 90003819, 90003821, 2, 640x360 
0x1382CA98, 37353949626518648, 90003854, 90003861, 7, 640x360 
0x1382CA98, 37353949626837160, 90003892, 90003895, 3, 640x360 
0x1382CA98, 37353949627158200, 90003921, 90003923, 2, 640x360 
0x1382CA98, 37353949627632664, 90003963, 90003971, 8, 640x360 
0x1382CA98, 37353949627953464, 90003999, 90004005, 6, 640x360 
0x1382CA98, 37353949628276320, 90004026, 90004028, 2, 640x360 
0x1382CA98, 37353949628600336, 90004064, 90004070, 6, 640x360 
0x1382CA98, 37353949628919984, 90004092, 90004102, 10, 640x360 
0x1382CA98, 37353949629272256, 90004148, 90004163, 15, 640x360 
0x1382CA98, 37353949629558368, 90004172, 90004177, 5, 640x360 
0x1382CA98, 37353949629874656, 90004192, 90004204, 12, 640x360 
0x1382CA98, 37353949630233472, 90004236, 90004238, 2, 640x360 
0x1382CA98, 37353949630522560, 90004260, 90004264, 4, 640x360 
0x1382CA98, 37353949630838192, 90004292, 90004296, 4, 640x360 
0x1382CA98, 37353949631153824, 90004322, 90004330, 8, 640x360 
0x1382CA98, 37353949631633080, 90004372, 90004376, 4, 640x360 
0x1382CA98, 37353949631961320, 90004399, 90004402, 3, 640x360 
0x1382CA98, 37353949632272544, 90004431, 90004433, 2, 640x360 
0x1382CA98, 37353949632599792, 90004468, 90004475, 7, 640x360 
0x1382CA98, 37353949632930592, 90004490, 90004498, 8, 640x360 
0x1382CA98, 37353949633232752, 90004523, 90004534, 11, 640x360 
0x1382CA98, 37353949633552888, 90004553, 90004557, 4, 640x360 
0x1382CA98, 37353949633876912, 90004585, 90004587, 2, 640x360 
0x1382CA98, 37353949634196896, 90004623, 90004627, 4, 640x360 
0x1382CA98, 37353949634513960, 90004654, 90004658, 4, 640x360 
0x1382CA98, 37353949634835408, 90004681, 90004687, 6, 640x360 
0x1382CA98, 37353949635153752, 90004721, 90004723, 2, 640x360 
0x1382CA98, 37353949635632352, 90004765, 90004771, 6, 640x360 
0x1382CA98, 37353949635952888, 90004792, 90004794, 2, 640x360 
0x1382CA98, 37353949636278880, 90004822, 90004826, 4, 640x360 
0x1382CA98, 37353949636594408, 90004854, 90004858, 4, 640x360 
0x1382CA98, 37353949636913288, 90004893, 90004896, 3, 640x360 
0x1382CA98, 37353949637232568, 90004922, 90004925, 3, 640x360 
0x1382CA98, 37353949637556392, 90004954, 90004960, 6, 640x360 
0x1382CA98, 37353949637876560, 90004992, 90004995, 3, 640x360 
0x1382CA98, 37353949638196944, 90005016, 90005018, 2, 640x360 
0x1382CA98, 37353949638517872, 90005052, 90005054, 2, 640x360 
0x1382CA98, 37353949638833064, 90005078, 90005081, 3, 640x360 
0x1382CA98, 37353949639153232, 90005115, 90005118, 3, 640x360 
0x1382CA98, 37353949639633960, 90005165, 90005167, 2, 640x360 
0x1382CA98, 37353949639961544, 90005198, 90005200, 2, 640x360 
0x1382CA98, 37353949640278136, 90005237, 90005239, 2, 640x360 
0x1382CA98, 37353949640598576, 90005260, 90005266, 6, 640x360 
0x1382CA98, 37353949640913024, 90005293, 90005299, 6, 640x360 
0x1382CA98, 37353949641233888, 90005334, 90005336, 2, 640x360 
0x1382CA98, 37353949641554016, 90005360, 90005366, 6, 640x360 
0x1382CA98, 37353949641878928, 90005386, 90005390, 4, 640x360 
0x1382CA98, 37353949642198240, 90005422, 90005431, 9, 640x360 
0x1382CA98, 37353949642516192, 90005454, 90005458, 4, 640x360 
0x1382CA98, 37353949642850040, 90005495, 90005501, 6, 640x360 
0x1382CA98, 37353949643158232, 90005527, 90005538, 11, 640x360 
0x1382CA98, 37353949643639176, 90005570, 90005572, 2, 640x360 
0x1382CA98, 37353949643963184, 90005608, 90005613, 5, 640x360 
0x1382CA98, 37353949644281912, 90005644, 90005648, 4, 640x360 
0x1382CA98, 37353949644604944, 90005687, 90005700, 13, 640x360 
0x1382CA98, 37353949644955488, 90005701, 90005710, 9, 640x360 
0x1382CA98, 37353949645257752, 90005744, 90005753, 9, 640x360 
0x1382CA98, 37353949645571328, 90005768, 90005774, 6, 640x360 
0x1382CA98, 37353949645883992, 90005792, 90005810, 18, 640x360 
0x1382CA98, 37353949646222352, 90005828, 90005831, 3, 640x360 
0x1382CA98, 37353949646514288, 90005853, 90005856, 3, 640x360 
0x1382CA98, 37353949646838272, 90005889, 90005894, 5, 640x360 
0x1382CA98, 37353949647153208, 90005914, 90005917, 3, 640x360 
0x1382CA98, 37353949647632504, 90005968, 90005971, 3, 640x360 
0x1382CA98, 37353949647957616, 90006006, 90006025, 19, 640x360 
0x1382CA98, 37353949648303664, 90006041, 90006053, 12, 640x360 
0x1382CA98, 37353949648605728, 90006081, 90006088, 7, 640x360 
0x1382CA98, 37353949648976592, 90006099, 90006105, 6, 640x360 
0x1382CA98, 37353949649237528, 90006147, 90006150, 3, 640x360 
0x1382CA98, 37353949649559320, 90006162, 90006169, 7, 640x360 
0x1382CA98, 37353949649882016, 90006189, 90006198, 9, 640x360 
0x1382CA98, 37353949650196368, 90006223, 90006230, 7, 640x360 
0x1382CA98, 37353949650517144, 90006263, 90006265, 2, 640x360 
0x1382CA98, 37353949650833320, 90006289, 90006295, 6, 640x360 
0x1382CA98, 37353949651172672, 90006320, 90006330, 10, 640x360 
0x1382CA98, 37353949651477848, 90006347, 90006350, 3, 640x360 
0x1382CA98, 37353949651956664, 90006398, 90006405, 7, 640x360 
0x1382CA98, 37353949652282608, 90006436, 90006440, 4, 640x360 
0x1382CA98, 37353949652629352, 90006476, 90006479, 3, 640x360 
0x1382CA98, 37353949652915008, 90006492, 90006500, 8, 640x360 
0x1382CA98, 37353949653238112, 90006532, 90006538, 6, 640x360 
0x1382CA98, 37353949653561200, 90006566, 90006568, 2, 640x360 
0x1382CA98, 37353949653873664, 90006599, 90006619, 20, 640x360 
0x1382CA98, 37353949654237584, 90006637, 90006641, 4, 640x360 
0x1382CA98, 37353949654530720, 90006660, 90006667, 7, 640x360 
0x1382CA98, 37353949655960024, 90006794, 90006807, 13, 320x180 
0x1382CA98, 37353949656598272, 90006870, 90006871, 1, 320x180 
0x1382CA98, 37353949657233384, 90006931, 90006932, 1, 320x180 
0x1382CA98, 37353949657872168, 90007006, 90007011, 5, 320x180 
0x1382CA98, 37353949658512560, 90007055, 90007059, 4, 320x180 
0x1382CA98, 37353949659161312, 90007125, 90007145, 20, 320x180 
0x1382CA98, 37353949660015568, 90007206, 90007215, 9, 320x180 
0x1382CA98, 37353949660598992, 90007265, 90007266, 1, 320x180 
0x1382CA98, 37353949661885048, 90007392, 90007403, 11, 320x180 
0x1382CA98, 37353949662520136, 90007459, 90007466, 7, 320x180 
0x1382CA98, 37353949663152592, 90007515, 90007518, 3, 320x180 
0x1382CA98, 37353949663968856, 90007599, 90007600, 1, 320x180 
0x1382CA98, 37353949664612976, 90007679, 90007685, 6, 320x180 
0x1382CA98, 37353949665233144, 90007733, 90007735, 2, 320x180 
0x1382CA98, 37353949665887480, 90007804, 90007812, 8, 320x180 
0x1382CA98, 37353949666544848, 90007865, 90007871, 6, 320x180 
0x1382CA98, 37353949667159360, 90007919, 90007920, 1, 320x180 
0x1382CA98, 37353949667956448, 90008004, 90008006, 2, 320x180 
0x1382CA98, 37353949668606280, 90008079, 90008082, 3, 320x180 
0x1382CA98, 37353949669243856, 90008130, 90008132, 2, 320x180 
0x1382CA98, 37353949669893912, 90008186, 90008188, 2, 320x180 
0x1382CA98, 37353949670512824, 90008260, 90008262, 2, 320x180 
0x1382CA98, 37353949671152824, 90008313, 90008316, 3, 320x180 
0x1382CA98, 37353949671955024, 90008404, 90008405, 1, 320x180 
0x1382CA98, 37353949672624176, 90008464, 90008466, 2, 320x180 
0x1382CA98, 37353949673232080, 90008526, 90008534, 8, 320x180 
0x1382CA98, 37353949673874736, 90008587, 90008593, 6, 320x180 
0x1382CA98, 37353949674521360, 90008666, 90008670, 4, 320x180 
0x1382CA98, 37353949675156544, 90008717, 90008719, 2, 320x180 
0x1382CA98, 37353949675806008, 90008786, 90008788, 2, 320x180 
0x1382CA98, 37353949676602872, 90008875, 90008881, 6, 320x180 
0x1382CA98, 37353949677236832, 90008929, 90008932, 3, 320x180 
0x1382CA98, 37353949677872976, 90008994, 90008997, 3, 320x180 
0x1382CA98, 37353949678531088, 90009061, 90009063, 2, 320x180 
0x1382CA98, 37353949679177704, 90009123, 90009137, 14, 320x180 
0x1382CA98, 37353949679822200, 90009195, 90009196, 1, 320x180 
0x1382CA98, 37353949680628256, 90009265, 90009273, 8, 320x180 
0x1382CA98, 37353949681239776, 90009324, 90009327, 3, 320x180 
0x1382CA98, 37353949681874368, 90009388, 90009396, 8, 320x180 
0x1382CA98, 37353949682517384, 90009459, 90009470, 11, 320x180 
0x1382CA98, 37353949683172584, 90009519, 90009520, 1, 320x180 
0x1382CA98, 37353949683792520, 90009580, 90009589, 9, 320x180 
0x1382CA98, 37353949684596264, 90009663, 90009665, 2, 320x180 
0x1382CA98, 37353949685232024, 90009728, 90009734, 6, 320x180 
0x1382CA98, 37353949685884816, 90009796, 90009798, 2, 320x180 
0x1382CA98, 37353949686515360, 90009861, 90009864, 3, 320x180 
0x1382CA98, 37353949687152248, 90009933, 90009938, 5, 320x180 
0x1382CA98, 37353949687820328, 90009987, 90009988, 1, 320x180 
0x1382CA98, 37353949688608792, 90010082, 90010090, 8, 320x180 
0x1382CA98, 37353949689235960, 90010130, 90010145, 15, 320x180 
0x1382CA98, 37353949689877856, 90010199, 90010212, 13, 320x180 
0x1382CA98, 37353949690520160, 90010261, 90010271, 10, 320x180 
0x1382CA98, 37353949691180184, 90010326, 90010330, 4, 320x180 
0x1382CA98, 37353949691796064, 90010397, 90010399, 2, 320x180 
0x1382CA98, 37353949692607752, 90010485, 90010487, 2, 320x180 
0x1382CA98, 37353949693293344, 90010536, 90010551, 15, 320x180 
0x1382CA98, 37353949693904288, 90010604, 90010610, 6, 320x180 
0x1382CA98, 37353949694517432, 90010652, 90010653, 1, 320x180 
0x1382CA98, 37353949695152056, 90010718, 90010719, 1, 320x180 
0x1382CA98, 37353949695791640, 90010784, 90010786, 2, 320x180 
0x1382CA98, 37353949696606344, 90010867, 90010877, 10, 320x180 
0x1382CA98, 37353949697230880, 90010936, 90010942, 6, 320x180 
0x1382CA98, 37353949697876296, 90010993, 90011002, 9, 320x180 
0x1382CA98, 37353949698519688, 90011061, 90011062, 1, 320x180 
0x1382CA98, 37353949699152688, 90011127, 90011135, 8, 320x180 
0x1382CA98, 37353949699804000, 90011187, 90011190, 3, 320x180 
0x1382CA98, 37353949700622384, 90011281, 90011288, 7, 320x180 
0x1382CA98, 37353949701281944, 90011355, 90011361, 6, 320x180 
0x1382CA98, 37353949701916232, 90011402, 90011404, 2, 320x180 
0x1382CA98, 37353949702540432, 90011461, 90011464, 3, 320x180 
0x1382CA98, 37353949703158208, 90011520, 90011523, 3, 320x180 
0x1382CA98, 37353949703791824, 90011585, 90011586, 1, 320x180 
0x1382CA98, 37353949704611344, 90011665, 90011667, 2, 320x180 
0x1382CA98, 37353949705231168, 90011732, 90011740, 8, 320x180 
0x1382CA98, 37353949705876520, 90011785, 90011787, 2, 320x180 
0x1382CA98, 37353949706512528, 90011858, 90011861, 3, 320x180 
0x1382CA98, 37353949707156288, 90011916, 90011917, 1, 320x180 
0x1382CA98, 37353949707795416, 90011984, 90011990, 6, 320x180 
0x1382CA98, 37353949708590920, 90012057, 90012061, 4, 320x180 
0x1382CA98, 37353949709230952, 90012127, 90012130, 3, 320x180 
0x1382CA98, 37353949709874696, 90012192, 90012196, 4, 320x180 
0x1382CA98, 37353949710539720, 90012265, 90012269, 4, 320x180 
0x1382CA98, 37353949711157024, 90012328, 90012337, 9, 320x180 
0x1382CA98, 37353949711793008, 90012393, 90012401, 8, 320x180 
0x1382CA98, 37353949712597832, 90012463, 90012465, 2, 320x180 
0x1382CA98, 37353949713231816, 90012531, 90012542, 11, 320x180 
0x1382CA98, 37353949713876912, 90012587, 90012593, 6, 320x180 
0x1382CA98, 37353949714520480, 90012660, 90012668, 8, 320x180 
0x1382CA98, 37353949715156400, 90012716, 90012717, 1, 320x180 
0x1382CA98, 37353949715795016, 90012785, 90012786, 1, 320x180 
0x1382CA98, 37353949716593576, 90012859, 90012867, 8, 320x180 
0x1382CA98, 37353949717235640, 90012924, 90012928, 4, 320x180 
0x1382CA98, 37353949717871224, 90012986, 90012988, 2, 320x180 
0x1382CA98, 37353949718519704, 90013045, 90013047, 2, 320x180 
0x1382CA98, 37353949719152808, 90013117, 90013123, 6, 320x180 
0x1382CA98, 37353949719796272, 90013193, 90013196, 3, 320x180 
0x1382CA98, 37353949720598104, 90013271, 90013273, 2, 320x180 
0x1382CA98, 37353949721231384, 90013335, 90013344, 9, 320x180 
0x1382CA98, 37353949721870744, 90013390, 90013395, 5, 320x180 
0x1382CA98, 37353949722511176, 90013458, 90013460, 2, 320x180 
0x1382CA98, 37353949723153264, 90013526, 90013527, 1, 320x180 
0x1382CA98, 37353949723799424, 90013582, 90013584, 2, 320x180 
0x1382CA98, 37353949724595176, 90013653, 90013660, 7, 320x180 
0x1382CA98, 37353949725230808, 90013732, 90013740, 8, 320x180 
0x1382CA98, 37353949725870464, 90013796, 90013805, 9, 320x180 
0x1382CA98, 37353949726515736, 90013851, 90013852, 1, 320x180 
0x1382CA98, 37353949727155024, 90013925, 90013933, 8, 320x180 
0x1382CA98, 37353949727806544, 90013986, 90013996, 10, 320x180 
0x1382CA98, 37353949728435448, 90014055, 90014057, 2, 320x180 
0x1382CA98, 37353949729237032, 90014132, 90014142, 10, 320x180 
0x1382CA98, 37353949729877584, 90014181, 90014183, 2, 320x180 
0x1382CA98, 37353949730514896, 90014249, 90014254, 5, 320x180 
0x1382CA98, 37353949731152440, 90014307, 90014310, 3, 320x180 
0x1382CA98, 37353949731791352, 90014373, 90014381, 8, 320x180 
0x1382CA98, 37353949732432472, 90014440, 90014444, 4, 320x180 
0x1382CA98, 37353949733230376, 90014530, 90014534, 4, 320x180 
0x1382CA98, 37353949733870184, 90014589, 90014599, 10, 320x180 
0x1382CA98, 37353949734514800, 90014647, 90014649, 2, 320x180 
0x1382CA98, 37353949735154544, 90014715, 90014721, 6, 320x180 
0x1382CA98, 37353949735791256, 90014772, 90014786, 14, 320x180 
0x1382CA98, 37353949736441928, 90014840, 90014847, 7, 320x180 
0x1382CA98, 37353949737248584, 90014921, 90014925, 4, 320x180 
0x1382CA98, 37353949737891496, 90014999, 90015025, 26, 320x180 
0x1382CA98, 37353949738534432, 90015061, 90015068, 7, 320x180 
0x1382CA98, 37353949739150808, 90015122, 90015133, 11, 320x180 
0x1382CA98, 37353949739833432, 90015198, 90015211, 13, 320x180 
0x1382CA98, 37353949740446096, 90015248, 90015250, 2, 320x180 
0x1382CA98, 37353949741232336, 90015320, 90015322, 2, 320x180 
0x1382CA98, 37353949741873848, 90015386, 90015387, 1, 320x180 
0x1382CA98, 37353949742518568, 90015456, 90015464, 8, 320x180 
0x1382CA98, 37353949743154928, 90015517, 90015518, 1, 320x180 
0x1382CA98, 37353949743791088, 90015589, 90015594, 5, 320x180 
0x1382CA98, 37353949744550440, 90015663, 90015664, 1, 320x180 
0x1382CA98, 37353949745229720, 90015727, 90015729, 2, 320x180 
0x1382CA98, 37353949745869960, 90015794, 90015795, 1, 320x180 
0x1382CA98, 37353949746513664, 90015855, 90015859, 4, 320x180 
0x1382CA98, 37353949747155680, 90015915, 90015917, 2, 320x180 
0x1382CA98, 37353949747790560, 90015972, 90015982, 10, 320x180 
0x1382CA98, 37353949748435376, 90016043, 90016050, 7, 320x180 
0x1382CA98, 37353949749297904, 90016160, 90016168, 8, 320x180 
0x1382CA98, 37353949749939320, 90016205, 90016215, 10, 320x180 
0x1382CA98, 37353949750510320, 90016253, 90016254, 1, 320x180 
0x1382CA98, 37353949751150064, 90016308, 90016317, 9, 320x180 
0x1382CA98, 37353949751795408, 90016395, 90016398, 3, 320x180 
0x1382CA98, 37353949752437936, 90016447, 90016448, 1, 320x180 
0x1382CA98, 37353949753234672, 90016521, 90016522, 1, 320x180 
0x1382CA98, 37353949753873912, 90016582, 90016583, 1, 320x180 
0x1382CA98, 37353949754523120, 90016647, 90016649, 2, 320x180 
0x1382CA98, 37353949755152928, 90016715, 90016716, 1, 320x180 
0x1382CA98, 37353949755803712, 90016781, 90016786, 5, 320x180 
0x1382CA98, 37353949756440400, 90016838, 90016841, 3, 320x180 
0x1382CA98, 37353949757230296, 90016921, 90016923, 2, 320x180 
0x1382CA98, 37353949757873968, 90016982, 90016983, 1, 320x180 
0x1382CA98, 37353949758514024, 90017047, 90017050, 3, 320x180 
0x1382CA98, 37353949759150176, 90017113, 90017121, 8, 320x180 
0x1382CA98, 37353949759791080, 90017175, 90017182, 7, 320x180 
0x1382CA98, 37353949760443688, 90017236, 90017241, 5, 320x180 
0x1382CA98, 37353949761230048, 90017322, 90017326, 4, 320x180 
0x1382CA98, 37353949761873896, 90017378, 90017380, 2, 320x180 
0x1382CA98, 37353949762510408, 90017451, 90017454, 3, 320x180 
0x1382CA98, 37353949763163376, 90017516, 90017533, 17, 320x180 
0x1382CA98, 37353949763804744, 90017575, 90017580, 5, 320x180 
0x1382CA98, 37353949764596416, 90017659, 90017679, 20, 320x180 
0x1382CA98, 37353949765233168, 90017722, 90017727, 5, 320x180 
0x1382CA98, 37353949765880624, 90017785, 90017787, 2, 320x180 
0x1382CA98, 37353949766512576, 90017848, 90017850, 2, 320x180 
0x1382CA98, 37353949767151720, 90017919, 90017921, 2, 320x180 
0x1382CA98, 37353949767793632, 90017977, 90017979, 2, 320x180 
0x1382CA98, 37353949768441200, 90018037, 90018038, 1, 320x180 
0x1382CA98, 37353949769233280, 90018125, 90018134, 9, 320x180 
0x1382CA98, 37353949769869000, 90018184, 90018187, 3, 320x180 
0x1382CA98, 37353949770513368, 90018248, 90018255, 7, 320x180 
0x1382CA98, 37353949771150896, 90018315, 90018316, 1, 320x180 
0x1382CA98, 37353949771796248, 90018373, 90018377, 4, 320x180 
0x1382CA98, 37353949772444232, 90018435, 90018436, 1, 320x180 
0x1382CA98, 37353949773229680, 90018522, 90018527, 5, 320x180 
0x1382CA98, 37353949773869800, 90018580, 90018582, 2, 320x180 
0x1382CA98, 37353949774523584, 90018650, 90018651, 1, 320x180 
0x1382CA98, 37353949775149760, 90018713, 90018714, 1, 320x180 
0x1382CA98, 37353949775789832, 90018774, 90018781, 7, 320x180 
0x1382CA98, 37353949776438424, 90018842, 90018843, 1, 320x180 
0x1382CA98, 37353949777228992, 90018928, 90018932, 4, 320x180 
0x1382CA98, 37353949777868976, 90018985, 90018986, 1, 320x180 
0x1382CA98, 37353949778514624, 90019059, 90019062, 3, 320x180 
0x1382CA98, 37353949779155240, 90019124, 90019126, 2, 320x180 
0x1382CA98, 37353949779790368, 90019192, 90019201, 9, 320x180 
0x1382CA98, 37353949780441408, 90019237, 90019238, 1, 320x180 
0x1382CA98, 37353949781233264, 90019319, 90019321, 2, 320x180 
0x1382CA98, 37353949781879904, 90019386, 90019387, 1, 320x180 
0x1382CA98, 37353949782509320, 90019452, 90019454, 2, 320x180 
0x1382CA98, 37353949783154512, 90019508, 90019513, 5, 320x180 
0x1382CA98, 37353949783795176, 90019586, 90019593, 7, 320x180 
0x1382CA98, 37353949784449224, 90019655, 90019658, 3, 320x180 
0x1382CA98, 37353949785070384, 90019711, 90019714, 3, 320x180 
0x1382CA98, 37353949785871496, 90019786, 90019788, 2, 320x180 
0x1382CA98, 37353949786515520, 90019847, 90019853, 6, 320x180 
0x1382CA98, 37353949787153880, 90019910, 90019912, 2, 320x180 
0x1382CA98, 37353949787790360, 90019980, 90019987, 7, 320x180 
0x1382CA98, 37353949788437328, 90020043, 90020047, 4, 320x180 
0x1382CA98, 37353949789069040, 90020110, 90020112, 2, 320x180 
0x1382CA98, 37353949789873544, 90020190, 90020193, 3, 320x180 
0x1382CA98, 37353949790512960, 90020248, 90020254, 6, 320x180 
0x1382CA98, 37353949791149608, 90020315, 90020322, 7, 320x180 
0x1382CA98, 37353949791789832, 90020380, 90020381, 1, 320x180 
0x1382CA98, 37353949792433416, 90020442, 90020450, 8, 320x180 
0x1382CA98, 37353949793069928, 90020504, 90020507, 3, 320x180 
0x1382CA98, 37353949793882776, 90020589, 90020594, 5, 320x180 
0x1382CA98, 37353949794513280, 90020648, 90020653, 5, 320x180 
0x1382CA98, 37353949795155416, 90020716, 90020717, 1, 320x180 
0x1382CA98, 37353949795807112, 90020788, 90020811, 23, 320x180 
0x1382CA98, 37353949796430496, 90020840, 90020845, 5, 320x180 
0x1382CA98, 37353949797102896, 90020916, 90020923, 7, 320x180 
0x1382CA98, 37353949797872864, 90021013, 90021020, 7, 320x180 
0x1382CA98, 37353949798522936, 90021049, 90021051, 2, 320x180 
0x1382CA98, 37353949799148360, 90021113, 90021114, 1, 320x180 
0x1382CA98, 37353949799803272, 90021182, 90021185, 3, 320x180 
0x1382CA98, 37353949800438000, 90021242, 90021251, 9, 320x180 
0x1382CA98, 37353949801072184, 90021311, 90021313, 2, 320x180 
0x1382CA98, 37353949801874176, 90021387, 90021389, 2, 320x180 
0x1382CA98, 37353949802513248, 90021451, 90021456, 5, 320x180 
0x1382CA98, 37353949803149224, 90021514, 90021516, 2, 320x180 
0x1382CA98, 37353949803794568, 90021582, 90021591, 9, 320x180 
0x1382CA98, 37353949804432304, 90021637, 90021639, 2, 320x180 
0x1382CA98, 37353949805069176, 90021715, 90021723, 8, 320x180 
0x1382CA98, 37353949805881064, 90021785, 90021787, 2, 320x180 
0x1382CA98, 37353949806508792, 90021847, 90021849, 2, 320x180 
0x1382CA98, 37353949807168024, 90021913, 90021915, 2, 320x180 
0x1382CA98, 37353949807808400, 90021978, 90021987, 9, 320x180 
0x1382CA98, 37353949808433616, 90022045, 90022048, 3, 320x180 
0x1382CA98, 37353949809068512, 90022105, 90022106, 1, 320x180 
0x1382CA98, 37353949809867792, 90022186, 90022188, 2, 320x180 
0x1382CA98, 37353949810533760, 90022253, 90022255, 2, 320x180 
0x1382CA98, 37353949811163944, 90022316, 90022317, 1, 320x180 
0x1382CA98, 37353949811798888, 90022384, 90022386, 2, 320x180 
0x1382CA98, 37353949812467752, 90022452, 90022454, 2, 320x180 
0x1382CA98, 37353949813071328, 90022510, 90022512, 2, 320x180 
0x1382CA98, 37353949813883496, 90022604, 90022610, 6, 320x180 
0x1382CA98, 37353949814517320, 90022669, 90022679, 10, 320x180 
0x1382CA98, 37353949815154184, 90022722, 90022726, 4, 320x180 
0x1382CA98, 37353949815805552, 90022814, 90022827, 13, 320x180 
0x1382CA98, 37353949816767576, 90022887, 90022895, 8, 320x180 
0x1382CA98, 37353949817397800, 90022944, 90022946, 2, 320x180 
0x1382CA98, 37353949818201264, 90023020, 90023022, 2, 320x180 
0x1382CA98, 37353949818841776, 90023093, 90023109, 16, 320x180 
0x1382CA98, 37353949819474400, 90023150, 90023152, 2, 320x180 
0x1382CA98, 37353949820120472, 90023220, 90023226, 6, 320x180 
0x1382CA98, 37353949820768776, 90023285, 90023286, 1, 320x180 
0x1382CA98, 37353949821407352, 90023349, 90023351, 2, 320x180 
0x1382CA98, 37353949822187816, 90023417, 90023419, 2, 320x180 
0x1382CA98, 37353949822838560, 90023485, 90023487, 2, 320x180 
0x1382CA98, 37353949823472776, 90023541, 90023549, 8, 320x180 
0x1382CA98, 37353949824115064, 90023610, 90023613, 3, 320x180 
0x1382CA98, 37353949824758512, 90023674, 90023678, 4, 320x180 
0x1382CA98, 37353949825395968, 90023737, 90023739, 2, 320x180 
0x1382CA98, 37353949826188216, 90023816, 90023818, 2, 320x180 
0x1382CA98, 37353949826853576, 90023882, 90023883, 1, 320x180 
0x1382CA98, 37353949827485184, 90023951, 90023955, 4, 320x180 
0x1382CA98, 37353949828124160, 90024009, 90024015, 6, 320x180 
0x1382CA98, 37353949828748648, 90024075, 90024084, 9, 320x180 
0x1382CA98, 37353949829387960, 90024140, 90024148, 8, 320x180 
0x1382CA98, 37353949830188208, 90024215, 90024219, 4, 320x180 
0x1382CA98, 37353949830828224, 90024281, 90024291, 10, 320x180 
0x1382CA98, 37353949831468680, 90024347, 90024355, 8, 320x180 
0x1382CA98, 37353949832108312, 90024409, 90024414, 5, 320x180 
0x1382CA98, 37353949832748232, 90024467, 90024469, 2, 320x180 
0x1382CA98, 37353949833391520, 90024536, 90024538, 2, 320x180 
0x1382CA98, 37353949834188008, 90024614, 90024617, 3, 320x180 
0x1382CA98, 37353949834828168, 90024677, 90024681, 4, 320x180 
0x1382CA98, 37353949835470376, 90024743, 90024748, 5, 320x180 
0x1382CA98, 37353949836113904, 90024807, 90024817, 10, 320x180 
0x1382CA98, 37353949836749120, 90024870, 90024872, 2, 320x180 
0x1382CA98, 37353949837388096, 90024936, 90024937, 1, 320x180 
0x1382CA98, 37353949838187408, 90025019, 90025022, 3, 320x180 
0x1382CA98, 37353949838829480, 90025088, 90025090, 2, 320x180 
0x1382CA98, 37353949839467896, 90025146, 90025147, 1, 320x180 
0x1382CA98, 37353949840111584, 90025214, 90025217, 3, 320x180 
0x1382CA98, 37353949840751936, 90025281, 90025287, 6, 320x180 
0x1382CA98, 37353949841391312, 90025339, 90025344, 5, 320x180 
0x1382CA98, 37353949842191360, 90025425, 90025433, 8, 320x180 
0x1382CA98, 37353949842831488, 90025481, 90025483, 2, 320x180 
0x1382CA98, 37353949843472528, 90025542, 90025544, 2, 320x180 
0x1382CA98, 37353949844115704, 90025608, 90025611, 3, 320x180 
0x1382CA98, 37353949844753904, 90025675, 90025678, 3, 320x180 
0x1382CA98, 37353949845387496, 90025736, 90025738, 2, 320x180 
0x1382CA98, 37353949846189352, 90025843, 90025854, 11, 320x180 
0x1382CA98, 37353949846831616, 90025878, 90025880, 2, 320x180 
0x1382CA98, 37353949847467888, 90025945, 90025947, 2, 320x180 
0x1382CA98, 37353949848112248, 90026006, 90026011, 5, 320x180 
0x1382CA98, 37353949848750520, 90026068, 90026070, 2, 320x180 
0x1382CA98, 37353949849392080, 90026135, 90026138, 3, 320x180 
0x1382CA98, 37353949850192664, 90026222, 90026225, 3, 320x180 
0x1382CA98, 37353949850827184, 90026283, 90026284, 1, 320x180 
0x1382CA98, 37353949851467864, 90026351, 90026353, 2, 320x180 
0x1382CA98, 37353949852107088, 90026416, 90026422, 6, 320x180 
0x1382CA98, 37353949852755392, 90026481, 90026483, 2, 320x180 
0x1382CA98, 37353949853387280, 90026536, 90026538, 2, 320x180 
0x1382CA98, 37353949854188336, 90026622, 90026624, 2, 320x180 
0x1382CA98, 37353949854829744, 90026683, 90026684, 1, 320x180 
0x1382CA98, 37353949855467040, 90026751, 90026753, 2, 320x180 
0x1382CA98, 37353949856107496, 90026817, 90026819, 2, 320x180 
0x1382CA98, 37353949856765664, 90026883, 90026886, 3, 320x180 
0x1382CA98, 37353949857399472, 90026949, 90026955, 6, 320x180 
0x1382CA98, 37353949858192080, 90027025, 90027027, 2, 320x180 
0x1382CA98, 37353949858826456, 90027081, 90027087, 6, 320x180 
0x1382CA98, 37353949859470000, 90027154, 90027156, 2, 320x180 
0x1382CA98, 37353949860109944, 90027215, 90027217, 2, 320x180 
0x1382CA98, 37353949860750392, 90027280, 90027284, 4, 320x180 
0x1382CA98, 37353949861391288, 90027342, 90027345, 3, 320x180 
0x1382CA98, 37353949862186240, 90027414, 90027416, 2, 320x180 
0x1382CA98, 37353949862827696, 90027479, 90027482, 3, 320x180 
0x1382CA98, 37353949863467440, 90027551, 90027554, 3, 320x180 
0x1382CA98, 37353949864113480, 90027610, 90027615, 5, 320x180 
0x1382CA98, 37353949864747904, 90027670, 90027672, 2, 320x180 
0x1382CA98, 37353949865387584, 90027735, 90027737, 2, 320x180 
0x1382CA98, 37353949866027904, 90027796, 90027801, 5, 320x180 
0x1382CA98, 37353949866827176, 90027883, 90027885, 2, 320x180 
0x1382CA98, 37353949867467696, 90027949, 90027951, 2, 320x180 
0x1382CA98, 37353949868112232, 90028004, 90028008, 4, 320x180 
0x1382CA98, 37353949868757768, 90028072, 90028077, 5, 320x180 
0x1382CA98, 37353949869386680, 90028165, 90028176, 11, 320x180 
0x1382CA98, 37353949870027216, 90028208, 90028212, 4, 320x180 
0x1382CA98, 37353949870836080, 90028282, 90028286, 4, 320x180 
0x1382CA98, 37353949871470776, 90028341, 90028347, 6, 320x180 
0x1382CA98, 37353949872106784, 90028408, 90028412, 4, 320x180 
0x1382CA98, 37353949872747664, 90028478, 90028480, 2, 320x180 
0x1382CA98, 37353949873391104, 90028536, 90028538, 2, 320x180 
0x1382CA98, 37353949874032432, 90028601, 90028602, 1, 320x180 
0x1382CA98, 37353949874829888, 90028689, 90028694, 5, 320x180 
0x1382CA98, 37353949875474024, 90028758, 90028768, 10, 320x180 
0x1382CA98, 37353949876118008, 90028828, 90028842, 14, 320x180 
0x1382CA98, 37353949876753312, 90028918, 90028922, 4, 320x180 
0x1382CA98, 37353949877395880, 90028949, 90028967, 18, 320x180 
0x1382CA98, 37353949878062376, 90029015, 90029020, 5, 320x180 
0x1382CA98, 37353949878828680, 90029098, 90029104, 6, 320x180 
0x1382CA98, 37353949879482272, 90029160, 90029170, 10, 320x180 
0x1382CA98, 37353949880121032, 90029211, 90029214, 3, 320x180 
0x1382CA98, 37353949880746848, 90029278, 90029288, 10, 320x180 
0x1382CA98, 37353949881395080, 90029335, 90029337, 2, 320x180 
0x1382CA98, 37353949882026688, 90029398, 90029405, 7, 320x180 
0x1382CA98, 37353949882836104, 90029483, 90029485, 2, 320x180 
0x1382CA98, 37353949883472792, 90029550, 90029552, 2, 320x180 
0x1382CA98, 37353949884106600, 90029606, 90029618, 12, 320x180 
0x1382CA98, 37353949884746752, 90029674, 90029682, 8, 320x180 
0x1382CA98, 37353949885387312, 90029737, 90029740, 3, 320x180 
0x1382CA98, 37353949886027392, 90029799, 90029808, 9, 320x180 
0x1382CA98, 37353949886832032, 90029884, 90029890, 6, 320x180 
0x1382CA98, 37353949887470168, 90029949, 90029954, 5, 320x180 
0x1382CA98, 37353949888113112, 90030009, 90030011, 2, 320x180 
0x1382CA98, 37353949888746448, 90030077, 90030079, 2, 320x180 
0x1382CA98, 37353949889386592, 90030143, 90030145, 2, 320x180 
0x1382CA98, 37353949890030192, 90030203, 90030206, 3, 320x180 
0x1382CA98, 37353949890830944, 90030285, 90030288, 3, 320x180 
0x1382CA98, 37353949891470976, 90030348, 90030350, 2, 320x180 
0x1382CA98, 37353949892111576, 90030419, 90030421, 2, 320x180 
0x1382CA98, 37353949892747112, 90030474, 90030477, 3, 320x180 
0x1382CA98, 37353949893393504, 90030542, 90030545, 3, 320x180 
0x1382CA98, 37353949894026776, 90030597, 90030599, 2, 320x180 
0x1382CA98, 37353949894826000, 90030686, 90030688, 2, 320x180 
0x1382CA98, 37353949895470192, 90030750, 90030752, 2, 320x180 
0x1382CA98, 37353949896110504, 90030815, 90030817, 2, 320x180 
0x1382CA98, 37353949896752032, 90030872, 90030875, 3, 320x180 
0x1382CA98, 37353949897386752, 90030942, 90030945, 3, 320x180 
0x1382CA98, 37353949898028744, 90031002, 90031008, 6, 320x180 
0x1382CA98, 37353949898825824, 90031092, 90031102, 10, 320x180 
0x1382CA98, 37353949899472512, 90031160, 90031162, 2, 320x180 
0x1382CA98, 37353949900148408, 90031222, 90031236, 14, 320x180 
0x1382CA98, 37353949900751872, 90031274, 90031285, 11, 320x180 
0x1382CA98, 37353949901390440, 90031334, 90031335, 1, 320x180 
0x1382CA98, 37353949902025880, 90031402, 90031404, 2, 320x180 
0x1382CA98, 37353949902825848, 90031479, 90031482, 3, 320x180 
0x1382CA98, 37353949903465840, 90031548, 90031553, 5, 320x180 
0x1382CA98, 37353949904116656, 90031613, 90031620, 7, 320x180 
0x1382CA98, 37353949904749264, 90031678, 90031679, 1, 320x180 
0x1382CA98, 37353949905385792, 90031742, 90031750, 8, 320x180 
0x1382CA98, 37353949906026048, 90031797, 90031801, 4, 320x180 
0x1382CA98, 37353949906829456, 90031886, 90031887, 1, 320x180 
0x1382CA98, 37353949907466576, 90031951, 90031953, 2, 320x180 
0x1382CA98, 37353949908105488, 90032010, 90032013, 3, 320x180 
0x1382CA98, 37353949908751248, 90032076, 90032079, 3, 320x180 
0x1382CA98, 37353949909393216, 90032137, 90032142, 5, 320x180 
0x1382CA98, 37353949910026472, 90032197, 90032203, 6, 320x180 
0x1382CA98, 37353949910829112, 90032289, 90032295, 6, 320x180 
0x1382CA98, 37353949911465528, 90032350, 90032357, 7, 320x180 
0x1382CA98, 37353949912109696, 90032425, 90032427, 2, 320x180 
0x1382CA98, 37353949912752000, 90032477, 90032481, 4, 320x180 
0x1382CA98, 37353949913389016, 90032539, 90032544, 5, 320x180 
0x1382CA98, 37353949914025656, 90032597, 90032603, 6, 320x180 
0x1382CA98, 37353949914827848, 90032686, 90032688, 2, 320x180 
0x1382CA98, 37353949915465696, 90032744, 90032746, 2, 320x180 
0x1382CA98, 37353949916115912, 90032808, 90032811, 3, 320x180 
0x1382CA98, 37353949916746464, 90032874, 90032875, 1, 320x180 
0x1382CA98, 37353949917390016, 90032932, 90032933, 1, 320x180 
0x1382CA98, 37353949918035040, 90033000, 90033001, 1, 320x180 
0x1382CA98, 37353949918672088, 90033064, 90033070, 6, 320x180 
0x1382CA98, 37353949919467160, 90033146, 90033148, 2, 320x180 
0x1382CA98, 37353949920107272, 90033203, 90033205, 2, 320x180 
0x1382CA98, 37353949920746320, 90033277, 90033278, 1, 320x180 
0x1382CA98, 37353949921386368, 90033344, 90033346, 2, 320x180 
0x1382CA98, 37353949922026016, 90033409, 90033411, 2, 320x180 
0x1382CA98, 37353949922669336, 90033461, 90033463, 2, 320x180 
0x1382CA98, 37353949923465912, 90033541, 90033542, 1, 320x180 
0x1382CA98, 37353949924108840, 90033609, 90033611, 2, 320x180 
0x1382CA98, 37353949924746592, 90033674, 90033675, 1, 320x180 
0x1382CA98, 37353949925390056, 90033743, 90033747, 4, 320x180 
0x1382CA98, 37353949926025296, 90033803, 90033804, 1, 320x180 
0x1382CA98, 37353949926675864, 90033874, 90033882, 8, 320x180 
0x1382CA98, 37353949927467688, 90033948, 90033950, 2, 320x180 
0x1382CA98, 37353949928110360, 90034021, 90034032, 11, 320x180 
0x1382CA98, 37353949928755096, 90034079, 90034081, 2, 320x180 
0x1382CA98, 37353949929389664, 90034142, 90034144, 2, 320x180 
0x1382CA98, 37353949930029400, 90034204, 90034206, 2, 320x180 
0x1382CA98, 37353949930665592, 90034267, 90034274, 7, 320x180 
0x1382CA98, 37353949931466736, 90034342, 90034352, 10, 320x180 
0x1382CA98, 37353949932118992, 90034422, 90034424, 2, 320x180 
0x1382CA98, 37353949932746080, 90034474, 90034483, 9, 320x180 
0x1382CA98, 37353949933386720, 90034537, 90034539, 2, 320x180 
0x1382CA98, 37353949934026992, 90034601, 90034603, 2, 320x180 
0x1382CA98, 37353949934672536, 90034664, 90034665, 1, 320x180 
0x1382CA98, 37353949935464576, 90034741, 90034750, 9, 320x180 
0x1382CA98, 37353949936111728, 90034808, 90034819, 11, 320x180 
0x1382CA98, 37353949936751088, 90034870, 90034871, 1, 320x180 
0x1382CA98, 37353949937385224, 90034941, 90034945, 4, 320x180 
0x1382CA98, 37353949938029264, 90034999, 90035003, 4, 320x180 
0x1382CA98, 37353949938665384, 90035065, 90035068, 3, 320x180 
0x1382CA98, 37353949939464520, 90035150, 90035159, 9, 320x180 
0x1382CA98, 37353949940112064, 90035210, 90035220, 10, 320x180 
0x1382CA98, 37353949940746088, 90035276, 90035278, 2, 320x180 
0x1382CA98, 37353949941385112, 90035336, 90035338, 2, 320x180 
0x1382CA98, 37353949942024984, 90035397, 90035399, 2, 320x180 
0x1382CA98, 37353949942666520, 90035463, 90035466, 3, 320x180 
0x1382CA98, 37353949943465720, 90035548, 90035554, 6, 320x180 
0x1382CA98, 37353949944112128, 90035608, 90035616, 8, 320x180 
0x1382CA98, 37353949944745016, 90035671, 90035674, 3, 320x180 
0x1382CA98, 37353949945401080, 90035734, 90035735, 1, 320x180 
0x1382CA98, 37353949946026920, 90035809, 90035815, 6, 320x180 
0x1382CA98, 37353949946669480, 90035865, 90035872, 7, 320x180 
0x1382CA98, 37353949947465272, 90035944, 90035947, 3, 320x180 
0x1382CA98, 37353949948132128, 90036021, 90036024, 3, 320x180 
0x1382CA98, 37353949948746928, 90036070, 90036072, 2, 320x180 
0x1382CA98, 37353949949395752, 90036150, 90036152, 2, 320x180 
0x1382CA98, 37353949950038032, 90036204, 90036211, 7, 320x180 
0x1382CA98, 37353949950664864, 90036266, 90036268, 2, 320x180 
0x1382CA98, 37353949951464288, 90036349, 90036352, 3, 320x180 
0x1382CA98, 37353949952104208, 90036404, 90036406, 2, 320x180 
0x1382CA98, 37353949952745256, 90036468, 90036470, 2, 320x180 
0x1382CA98, 37353949953387344, 90036540, 90036544, 4, 320x180 
0x1382CA98, 37353949954025456, 90036596, 90036597, 1, 320x180 
0x1382CA98, 37353949954669144, 90036662, 90036673, 11, 320x180 
0x1382CA98, 37353949955464616, 90036744, 90036747, 3, 320x180 
0x1382CA98, 37353949956110080, 90036804, 90036806, 2, 320x180 
0x1382CA98, 37353949956751744, 90036872, 90036883, 11, 320x180 
0x1382CA98, 37353949957385016, 90036936, 90036938, 2, 320x180 
0x1382CA98, 37353949958028952, 90037000, 90037003, 3, 320x180 
0x1382CA98, 37353949958680080, 90037069, 90037071, 2, 320x180 
0x1382CA98, 37353949959535960, 90037157, 90037172, 15, 320x180 
0x1382CA98, 37353949960119456, 90037212, 90037221, 9, 320x180 
0x1382CA98, 37353949960766968, 90037284, 90037286, 2, 320x180 
0x1382CA98, 37353949961384648, 90037347, 90037354, 7, 320x180 
0x1382CA98, 37353949962025272, 90037405, 90037408, 3, 320x180 
0x1382CA98, 37353949962666184, 90037464, 90037472, 8, 320x180 
0x1382CA98, 37353949963467832, 90037545, 90037546, 1, 320x180 
0x1382CA98, 37353949964138328, 90037619, 90037622, 3, 320x180 
0x1382CA98, 37353949964762808, 90037687, 90037691, 4, 320x180 
0x1382CA98, 37353949965386312, 90037740, 90037744, 4, 320x180 
0x1382CA98, 37353949966027960, 90037803, 90037808, 5, 320x180 
0x1382CA98, 37353949966665192, 90037870, 90037872, 2, 320x180 
0x1382CA98, 37353949967470504, 90037952, 90037954, 2, 320x180 
0x1382CA98, 37353949968104256, 90038005, 90038012, 7, 320x180 
0x1382CA98, 37353949968743864, 90038072, 90038077, 5, 320x180 
0x1382CA98, 37353949969384144, 90038137, 90038140, 3, 320x180 
0x1382CA98, 37353949970024304, 90038197, 90038198, 1, 320x180 
0x1382CA98, 37353949970664344, 90038262, 90038264, 2, 320x180 
0x1382CA98, 37353949971464208, 90038349, 90038359, 10, 320x180 
0x1382CA98, 37353949972108448, 90038411, 90038417, 6, 320x180 
0x1382CA98, 37353949972744800, 90038479, 90038482, 3, 320x180 
0x1382CA98, 37353949973385824, 90038537, 90038540, 3, 320x180 
0x1382CA98, 37353949974023976, 90038601, 90038603, 2, 320x180 
0x1382CA98, 37353949974677624, 90038667, 90038671, 4, 320x180 
0x1382CA98, 37353949975305864, 90038729, 90038735, 6, 320x180 
0x1382CA98, 37353949976108064, 90038804, 90038805, 1, 320x180 
0x1382CA98, 37353949976744856, 90038887, 90038889, 2, 320x180 
0x1382CA98, 37353949977404392, 90038948, 90038951, 3, 320x180 
0x1382CA98, 37353949978023784, 90039002, 90039005, 3, 320x180 
0x1382CA98, 37353949978667456, 90039063, 90039070, 7, 320x180 
0x1382CA98, 37353949979305256, 90039124, 90039126, 2, 320x180 
0x1382CA98, 37353949980117464, 90039214, 90039219, 5, 320x180 
0x1382CA98, 37353949980744408, 90039279, 90039281, 2, 320x180 
0x1382CA98, 37353949981384424, 90039342, 90039351, 9, 320x180 
0x1382CA98, 37353949982029528, 90039409, 90039411, 2, 320x180 
0x1382CA98, 37353949982664384, 90039472, 90039476, 4, 320x180 
0x1382CA98, 37353949983304544, 90039527, 90039535, 8, 320x180 
0x1382CA98, 37353949984111992, 90039606, 90039608, 2, 320x180 
0x1382CA98, 37353949984744464, 90039672, 90039675, 3, 320x180 
0x1382CA98, 37353949985384336, 90039743, 90039747, 4, 320x180 
0x1382CA98, 37353949986023648, 90039804, 90039805, 1, 320x180 
0x1382CA98, 37353949986669672, 90039865, 90039872, 7, 320x180 
0x1382CA98, 37353949987325712, 90039929, 90039931, 2, 320x180 
0x1382CA98, 37353949988104352, 90040011, 90040014, 3, 320x180 
0x1382CA98, 37353949988745096, 90040093, 90040094, 1, 320x180 
0x1382CA98, 37353949989384160, 90040143, 90040152, 9, 320x180 
0x1382CA98, 37353949990023904, 90040203, 90040205, 2, 320x180 
0x1382CA98, 37353949990668224, 90040274, 90040286, 12, 320x180 
0x1382CA98, 37353949991303832, 90040337, 90040339, 2, 320x180 
0x1382CA98, 37353949992118440, 90040420, 90040430, 10, 320x180 
0x1382CA98, 37353949992839928, 90040488, 90040498, 10, 320x180 
0x1382CA98, 37353949993389808, 90040538, 90040539, 1, 320x180 
0x1382CA98, 37353949994031832, 90040604, 90040606, 2, 320x180 
0x1382CA98, 37353949994674200, 90040669, 90040674, 5, 320x180 
0x1382CA98, 37353949995306024, 90040726, 90040728, 2, 320x180 
0x1382CA98, 37353949996111840, 90040809, 90040817, 8, 320x180 
0x1382CA98, 37353949996745512, 90040870, 90040871, 1, 320x180 
0x1382CA98, 37353949997391544, 90040937, 90040938, 1, 320x180 
0x1382CA98, 37353949998027600, 90041000, 90041002, 2, 320x180 
0x1382CA98, 37353949998663992, 90041065, 90041073, 8, 320x180 
0x1382CA98, 37353949999304264, 90041135, 90041139, 4, 320x180 
0x1382CA98, 37353950000119352, 90041216, 90041222, 6, 320x180 
0x1382CA98, 37353950000767496, 90041284, 90041296, 12, 320x180 
0x1382CA98, 37353950001391720, 90041352, 90041363, 11, 320x180 
0x1382CA98, 37353950002024104, 90041409, 90041421, 12, 320x180 
0x1382CA98, 37353950002663200, 90041469, 90041479, 10, 320x180 
0x1382CA98, 37353950003305944, 90041532, 90041539, 7, 320x180 
0x1382CA98, 37353950004103064, 90041606, 90041614, 8, 320x180 
0x1382CA98, 37353950004754720, 90041683, 90041689, 6, 320x180 
0x1382CA98, 37353950005383400, 90041737, 90041738, 1, 320x180 
0x1382CA98, 37353950006022896, 90041797, 90041801, 4, 320x180 
0x1382CA98, 37353950006676992, 90041866, 90041868, 2, 320x180 
0x1382CA98, 37353950007319280, 90041951, 90041954, 3, 320x180 
0x1382CA98, 37353950008106456, 90042010, 90042017, 7, 320x180 
0x1382CA98, 37353950008756160, 90042076, 90042084, 8, 320x180 
0x1382CA98, 37353950009392352, 90042146, 90042148, 2, 320x180 
0x1382CA98, 37353950010023384, 90042203, 90042210, 7, 320x180 
0x1382CA98, 37353950010664496, 90042283, 90042284, 1, 320x180 
0x1382CA98, 37353950011307008, 90042329, 90042332, 3, 320x180 
0x1382CA98, 37353950012109520, 90042407, 90042409, 2, 320x180 
0x1382CA98, 37353950012754344, 90042471, 90042473, 2, 320x180 
0x1382CA98, 37353950013387480, 90042535, 90042538, 3, 320x180 
0x1382CA98, 37353950014050336, 90042602, 90042604, 2, 320x180 
0x1382CA98, 37353950014667288, 90042672, 90042673, 1, 320x180 
0x1382CA98, 37353950015311976, 90042732, 90042734, 2, 320x180 
0x1382CA98, 37353950016115336, 90042828, 90042841, 13, 320x180 
0x1382CA98, 37353950016763616, 90042884, 90042888, 4, 320x180 
0x1382CA98, 37353950017454400, 90042971, 90042979, 8, 320x180 
0x1382CA98, 37353950018241528, 90043056, 90043060, 4, 320x180 
0x1382CA98, 37353950018885912, 90043125, 90043143, 18, 320x180 
0x1382CA98, 37353950019654024, 90043197, 90043202, 5, 320x180 
0x1382CA98, 37353950020424200, 90043272, 90043275, 3, 320x180 
0x1382CA98, 37353950021065416, 90043318, 90043319, 1, 320x180 
0x1382CA98, 37353950021702584, 90043372, 90043379, 7, 320x180 
0x1382CA98, 37353950022344104, 90043438, 90043440, 2, 320x180 
0x1382CA98, 37353950022991832, 90043497, 90043505, 8, 320x180 
0x1382CA98, 37353950023627800, 90043572, 90043574, 2, 320x180 
0x1382CA98, 37353950024438928, 90043643, 90043647, 4, 320x180 
0x1382CA98, 37353950025062608, 90043729, 90043736, 7, 320x180 
0x1382CA98, 37353950025703312, 90043784, 90043789, 5, 320x180 
0x1382CA98, 37353950026342528, 90043844, 90043846, 2, 320x180 
0x1382CA98, 37353950026983024, 90043891, 90043895, 4, 320x180 
0x1382CA98, 37353950027624448, 90043970, 90043974, 4, 320x180 
0x1382CA98, 37353950028426872, 90044044, 90044053, 9, 320x180 
0x1382CA98, 37353950029062248, 90044110, 90044112, 2, 320x180 
0x1382CA98, 37353950029703016, 90044171, 90044175, 4, 320x180 
0x1382CA98, 37353950030342912, 90044231, 90044233, 2, 320x180 
0x1382CA98, 37353950030982664, 90044293, 90044301, 8, 320x180 
0x1382CA98, 37353950031626096, 90044365, 90044371, 6, 320x180 
0x1382CA98, 37353950032422968, 90044442, 90044446, 4, 320x180 
0x1382CA98, 37353950033066352, 90044515, 90044517, 2, 320x180 
0x1382CA98, 37353950033702312, 90044569, 90044571, 2, 320x180 
0x1382CA98, 37353950034351016, 90044633, 90044634, 1, 320x180 
0x1382CA98, 37353950034986032, 90044692, 90044700, 8, 320x180 
0x1382CA98, 37353950035622392, 90044755, 90044759, 4, 320x180 
0x1382CA98, 37353950036441080, 90044848, 90044850, 2, 320x180 
0x1382CA98, 37353950037109960, 90044911, 90044913, 2, 320x180 
0x1382CA98, 37353950037715688, 90044976, 90044978, 2, 320x180 
0x1382CA98, 37353950038342496, 90045040, 90045044, 4, 320x180 
0x1382CA98, 37353950038991512, 90045106, 90045108, 2, 320x180 
0x1382CA98, 37353950039622520, 90045166, 90045172, 6, 320x180 
0x1382CA98, 37353950040441656, 90045240, 90045245, 5, 320x180 
0x1382CA98, 37353950041066384, 90045302, 90045305, 3, 320x180 
0x1382CA98, 37353950041702024, 90045371, 90045372, 1, 320x180 
0x1382CA98, 37353950042347088, 90045434, 90045435, 1, 320x180 
0x1382CA98, 37353950042994584, 90045496, 90045503, 7, 320x180 
0x1382CA98, 37353950043630360, 90045564, 90045570, 6, 320x180 
0x1382CA98, 37353950044426048, 90045649, 90045650, 1, 320x180 
0x1382CA98, 37353950045062632, 90045712, 90045714, 2, 320x180 
0x1382CA98, 37353950045702952, 90045772, 90045773, 1, 320x180 
0x1382CA98, 37353950046342824, 90045844, 90045846, 2, 320x180 
0x1382CA98, 37353950046985680, 90045912, 90045922, 10, 320x180 
0x1382CA98, 37353950047629024, 90045970, 90045971, 1, 320x180 
0x1382CA98, 37353950048445120, 90046051, 90046060, 9, 320x180 
0x1382CA98, 37353950049074776, 90046113, 90046115, 2, 320x180 
0x1382CA98, 37353950049701728, 90046174, 90046178, 4, 320x180 
0x1382CA98, 37353950050341736, 90046234, 90046240, 6, 320x180 
0x1382CA98, 37353950050987136, 90046298, 90046300, 2, 320x180 
0x1382CA98, 37353950051622744, 90046361, 90046363, 2, 320x180 
0x1382CA98, 37353950052435704, 90046441, 90046445, 4, 320x180 
0x1382CA98, 37353950053086744, 90046500, 90046502, 2, 320x180 
0x1382CA98, 37353950053701832, 90046566, 90046569, 3, 320x180 
0x1382CA98, 37353950054346664, 90046631, 90046633, 2, 320x180 
0x1382CA98, 37353950054985800, 90046705, 90046706, 1, 320x180 
0x1382CA98, 37353950055622880, 90046764, 90046768, 4, 320x180 
0x1382CA98, 37353950056285936, 90046841, 90046851, 10, 320x180 
0x1382CA98, 37353950057077288, 90046917, 90046919, 2, 320x180 
0x1382CA98, 37353950057701576, 90046967, 90046968, 1, 320x180 
0x1382CA98, 37353950058346288, 90047034, 90047035, 1, 320x180 
0x1382CA98, 37353950058982080, 90047090, 90047098, 8, 320x180 
0x1382CA98, 37353950059623944, 90047159, 90047168, 9, 320x180 
0x1382CA98, 37353950060273400, 90047226, 90047228, 2, 320x180 
0x1382CA98, 37353950061065728, 90047304, 90047305, 1, 320x180 
0x1382CA98, 37353950061702088, 90047369, 90047370, 1, 320x180 
0x1382CA98, 37353950062342184, 90047432, 90047438, 6, 320x180 
0x1382CA98, 37353950062985984, 90047505, 90047506, 1, 320x180 
0x1382CA98, 37353950063626784, 90047558, 90047566, 8, 320x180 
0x1382CA98, 37353950064283048, 90047626, 90047633, 7, 320x180 
0x1382CA98, 37353950065066720, 90047713, 90047725, 12, 320x180 
0x1382CA98, 37353950065705928, 90047781, 90047788, 7, 320x180 
0x1382CA98, 37353950066341160, 90047834, 90047836, 2, 320x180 
0x1382CA98, 37353950066982144, 90047899, 90047901, 2, 320x180 
0x1382CA98, 37353950067626728, 90047960, 90047964, 4, 320x180 
0x1382CA98, 37353950068276976, 90048025, 90048033, 8, 320x180 
0x1382CA98, 37353950069072512, 90048105, 90048106, 1, 320x180 
0x1382CA98, 37353950069705280, 90048169, 90048170, 1, 320x180 
0x1382CA98, 37353950070350344, 90048231, 90048238, 7, 320x180 
0x1382CA98, 37353950070991688, 90048305, 90048310, 5, 320x180 
0x1382CA98, 37353950071628728, 90048382, 90048391, 9, 320x180 
0x1382CA98, 37353950072302944, 90048438, 90048445, 7, 320x180 
0x1382CA98, 37353950073068144, 90048512, 90048514, 2, 320x180 
0x1382CA98, 37353950073709424, 90048573, 90048578, 5, 320x180 
0x1382CA98, 37353950074363368, 90048641, 90048644, 3, 320x180 
0x1382CA98, 37353950074984376, 90048695, 90048703, 8, 320x180 
0x1382CA98, 37353950075623912, 90048762, 90048769, 7, 320x180 
0x1382CA98, 37353950076291056, 90048821, 90048824, 3, 320x180 
0x1382CA98, 37353950077061128, 90048909, 90048912, 3, 320x180 
0x1382CA98, 37353950077710072, 90048968, 90048969, 1, 320x180 
0x1382CA98, 37353950078341928, 90049028, 90049032, 4, 320x180 
0x1382CA98, 37353950078982384, 90049093, 90049105, 12, 320x180 
0x1382CA98, 37353950079646064, 90049171, 90049173, 2, 320x180 
0x1382CA98, 37353950080273752, 90049229, 90049231, 2, 320x180 
0x1382CA98, 37353950081060760, 90049309, 90049311, 2, 320x180 
0x1382CA98, 37353950081701752, 90049368, 90049369, 1, 320x180 
0x1382CA98, 37353950082341824, 90049431, 90049439, 8, 320x180 
0x1382CA98, 37353950082981584, 90049491, 90049495, 4, 320x180 
0x1382CA98, 37353950083622272, 90049556, 90049564, 8, 320x180 
0x1382CA98, 37353950084262400, 90049620, 90049622, 2, 320x180 
0x1382CA98, 37353950085061840, 90049702, 90049704, 2, 320x180 
0x1382CA98, 37353950085701984, 90049764, 90049769, 5, 320x180 
0x1382CA98, 37353950086345000, 90049834, 90049836, 2, 320x180 
0x1382CA98, 37353950086981848, 90049892, 90049916, 24, 320x180 
0x1382CA98, 37353950087630808, 90049959, 90049970, 11, 320x180 
0x1382CA98, 37353950088277488, 90050039, 90050044, 5, 320x180 
0x1382CA98, 37353950089061328, 90050115, 90050118, 3, 320x180 
0x1382CA98, 37353950089714384, 90050178, 90050179, 1, 320x180 
0x1382CA98, 37353950090342360, 90050239, 90050240, 1, 320x180 
0x1382CA98, 37353950090981464, 90050298, 90050300, 2, 320x180 
0x1382CA98, 37353950091639272, 90050375, 90050379, 4, 320x180 
0x1382CA98, 37353950092264520, 90050443, 90050451, 8, 320x180 
0x1382CA98, 37353950093067352, 90050522, 90050527, 5, 320x180 
0x1382CA98, 37353950093701200, 90050572, 90050578, 6, 320x180 
0x1382CA98, 37353950094341448, 90050636, 90050638, 2, 320x180 
0x1382CA98, 37353950094990144, 90050706, 90050712, 6, 320x180 
0x1382CA98, 37353950095621184, 90050773, 90050778, 5, 320x180 
0x1382CA98, 37353950096266440, 90050838, 90050841, 3, 320x180 
0x1382CA98, 37353950097060960, 90050912, 90050914, 2, 320x180 
0x1382CA98, 37353950097715288, 90050972, 90050984, 12, 320x180 
0x1382CA98, 37353950098341576, 90051044, 90051046, 2, 320x180 
0x1382CA98, 37353950098981152, 90051098, 90051100, 2, 320x180 
0x1382CA98, 37353950099622864, 90051175, 90051179, 4, 320x180 
0x1382CA98, 37353950100265496, 90051235, 90051236, 1, 320x180 
0x1382CA98, 37353950101098128, 90051317, 90051319, 2, 320x180 
0x1382CA98, 37353950101704568, 90051383, 90051384, 1, 320x180 
0x1382CA98, 37353950102344440, 90051440, 90051444, 4, 320x180 
0x1382CA98, 37353950102985752, 90051508, 90051521, 13, 320x180 
0x1382CA98, 37353950103623392, 90051575, 90051579, 4, 320x180 
0x1382CA98, 37353950104261816, 90051636, 90051638, 2, 320x180 
0x1382CA98, 37353950105059848, 90051712, 90051714, 2, 320x180 
0x1382CA98, 37353950105707040, 90051770, 90051772, 2, 320x180 
0x1382CA98, 37353950106361976, 90051841, 90051851, 10, 320x180 
0x1382CA98, 37353950107033968, 90051915, 90051917, 2, 320x180 
0x1382CA98, 37353950107623608, 90051985, 90051996, 11, 320x180 
0x1382CA98, 37353950108273448, 90052042, 90052048, 6, 320x180 
0x1382CA98, 37353950108907864, 90052111, 90052114, 3, 320x180 
0x1382CA98, 37353950109704624, 90052175, 90052178, 3, 320x180 
0x1382CA98, 37353950110345088, 90052233, 90052235, 2, 320x180 
0x1382CA98, 37353950110980216, 90052300, 90052304, 4, 320x180 
0x1382CA98, 37353950111620552, 90052359, 90052372, 13, 320x180 
0x1382CA98, 37353950112266384, 90052427, 90052430, 3, 320x180 
0x1382CA98, 37353950112902248, 90052485, 90052487, 2, 320x180 
0x1382CA98, 37353950113701664, 90052569, 90052570, 1, 320x180 
0x1382CA98, 37353950114345200, 90052630, 90052638, 8, 320x180 
0x1382CA98, 37353950114984144, 90052706, 90052712, 6, 320x180 
0x1382CA98, 37353950115624512, 90052758, 90052761, 3, 320x180 
0x1382CA98, 37353950116269976, 90052830, 90052832, 2, 320x180 
0x1382CA98, 37353950116904536, 90052886, 90052888, 2, 320x180 
0x1382CA98, 37353950117700280, 90052966, 90052968, 2, 320x180 
0x1382CA98, 37353950118342008, 90053044, 90053055, 11, 320x180 
0x1382CA98, 37353950118987120, 90053106, 90053108, 2, 320x180 
0x1382CA98, 37353950119621112, 90053154, 90053157, 3, 320x180 
0x1382CA98, 37353950120270928, 90053221, 90053224, 3, 320x180 
0x1382CA98, 37353950120900512, 90053287, 90053292, 5, 320x180 
0x1382CA98, 37353950121703640, 90053366, 90053368, 2, 320x180 
0x1382CA98, 37353950122340512, 90053431, 90053432, 1, 320x180 
0x1382CA98, 37353950122987880, 90053506, 90053518, 12, 320x180 
0x1382CA98, 37353950123632880, 90053581, 90053583, 2, 320x180 
0x1382CA98, 37353950124277008, 90053653, 90053667, 14, 320x180 
0x1382CA98, 37353950124901752, 90053698, 90053700, 2, 320x180 
0x1382CA98, 37353950125726896, 90053782, 90053784, 2, 320x180 
0x1382CA98, 37353950126344272, 90053836, 90053837, 1, 320x180 
0x1382CA98, 37353950126985552, 90053901, 90053904, 3, 320x180 
0x1382CA98, 37353950127620832, 90053980, 90053994, 14, 320x180 
0x1382CA98, 37353950128265520, 90054050, 90054056, 6, 320x180 
0x1382CA98, 37353950128902296, 90054095, 90054098, 3, 320x180 
0x1382CA98, 37353950129700088, 90054170, 90054174, 4, 320x180 
0x1382CA98, 37353950130345504, 90054267, 90054270, 3, 320x180 
0x1382CA98, 37353950131007384, 90054308, 90054332, 24, 320x180 
0x1382CA98, 37353950131629112, 90054384, 90054414, 30, 320x180 
0x1382CA98, 37353950132383864, 90054471, 90054479, 8, 320x180 
0x1382CA98, 37353950133380008, 90054538, 90054544, 6, 320x180 
0x1382CA98, 37353950134019712, 90054601, 90054605, 4, 320x180 
0x1382CA98, 37353950134663544, 90054665, 90054672, 7, 320x180 
0x1382CA98, 37353950135300448, 90054737, 90054739, 2, 320x180 
0x1382CA98, 37353950135945136, 90054800, 90054802, 2, 320x180 
0x1382CA98, 37353950136583136, 90054858, 90054868, 10, 320x180 
0x1382CA98, 37353950137224600, 90054921, 90054922, 1, 320x180 
0x1382CA98, 37353950138019440, 90054998, 90055005, 7, 320x180 
0x1382CA98, 37353950138659600, 90055064, 90055066, 2, 320x180 
0x1382CA98, 37353950139300216, 90055130, 90055134, 4, 320x180 
0x1382CA98, 37353950139952776, 90055189, 90055193, 4, 320x180 
0x1382CA98, 37353950140594848, 90055252, 90055253, 1, 320x180 
0x1382CA98, 37353950141223984, 90055321, 90055324, 3, 320x180 
0x1382CA98, 37353950142020136, 90055395, 90055397, 2, 320x180 
0x1382CA98, 37353950142660256, 90055466, 90055467, 1, 320x180 
0x1382CA98, 37353950143300424, 90055529, 90055543, 14, 320x180 
0x1382CA98, 37353950143941440, 90055601, 90055608, 7, 320x180 
0x1382CA98, 37353950144583784, 90055653, 90055655, 2, 320x180 
0x1382CA98, 37353950145219504, 90055718, 90055719, 1, 320x180 
0x1382CA98, 37353950146019504, 90055804, 90055805, 1, 320x180 
0x1382CA98, 37353950146663416, 90055865, 90055873, 8, 320x180 
0x1382CA98, 37353950147303448, 90055927, 90055939, 12, 320x180 
0x1382CA98, 37353950147943880, 90055988, 90055989, 1, 320x180 
0x1382CA98, 37353950148579800, 90056051, 90056052, 1, 320x180 
0x1382CA98, 37353950149223928, 90056116, 90056117, 1, 320x180 
0x1382CA98, 37353950150019544, 90056207, 90056210, 3, 320x180 
0x1382CA98, 37353950150664416, 90056265, 90056266, 1, 320x180 
0x1382CA98, 37353950151299696, 90056336, 90056338, 2, 320x180 
0x1382CA98, 37353950151939944, 90056398, 90056400, 2, 320x180 
0x1382CA98, 37353950152586448, 90056462, 90056466, 4, 320x180 
0x1382CA98, 37353950153222896, 90056536, 90056537, 1, 320x180 
0x1382CA98, 37353950154023536, 90056598, 90056606, 8, 320x180 
0x1382CA98, 37353950154663816, 90056665, 90056672, 7, 320x180 
0x1382CA98, 37353950155299600, 90056725, 90056739, 14, 320x180 
0x1382CA98, 37353950155948312, 90056794, 90056799, 5, 320x180 
0x1382CA98, 37353950156581624, 90056859, 90056864, 5, 320x180 
0x1382CA98, 37353950157235968, 90056924, 90056929, 5, 320x180 
0x1382CA98, 37353950158023072, 90057007, 90057019, 12, 320x180 
0x1382CA98, 37353950158664536, 90057079, 90057082, 3, 320x180 
0x1382CA98, 37353950159305464, 90057132, 90057138, 6, 320x180 
0x1382CA98, 37353950159942624, 90057191, 90057195, 4, 320x180 
0x1382CA98, 37353950160586264, 90057265, 90057268, 3, 320x180 
0x1382CA98, 37353950161219136, 90057329, 90057331, 2, 320x180 
0x1382CA98, 37353950162020136, 90057398, 90057401, 3, 320x180 
0x1382CA98, 37353950162663136, 90057467, 90057469, 2, 320x180 
0x1382CA98, 37353950163304120, 90057533, 90057536, 3, 320x180 
0x1382CA98, 37353950163940376, 90057593, 90057595, 2, 320x180 
0x1382CA98, 37353950164588080, 90057658, 90057662, 4, 320x180 
0x1382CA98, 37353950165220088, 90057729, 90057731, 2, 320x180 
0x1382CA98, 37353950166019384, 90057805, 90057806, 1, 320x180 
0x1382CA98, 37353950166666296, 90057864, 90057867, 3, 320x180 
0x1382CA98, 37353950167299280, 90057923, 90057925, 2, 320x180 
0x1382CA98, 37353950167955056, 90058035, 90058037, 2, 320x180 
0x1382CA98, 37353950168910160, 90058097, 90058100, 3, 320x180 
0x1382CA98, 37353950169545280, 90058153, 90058154, 1, 320x180 
0x1382CA98, 37353950170342760, 90058243, 90058245, 2, 320x180 
0x1382CA98, 37353950170980248, 90058306, 90058320, 14, 320x180 
0x1382CA98, 37353950171631880, 90058370, 90058385, 15, 320x180 
0x1382CA98, 37353950172265976, 90058440, 90058443, 3, 320x180 
0x1382CA98, 37353950172898720, 90058497, 90058498, 1, 320x180 
0x1382CA98, 37353950173538888, 90058558, 90058562, 4, 320x180 
0x1382CA98, 37353950174360856, 90058632, 90058634, 2, 320x180 
0x1382CA98, 37353950174983616, 90058698, 90058706, 8, 320x180 
0x1382CA98, 37353950175619328, 90058759, 90058760, 1, 320x180 
0x1382CA98, 37353950176265464, 90058828, 90058831, 3, 320x180 
0x1382CA98, 37353950176899272, 90058896, 90058902, 6, 320x180 
0x1382CA98, 37353950177543112, 90058949, 90058951, 2, 320x180 
0x1382CA98, 37353950178342568, 90059043, 90059046, 3, 320x180 
0x1382CA98, 37353950178985544, 90059102, 90059103, 1, 320x180 
0x1382CA98, 37353950179624264, 90059162, 90059163, 1, 320x180 
0x1382CA98, 37353950180259240, 90059223, 90059228, 5, 320x180 
0x1382CA98, 37353950180899576, 90059291, 90059295, 4, 320x180 
0x1382CA98, 37353950181539840, 90059356, 90059358, 2, 320x180 
0x1382CA98, 37353950182338704, 90059431, 90059436, 5, 320x180 
0x1382CA98, 37353950182985640, 90059499, 90059501, 2, 320x180 
0x1382CA98, 37353950183632824, 90059569, 90059573, 4, 320x180 
0x1382CA98, 37353950184261856, 90059639, 90059643, 4, 320x180 
0x1382CA98, 37353950184904272, 90059694, 90059696, 2, 320x180 
0x1382CA98, 37353950185540616, 90059759, 90059763, 4, 320x180 
0x1382CA98, 37353950186344168, 90059831, 90059837, 6, 320x180 
0x1382CA98, 37353950186978664, 90059905, 90059906, 1, 320x180 
0x1382CA98, 37353950187620968, 90059959, 90059974, 15, 320x180 
0x1382CA98, 37353950188264456, 90060022, 90060026, 4, 320x180 
0x1382CA98, 37353950188898304, 90060090, 90060094, 4, 320x180 
0x1382CA98, 37353950189538424, 90060154, 90060155, 1, 320x180 
0x1382CA98, 37353950190344736, 90060234, 90060236, 2, 320x180 
0x1382CA98, 37353950190989040, 90060292, 90060301, 9, 320x180 
0x1382CA98, 37353950191619904, 90060360, 90060371, 11, 320x180 
0x1382CA98, 37353950192276488, 90060432, 90060434, 2, 320x180 
0x1382CA98, 37353950192905840, 90060490, 90060491, 1, 320x180 
0x1382CA98, 37353950193538760, 90060562, 90060564, 2, 320x180 
0x1382CA98, 37353950194346312, 90060634, 90060635, 1, 320x180 
0x1382CA98, 37353950194984144, 90060702, 90060710, 8, 320x180 
0x1382CA98, 37353950195622384, 90060769, 90060770, 1, 320x180 
0x1382CA98, 37353950196260328, 90060832, 90060833, 1, 320x180 
0x1382CA98, 37353950196899536, 90060899, 90060903, 4, 320x180 
0x1382CA98, 37353950197538224, 90060961, 90060968, 7, 320x180 
0x1382CA98, 37353950198337488, 90061042, 90061054, 12, 320x180 
0x1382CA98, 37353950199019024, 90061104, 90061106, 2, 320x180 
0x1382CA98, 37353950199662208, 90061168, 90061175, 7, 320x180 
0x1382CA98, 37353950200259192, 90061226, 90061237, 11, 320x180 
0x1382CA98, 37353950200897800, 90061298, 90061306, 8, 320x180 
0x1382CA98, 37353950201538088, 90061348, 90061354, 6, 320x180 
0x1382CA98, 37353950202338488, 90061431, 90061438, 7, 320x180 
0x1382CA98, 37353950202982088, 90061491, 90061494, 3, 320x180 
0x1382CA98, 37353950203620648, 90061562, 90061564, 2, 320x180 
0x1382CA98, 37353950204262272, 90061621, 90061623, 2, 320x180 
0x1382CA98, 37353950204902712, 90061697, 90061699, 2, 320x180 
0x1382CA98, 37353950205541216, 90061760, 90061762, 2, 320x180 
0x1382CA98, 37353950206346072, 90061840, 90061844, 4, 320x180 
0x1382CA98, 37353950206978064, 90061900, 90061902, 2, 320x180 
0x1382CA98, 37353950207617736, 90061969, 90061970, 1, 320x180 
0x1382CA98, 37353950208264080, 90062024, 90062028, 4, 320x180 
0x1382CA98, 37353950208898440, 90062089, 90062098, 9, 320x180 
0x1382CA98, 37353950209539616, 90062159, 90062162, 3, 320x180 
0x1382CA98, 37353950210341872, 90062235, 90062238, 3, 320x180 
0x1382CA98, 37353950210977328, 90062305, 90062306, 1, 320x180 
0x1382CA98, 37353950211618312, 90062366, 90062372, 6, 320x180 
0x1382CA98, 37353950212264584, 90062422, 90062423, 1, 320x180 
0x1382CA98, 37353950212904224, 90062494, 90062496, 2, 320x180 
0x1382CA98, 37353950213538368, 90062553, 90062555, 2, 320x180 
0x1382CA98, 37353950214337640, 90062643, 90062647, 4, 320x180 
0x1382CA98, 37353950214977648, 90062696, 90062698, 2, 320x180 
0x1382CA98, 37353950215619424, 90062767, 90062768, 1, 320x180 
0x1382CA98, 37353950216280328, 90062825, 90062840, 15, 320x180 
0x1382CA98, 37353950216900488, 90062893, 90062903, 10, 320x180 
0x1382CA98, 37353950217537736, 90062965, 90062973, 8, 320x180 
0x1382CA98, 37353950218181352, 90063044, 90063047, 3, 320x180 
0x1382CA98, 37353950219037344, 90063131, 90063136, 5, 320x180 
0x1382CA98, 37353950219628016, 90063175, 90063210, 35, 320x180 
0x1382CA98, 37353950220277072, 90063259, 90063268, 9, 320x180 
0x1382CA98, 37353950220941960, 90063320, 90063326, 6, 320x180 
0x1382CA98, 37353950221543576, 90063370, 90063372, 2, 320x180 
0x1382CA98, 37353950222211128, 90063444, 90063447, 3, 320x180 
0x1382CA98, 37353950222981648, 90063512, 90063516, 4, 320x180 
0x1382CA98, 37353950223618264, 90063560, 90063571, 11, 320x180 
0x1382CA98, 37353950224298768, 90063645, 90063646, 1, 320x180 
0x1382CA98, 37353950224897168, 90063696, 90063699, 3, 320x180 
0x1382CA98, 37353950225537272, 90063753, 90063754, 1, 320x180 
0x1382CA98, 37353950226184144, 90063814, 90063820, 6, 320x180 
0x1382CA98, 37353950226977400, 90063894, 90063905, 11, 320x180 
0x1382CA98, 37353950227645792, 90063967, 90063980, 13, 320x180 
0x1382CA98, 37353950228278488, 90064043, 90064053, 10, 320x180 
0x1382CA98, 37353950228897664, 90064104, 90064112, 8, 320x180 
0x1382CA98, 37353950229538816, 90064159, 90064168, 9, 320x180 
0x1382CA98, 37353950230179304, 90064221, 90064223, 2, 320x180 
0x1382CA98, 37353950230979904, 90064293, 90064295, 2, 320x180 
0x1382CA98, 37353950231619264, 90064359, 90064367, 8, 320x180 
0x1382CA98, 37353950232257784, 90064431, 90064432, 1, 320x180 
0x1382CA98, 37353950232897232, 90064494, 90064497, 3, 320x180 
0x1382CA98, 37353950233537496, 90064556, 90064558, 2, 320x180 
0x1382CA98, 37353950234182160, 90064626, 90064628, 2, 320x180 
0x1382CA98, 37353950234977000, 90064701, 90064703, 2, 320x180 
0x1382CA98, 37353950235617344, 90064765, 90064766, 1, 320x180 
0x1382CA98, 37353950236263344, 90064831, 90064837, 6, 320x180 
0x1382CA98, 37353950236897624, 90064888, 90064891, 3, 320x180 
0x1382CA98, 37353950237537816, 90064961, 90064963, 2, 320x180 
0x1382CA98, 37353950238179432, 90065022, 90065024, 2, 320x180 
0x1382CA98, 37353950238977608, 90065090, 90065096, 6, 320x180 
0x1382CA98, 37353950239619192, 90065168, 90065169, 1, 320x180 
0x1382CA98, 37353950240261928, 90065226, 90065234, 8, 320x180 
0x1382CA98, 37353950240900584, 90065285, 90065287, 2, 320x180 
0x1382CA98, 37353950241540616, 90065357, 90065361, 4, 320x180 
0x1382CA98, 37353950242185184, 90065418, 90065420, 2, 320x180 
0x1382CA98, 37353950242977896, 90065500, 90065501, 1, 320x180 
0x1382CA98, 37353950243619352, 90065559, 90065564, 5, 320x180 
0x1382CA98, 37353950244288008, 90065633, 90065635, 2, 320x180 
0x1382CA98, 37353950244896560, 90065688, 90065689, 1, 320x180 
0x1382CA98, 37353950245546864, 90065753, 90065754, 1, 320x180 
0x1382CA98, 37353950246177512, 90065827, 90065837, 10, 320x180 
0x1382CA98, 37353950246976816, 90065889, 90065892, 3, 320x180 
0x1382CA98, 37353950247621704, 90065959, 90065962, 3, 320x180 
0x1382CA98, 37353950248261720, 90066022, 90066025, 3, 320x180 
0x1382CA98, 37353950248900624, 90066094, 90066097, 3, 320x180 
0x1382CA98, 37353950249537560, 90066152, 90066154, 2, 320x180 
0x1382CA98, 37353950250176912, 90066214, 90066221, 7, 320x180 
0x1382CA98, 37353950250979344, 90066304, 90066306, 2, 320x180 
0x1382CA98, 37353950251618000, 90066361, 90066367, 6, 320x180 
0x1382CA98, 37353950252263536, 90066421, 90066423, 2, 320x180 
0x1382CA98, 37353950252896832, 90066487, 90066488, 1, 320x180 
0x1382CA98, 37353950253541080, 90066552, 90066553, 1, 320x180 
0x1382CA98, 37353950254178000, 90066628, 90066629, 1, 320x180 
0x1382CA98, 37353950254981208, 90066702, 90066710, 8, 320x180 
0x1382CA98, 37353950255617088, 90066755, 90066757, 2, 320x180 
0x1382CA98, 37353950256281264, 90066826, 90066829, 3, 320x180 
0x1382CA98, 37353950256905280, 90066887, 90066893, 6, 320x180 
0x1382CA98, 37353950257536624, 90066948, 90066956, 8, 320x180 
0x1382CA98, 37353950258177448, 90067015, 90067018, 3, 320x180 
0x1382CA98, 37353950258976096, 90067091, 90067103, 12, 320x180 
0x1382CA98, 37353950259635328, 90067169, 90067171, 2, 320x180 
0x1382CA98, 37353950260260696, 90067223, 90067226, 3, 320x180 
0x1382CA98, 37353950260896408, 90067294, 90067300, 6, 320x180 
0x1382CA98, 37353950261536288, 90067349, 90067353, 4, 320x180 
0x1382CA98, 37353950262176768, 90067418, 90067423, 5, 320x180 
0x1382CA98, 37353950262976432, 90067490, 90067492, 2, 320x180 
0x1382CA98, 37353950263617032, 90067563, 90067564, 1, 320x180 
0x1382CA98, 37353950264279976, 90067629, 90067635, 6, 320x180 
0x1382CA98, 37353950264901744, 90067686, 90067687, 1, 320x180 
0x1382CA98, 37353950265536832, 90067764, 90067771, 7, 320x180 
0x1382CA98, 37353950266180448, 90067818, 90067819, 1, 320x180 
0x1382CA98, 37353950266977592, 90067905, 90067907, 2, 320x180 
0x1382CA98, 37353950267618664, 90067960, 90067969, 9, 320x180 
0x1382CA98, 37353950268262392, 90068029, 90068034, 5, 320x180 
0x1382CA98, 37353950268895976, 90068087, 90068088, 1, 320x180 
0x1382CA98, 37353950269544312, 90068150, 90068151, 1, 320x180 
0x1382CA98, 37353950270177120, 90068222, 90068224, 2, 320x180 
0x1382CA98, 37353950270816952, 90068283, 90068285, 2, 320x180 
0x1382CA98, 37353950271638944, 90068367, 90068368, 1, 320x180 
0x1382CA98, 37353950272260168, 90068424, 90068437, 13, 320x180 
0x1382CA98, 37353950272901528, 90068489, 90068490, 1, 320x180 
0x1382CA98, 37353950273536520, 90068552, 90068555, 3, 320x180 
0x1382CA98, 37353950274180896, 90068615, 90068622, 7, 320x180 
0x1382CA98, 37353950274819904, 90068688, 90068691, 3, 320x180 
0x1382CA98, 37353950275631624, 90068767, 90068769, 2, 320x180 
0x1382CA98, 37353950276256848, 90068824, 90068836, 12, 320x180 
0x1382CA98, 37353950276896120, 90068893, 90068900, 7, 320x180 
0x1382CA98, 37353950277536720, 90068949, 90068951, 2, 320x180 
0x1382CA98, 37353950278188248, 90069016, 90069018, 2, 320x180 
0x1382CA98, 37353950278822304, 90069094, 90069096, 2, 320x180 
0x1382CA98, 37353950279622376, 90069169, 90069170, 1, 320x180 
0x1382CA98, 37353950280261304, 90069227, 90069228, 1, 320x180 
0x1382CA98, 37353950280896064, 90069290, 90069291, 1, 320x180 
0x1382CA98, 37353950281544392, 90069352, 90069359, 7, 320x180 
0x1382CA98, 37353950282181200, 90069416, 90069422, 6, 320x180 
0x1382CA98, 37353950282816608, 90069483, 90069484, 1, 320x180 
0x1382CA98, 37353950283615992, 90069561, 90069563, 2, 320x180 
0x1382CA98, 37353950284259192, 90069622, 90069624, 2, 320x180 
0x1382CA98, 37353950284896528, 90069685, 90069688, 3, 320x180 
0x1382CA98, 37353950285535568, 90069754, 90069755, 1, 320x180 
0x1382CA98, 37353950286178328, 90069815, 90069818, 3, 320x180 
0x1382CA98, 37353950286820344, 90069882, 90069884, 2, 320x180 
0x1382CA98, 37353950287619648, 90069956, 90069958, 2, 320x180 
0x1382CA98, 37353950288281312, 90070024, 90070025, 1, 320x180 
0x1382CA98, 37353950288900728, 90070087, 90070088, 1, 320x180 
0x1382CA98, 37353950289536664, 90070148, 90070153, 5, 320x180 
0x1382CA98, 37353950290179016, 90070214, 90070215, 1, 320x180 
0x1382CA98, 37353950290816904, 90070280, 90070286, 6, 320x180 
0x1382CA98, 37353950291628848, 90070366, 90070369, 3, 320x180 
0x1382CA98, 37353950292259176, 90070431, 90070437, 6, 320x180 
0x1382CA98, 37353950292899352, 90070487, 90070489, 2, 320x180 
0x1382CA98, 37353950293545400, 90070564, 90070577, 13, 320x180 
0x1382CA98, 37353950294176208, 90070619, 90070621, 2, 320x180 
0x1382CA98, 37353950294819416, 90070690, 90070697, 7, 320x180 
0x1382CA98, 37353950295619256, 90070760, 90070768, 8, 320x180 
0x1382CA98, 37353950296260464, 90070821, 90070822, 1, 320x180 
0x1382CA98, 37353950296896208, 90070892, 90070902, 10, 320x180 
0x1382CA98, 37353950297536192, 90070948, 90070955, 7, 320x180 
0x1382CA98, 37353950298183248, 90071013, 90071021, 8, 320x180 
0x1382CA98, 37353950298823424, 90071084, 90071086, 2, 320x180 
0x1382CA98, 37353950299624920, 90071162, 90071170, 8, 320x180 
0x1382CA98, 37353950300256360, 90071221, 90071222, 1, 320x180 
0x1382CA98, 37353950300899624, 90071292, 90071295, 3, 320x180 
0x1382CA98, 37353950301535344, 90071347, 90071349, 2, 320x180 
0x1382CA98, 37353950302189496, 90071421, 90071422, 1, 320x180 
0x1382CA98, 37353950302829464, 90071492, 90071496, 4, 320x180 
0x1382CA98, 37353950303617680, 90071565, 90071572, 7, 320x180 
0x1382CA98, 37353950304282144, 90071635, 90071637, 2, 320x180 
0x1382CA98, 37353950304895960, 90071699, 90071700, 1, 320x180 
0x1382CA98, 37353950305540616, 90071755, 90071757, 2, 320x180 
0x1382CA98, 37353950306180968, 90071816, 90071817, 1, 320x180 
0x1382CA98, 37353950306816168, 90071883, 90071885, 2, 320x180 
0x1382CA98, 37353950307620640, 90071955, 90071958, 3, 320x180 
0x1382CA98, 37353950308284432, 90072030, 90072032, 2, 320x180 
0x1382CA98, 37353950308894696, 90072094, 90072097, 3, 320x180 
0x1382CA98, 37353950309538600, 90072152, 90072154, 2, 320x180 
0x1382CA98, 37353950310178888, 90072215, 90072217, 2, 320x180 
0x1382CA98, 37353950310824880, 90072294, 90072296, 2, 320x180 
0x1382CA98, 37353950311619568, 90072363, 90072364, 1, 320x180 
0x1382CA98, 37353950312257160, 90072426, 90072431, 5, 320x180 
0x1382CA98, 37353950312901584, 90072489, 90072494, 5, 320x180 
0x1382CA98, 37353950313535520, 90072553, 90072555, 2, 320x180 
0x1382CA98, 37353950314175672, 90072623, 90072628, 5, 320x180 
0x1382CA98, 37353950314828840, 90072683, 90072685, 2, 320x180 
0x1382CA98, 37353950315618416, 90072765, 90072766, 1, 320x180 
0x1382CA98, 37353950316264424, 90072822, 90072824, 2, 320x180 
0x1382CA98, 37353950316895152, 90072891, 90072895, 4, 320x180 
0x1382CA98, 37353950317550080, 90072964, 90072966, 2, 320x180 
0x1382CA98, 37353950318175696, 90073015, 90073017, 2, 320x180 
0x1382CA98, 37353950318818208, 90073088, 90073095, 7, 320x180 
0x1382CA98, 37353950319619560, 90073158, 90073165, 7, 320x180 
0x1382CA98, 37353950320254416, 90073222, 90073223, 1, 320x180 
0x1382CA98, 37353950320894848, 90073289, 90073291, 2, 320x180 
0x1382CA98, 37353950321541560, 90073349, 90073351, 2, 320x180 
0x1382CA98, 37353950322179392, 90073423, 90073428, 5, 320x180 
0x1382CA98, 37353950322815752, 90073476, 90073483, 7, 320x180 
0x1382CA98, 37353950323460008, 90073544, 90073547, 3, 320x180 
0x1382CA98, 37353950324278360, 90073633, 90073635, 2, 320x180 
0x1382CA98, 37353950324897248, 90073682, 90073685, 3, 320x180 
0x1382CA98, 37353950325536280, 90073756, 90073757, 1, 320x180 
0x1382CA98, 37353950326175392, 90073821, 90073822, 1, 320x180 
0x1382CA98, 37353950326819072, 90073885, 90073886, 1, 320x180 
0x1382CA98, 37353950327460008, 90073947, 90073955, 8, 320x180 
0x1382CA98, 37353950328259112, 90074028, 90074030, 2, 320x180 
0x1382CA98, 37353950328898208, 90074099, 90074108, 9, 320x180 
0x1382CA98, 37353950329538584, 90074158, 90074162, 4, 320x180 
0x1382CA98, 37353950330179680, 90074216, 90074218, 2, 320x180 
0x1382CA98, 37353950330822048, 90074276, 90074288, 12, 320x180 
0x1382CA98, 37353950331455472, 90074340, 90074343, 3, 320x180 
0x1382CA98, 37353950332258520, 90074431, 90074433, 2, 320x180 
0x1382CA98, 37353950332900648, 90074495, 90074497, 2, 320x180 
0x1382CA98, 37353950333536952, 90074551, 90074552, 1, 320x180 
0x1382CA98, 37353950334180144, 90074616, 90074618, 2, 320x180 
0x1382CA98, 37353950334819112, 90074685, 90074686, 1, 320x180 
0x1382CA98, 37353950335455312, 90074756, 90074758, 2, 320x180 
0x1382CA98, 37353950336269080, 90074828, 90074831, 3, 320x180 
0x1382CA98, 37353950336895008, 90074890, 90074891, 1, 320x180 
0x1382CA98, 37353950337535016, 90074950, 90074962, 12, 320x180 
0x1382CA98, 37353950338179200, 90075024, 90075034, 10, 320x180 
0x1382CA98, 37353950338819712, 90075098, 90075103, 5, 320x180 
0x1382CA98, 37353950339472208, 90075151, 90075158, 7, 320x180 
0x1382CA98, 37353950340282952, 90075293, 90075322, 29, 320x180 
0x1382CA98, 37353950341462424, 90075373, 90075388, 15, 320x180 
0x1382CA98, 37353950341990888, 90075428, 90075431, 3, 320x180 
0x1382CA98, 37353950342494752, 90075462, 90075464, 2, 320x180 
0x1382CA98, 37353950343153168, 90075523, 90075525, 2, 320x180 
0x1382CA98, 37353950343943720, 90075609, 90075615, 6, 320x180 
0x1382CA98, 37353950344621048, 90075670, 90075671, 1, 320x180 
0x1382CA98, 37353950345215960, 90075729, 90075735, 6, 320x180 
0x1382CA98, 37353950345855536, 90075790, 90075793, 3, 320x180 
0x1382CA98, 37353950346496840, 90075857, 90075863, 6, 320x180 
0x1382CA98, 37353950347149600, 90075920, 90075921, 1, 320x180 
0x1382CA98, 37353950347948104, 90075990, 90076001, 11, 320x180 
0x1382CA98, 37353950348573904, 90076069, 90076070, 1, 320x180 
0x1382CA98, 37353950349222648, 90076118, 90076120, 2, 320x180 
0x1382CA98, 37353950349854848, 90076195, 90076198, 3, 320x180 
0x1382CA98, 37353950350494920, 90076249, 90076255, 6, 320x180 
0x1382CA98, 37353950351138304, 90076309, 90076314, 5, 320x180 
0x1382CA98, 37353950352257640, 90076426, 90076437, 11, 320x180 
0x1382CA98, 37353950352893696, 90076494, 90076496, 2, 320x180 
0x1382CA98, 37353950353535128, 90076558, 90076563, 5, 320x180 
0x1382CA98, 37353950354188680, 90076627, 90076629, 2, 320x180 
0x1382CA98, 37353950354813960, 90076686, 90076687, 1, 320x180 
0x1382CA98, 37353950355458040, 90076746, 90076755, 9, 320x180 
0x1382CA98, 37353950356283056, 90076830, 90076834, 4, 320x180 
0x1382CA98, 37353950356893448, 90076896, 90076898, 2, 320x180 
0x1382CA98, 37353950357533616, 90076952, 90076953, 1, 320x180 
0x1382CA98, 37353950358185712, 90077019, 90077025, 6, 320x180 
0x1382CA98, 37353950358815168, 90077082, 90077083, 1, 320x180 
0x1382CA98, 37353950359483080, 90077149, 90077150, 1, 320x180 
0x1382CA98, 37353950360257968, 90077229, 90077231, 2, 320x180 
0x1382CA98, 37353950360894400, 90077298, 90077300, 2, 320x180 
0x1382CA98, 37353950361538728, 90077369, 90077382, 13, 320x180 
0x1382CA98, 37353950362173976, 90077422, 90077423, 1, 320x180 
0x1382CA98, 37353950362813952, 90077490, 90077491, 1, 320x180 
0x1382CA98, 37353950363453904, 90077540, 90077543, 3, 320x180 
0x1382CA98, 37353950364257528, 90077628, 90077636, 8, 320x180 
0x1382CA98, 37353950364893184, 90077694, 90077697, 3, 320x180 
0x1382CA98, 37353950365533840, 90077758, 90077762, 4, 320x180 
0x1382CA98, 37353950366174424, 90077811, 90077821, 10, 320x180 
0x1382CA98, 37353950366816848, 90077877, 90077880, 3, 320x180 
0x1382CA98, 37353950367453992, 90077937, 90077939, 2, 320x180 
0x1382CA98, 37353950368253784, 90078027, 90078030, 3, 320x180 
0x1382CA98, 37353950368898304, 90078088, 90078090, 2, 320x180 
0x1382CA98, 37353950369533616, 90078149, 90078151, 2, 320x180 
0x1382CA98, 37353950370173784, 90078215, 90078221, 6, 320x180 
0x1382CA98, 37353950370818368, 90078289, 90078290, 1, 320x180 
0x1382CA98, 37353950371460720, 90078366, 90078368, 2, 320x180 
0x1382CA98, 37353950372258600, 90078440, 90078444, 4, 320x180 
0x1382CA98, 37353950372899568, 90078488, 90078490, 2, 320x180 
0x1382CA98, 37353950373538504, 90078562, 90078563, 1, 320x180 
0x1382CA98, 37353950374177264, 90078631, 90078633, 2, 320x180 
0x1382CA98, 37353950374813472, 90078686, 90078687, 1, 320x180 
0x1382CA98, 37353950375453584, 90078746, 90078752, 6, 320x180 
0x1382CA98, 37353950376102024, 90078805, 90078807, 2, 320x180 
0x1382CA98, 37353950376898896, 90078888, 90078890, 2, 320x180 
0x1382CA98, 37353950377532944, 90078957, 90078960, 3, 320x180 
0x1382CA98, 37353950378174832, 90079017, 90079019, 2, 320x180 
0x1382CA98, 37353950378816112, 90079086, 90079088, 2, 320x180 
0x1382CA98, 37353950379502520, 90079164, 90079172, 8, 320x180 
0x1382CA98, 37353950380099160, 90079227, 90079236, 9, 320x180 
0x1382CA98, 37353950380895480, 90079298, 90079305, 7, 320x180 
0x1382CA98, 37353950381544832, 90079353, 90079360, 7, 320x180 
0x1382CA98, 37353950382172904, 90079419, 90079421, 2, 320x180 
0x1382CA98, 37353950382814592, 90079487, 90079488, 1, 320x180 
0x1382CA98, 37353950383470208, 90079560, 90079579, 19, 320x180 
0x1382CA98, 37353950384139216, 90079621, 90079633, 12, 320x180 
0x1382CA98, 37353950384942408, 90079705, 90079707, 2, 320x180 
0x1382CA98, 37353950385537224, 90079767, 90079769, 2, 320x180 
0x1382CA98, 37353950386172752, 90079818, 90079820, 2, 320x180 
0x1382CA98, 37353950386813280, 90079892, 90079895, 3, 320x180 
0x1382CA98, 37353950387482344, 90079956, 90079959, 3, 320x180 
0x1382CA98, 37353950388122520, 90080021, 90080023, 2, 320x180 
0x1382CA98, 37353950388897448, 90080090, 90080091, 1, 320x180 
0x1382CA98, 37353950389533192, 90080153, 90080154, 1, 320x180 
0x1382CA98, 37353950390173984, 90080218, 90080219, 1, 320x180 
0x1382CA98, 37353950390813280, 90080277, 90080279, 2, 320x180 
0x1382CA98, 37353950391454112, 90080349, 90080351, 2, 320x180 
0x1382CA98, 37353950392106232, 90080406, 90080409, 3, 320x180 
0x1382CA98, 37353950392893160, 90080500, 90080501, 1, 320x180 
0x1382CA98, 37353950393532440, 90080558, 90080562, 4, 320x180 
0x1382CA98, 37353950394173128, 90080616, 90080619, 3, 320x180 
0x1382CA98, 37353950394816864, 90080679, 90080689, 10, 320x180 
0x1382CA98, 37353950395454912, 90080739, 90080741, 2, 320x180 
0x1382CA98, 37353950396099704, 90080806, 90080807, 1, 320x180 
0x1382CA98, 37353950396899480, 90080896, 90080898, 2, 320x180 
0x1382CA98, 37353950397533056, 90080950, 90080954, 4, 320x180 
0x1382CA98, 37353950398204680, 90081020, 90081021, 1, 320x180 
0x1382CA98, 37353950398830600, 90081086, 90081087, 1, 320x180 
0x1382CA98, 37353950399530264, 90081150, 90081155, 5, 320x180 
0x1382CA98, 37353950400098952, 90081210, 90081213, 3, 320x180 
0x1382CA98, 37353950400897600, 90081292, 90081295, 3, 320x180 
0x1382CA98, 37353950401533032, 90081352, 90081353, 1, 320x180 
0x1382CA98, 37353950402172456, 90081418, 90081423, 5, 320x180 
0x1382CA98, 37353950402814000, 90081476, 90081479, 3, 320x180 
0x1382CA98, 37353950403457408, 90081540, 90081542, 2, 320x180 
0x1382CA98, 37353950404103112, 90081612, 90081617, 5, 320x180 
0x1382CA98, 37353950404891992, 90081696, 90081703, 7, 320x180 
0x1382CA98, 37353950405532280, 90081755, 90081761, 6, 320x180 
0x1382CA98, 37353950406172616, 90081825, 90081840, 15, 320x180 
0x1382CA98, 37353950406818312, 90081885, 90081894, 9, 320x180 
0x1382CA98, 37353950407516304, 90081966, 90081978, 12, 320x180 
0x1382CA98, 37353950408095536, 90082009, 90082013, 4, 320x180 
0x1382CA98, 37353950408891880, 90082090, 90082092, 2, 320x180 
0x1382CA98, 37353950409532560, 90082162, 90082171, 9, 320x180 
0x1382CA98, 37353950410176216, 90082216, 90082218, 2, 320x180 
0x1382CA98, 37353950410815528, 90082285, 90082286, 1, 320x180 
0x1382CA98, 37353950411462920, 90082348, 90082354, 6, 320x180 
0x1382CA98, 37353950412100744, 90082409, 90082420, 11, 320x180 
0x1382CA98, 37353950412892472, 90082490, 90082492, 2, 320x180 
0x1382CA98, 37353950413536728, 90082555, 90082560, 5, 320x180 
0x1382CA98, 37353950414172144, 90082617, 90082619, 2, 320x180 
0x1382CA98, 37353950414816528, 90082689, 90082690, 1, 320x180 
0x1382CA98, 37353950415453800, 90082741, 90082746, 5, 320x180 
0x1382CA98, 37353950416105296, 90082805, 90082808, 3, 320x180 
0x1382CA98, 37353950416892640, 90082905, 90082917, 12, 320x180 
0x1382CA98, 37353950417534480, 90082959, 90082962, 3, 320x180 
0x1382CA98, 37353950418171792, 90083016, 90083018, 2, 320x180 
0x1382CA98, 37353950418827608, 90083082, 90083083, 1, 320x180 
0x1382CA98, 37353950419473688, 90083154, 90083156, 2, 320x180 
0x1382CA98, 37353950420098008, 90083226, 90083230, 4, 320x180 
0x1382CA98, 37353950420892400, 90083313, 90083330, 17, 320x180 
0x1382CA98, 37353950421533952, 90083381, 90083386, 5, 320x180 
0x1382CA98, 37353950422197968, 90083436, 90083438, 2, 320x180 
0x1382CA98, 37353950422817056, 90083500, 90083502, 2, 320x180 
0x1382CA98, 37353950423506056, 90083590, 90083605, 15, 320x180 
0x1382CA98, 37353950424119928, 90083665, 90083667, 2, 320x180 
0x1382CA98, 37353950425216360, 90083749, 90083754, 5, 320x180 
0x1382CA98, 37353950425859120, 90083790, 90083792, 2, 320x180 
0x1382CA98, 37353950426498456, 90083856, 90083857, 1, 320x180 
0x1382CA98, 37353950427137680, 90083925, 90083938, 13, 320x180 
0x1382CA98, 37353950427780528, 90083982, 90083989, 7, 320x180 
0x1382CA98, 37353950428412752, 90084050, 90084061, 11, 320x180 
0x1382CA98, 37353950429217928, 90084121, 90084122, 1, 320x180 
0x1382CA98, 37353950429851600, 90084182, 90084191, 9, 320x180 
0x1382CA98, 37353950430499152, 90084249, 90084251, 2, 320x180 
0x1382CA98, 37353950431131776, 90084313, 90084314, 1, 320x180 
0x1382CA98, 37353950431790648, 90084374, 90084385, 11, 320x180 
0x1382CA98, 37353950432413160, 90084452, 90084462, 10, 320x180 
0x1382CA98, 37353950433214840, 90084540, 90084546, 6, 320x180 
0x1382CA98, 37353950433864016, 90084585, 90084587, 2, 320x180 
0x1382CA98, 37353950434498392, 90084652, 90084653, 1, 320x180 
0x1382CA98, 37353950435131632, 90084707, 90084711, 4, 320x180 
0x1382CA98, 37353950435778856, 90084771, 90084774, 3, 320x180 
0x1382CA98, 37353950436421800, 90084837, 90084839, 2, 320x180 
0x1382CA98, 37353950437211592, 90084924, 90084934, 10, 320x180 
0x1382CA98, 37353950437852256, 90084983, 90084985, 2, 320x180 
0x1382CA98, 37353950438492384, 90085049, 90085051, 2, 320x180 
0x1382CA98, 37353950439132176, 90085122, 90085129, 7, 320x180 
0x1382CA98, 37353950439778776, 90085184, 90085185, 1, 320x180 
0x1382CA98, 37353950440412448, 90085240, 90085242, 2, 320x180 
0x1382CA98, 37353950441211216, 90085323, 90085324, 1, 320x180 
0x1382CA98, 37353950441851672, 90085382, 90085388, 6, 320x180 
0x1382CA98, 37353950442494160, 90085448, 90085455, 7, 320x180 
0x1382CA98, 37353950443132568, 90085513, 90085519, 6, 320x180 
0x1382CA98, 37353950443779704, 90085577, 90085584, 7, 320x180 
0x1382CA98, 37353950444414232, 90085646, 90085652, 6, 320x180 
0x1382CA98, 37353950445210904, 90085721, 90085722, 1, 320x180 
0x1382CA98, 37353950445851112, 90085790, 90085792, 2, 320x180 
0x1382CA98, 37353950446491216, 90085856, 90085857, 1, 320x180 
0x1382CA98, 37353950447131600, 90085920, 90085925, 5, 320x180 
0x1382CA98, 37353950447810680, 90085985, 90085986, 1, 320x180 
0x1382CA98, 37353950448412888, 90086051, 90086056, 5, 320x180 
0x1382CA98, 37353950449210944, 90086131, 90086133, 2, 320x180 
0x1382CA98, 37353950449851736, 90086184, 90086185, 1, 320x180 
0x1382CA98, 37353950450505512, 90086256, 90086257, 1, 320x180 
0x1382CA98, 37353950451141928, 90086317, 90086319, 2, 320x180 
0x1382CA98, 37353950451783728, 90086384, 90086385, 1, 320x180 
0x1382CA98, 37353950452413768, 90086446, 90086448, 2, 320x180 
0x1382CA98, 37353950453210880, 90086524, 90086528, 4, 320x180 
0x1382CA98, 37353950453856160, 90086582, 90086585, 3, 320x180 
0x1382CA98, 37353950454497472, 90086674, 90086682, 8, 320x180 
0x1382CA98, 37353950455137288, 90086725, 90086736, 11, 320x180 
0x1382CA98, 37353950455772104, 90086775, 90086788, 13, 320x180 
0x1382CA98, 37353950456419408, 90086836, 90086838, 2, 320x180 
0x1382CA98, 37353950457216032, 90086920, 90086933, 13, 320x180 
0x1382CA98, 37353950457851832, 90086984, 90086986, 2, 320x180 
0x1382CA98, 37353950458495408, 90087057, 90087062, 5, 320x180 
0x1382CA98, 37353950459135104, 90087123, 90087131, 8, 320x180 
0x1382CA98, 37353950459778488, 90087178, 90087185, 7, 320x180 
0x1382CA98, 37353950460412616, 90087244, 90087247, 3, 320x180 
0x1382CA98, 37353950461051328, 90087309, 90087313, 4, 320x180 
0x1382CA98, 37353950461851312, 90087381, 90087387, 6, 320x180 
0x1382CA98, 37353950462503448, 90087453, 90087455, 2, 320x180 
0x1382CA98, 37353950463131448, 90087518, 90087523, 5, 320x180 
0x1382CA98, 37353950463783088, 90087590, 90087614, 24, 320x180 
0x1382CA98, 37353950464412528, 90087647, 90087649, 2, 320x180 
0x1382CA98, 37353950465053816, 90087704, 90087705, 1, 320x180 
0x1382CA98, 37353950465854968, 90087787, 90087788, 1, 320x180 
0x1382CA98, 37353950466495440, 90087846, 90087850, 4, 320x180 
0x1382CA98, 37353950467131480, 90087921, 90087922, 1, 320x180 
0x1382CA98, 37353950467786728, 90087978, 90087983, 5, 320x180 
0x1382CA98, 37353950468413712, 90088040, 90088042, 2, 320x180 
0x1382CA98, 37353950469052216, 90088107, 90088111, 4, 320x180 
0x1382CA98, 37353950469855680, 90088191, 90088194, 3, 320x180 
0x1382CA98, 37353950470491512, 90088245, 90088248, 3, 320x180 
0x1382CA98, 37353950471131600, 90088315, 90088321, 6, 320x180 
0x1382CA98, 37353950471770976, 90088372, 90088374, 2, 320x180 
0x1382CA98, 37353950472412064, 90088451, 90088452, 1, 320x180 
0x1382CA98, 37353950473051712, 90088506, 90088509, 3, 320x180 
0x1382CA98, 37353950473851200, 90088582, 90088587, 5, 320x180 
0x1382CA98, 37353950474495888, 90088642, 90088645, 3, 320x180 
0x1382CA98, 37353950475133808, 90088723, 90088730, 7, 320x180 
0x1382CA98, 37353950475776288, 90088780, 90088787, 7, 320x180 
0x1382CA98, 37353950476413128, 90088849, 90088853, 4, 320x180 
0x1382CA98, 37353950477058568, 90088907, 90088911, 4, 320x180 
0x1382CA98, 37353950477854720, 90088990, 90088991, 1, 320x180 
0x1382CA98, 37353950478494928, 90089052, 90089053, 1, 320x180 
0x1382CA98, 37353950479134936, 90089116, 90089120, 4, 320x180 
0x1382CA98, 37353950479776600, 90089178, 90089186, 8, 320x180 
0x1382CA98, 37353950480414456, 90089240, 90089243, 3, 320x180 
0x1382CA98, 37353950481054848, 90089307, 90089312, 5, 320x180 
0x1382CA98, 37353950481854936, 90089388, 90089389, 1, 320x180 
0x1382CA98, 37353950482492888, 90089449, 90089451, 2, 320x180 
0x1382CA98, 37353950483130832, 90089513, 90089521, 8, 320x180 
0x1382CA98, 37353950483775880, 90089574, 90089580, 6, 320x180 
0x1382CA98, 37353950484414872, 90089643, 90089651, 8, 320x180 
0x1382CA98, 37353950485051448, 90089702, 90089707, 5, 320x180 
0x1382CA98, 37353950485854104, 90089778, 90089786, 8, 320x180 
0x1382CA98, 37353950486492184, 90089861, 90089862, 1, 320x180 
0x1382CA98, 37353950487143272, 90089922, 90089924, 2, 320x180 
0x1382CA98, 37353950487777824, 90089979, 90089988, 9, 320x180 
0x1382CA98, 37353950488411320, 90090050, 90090056, 6, 320x180 
0x1382CA98, 37353950489054224, 90090114, 90090116, 2, 320x180 
0x1382CA98, 37353950489861392, 90090195, 90090198, 3, 320x180 
0x1382CA98, 37353950490503144, 90090249, 90090259, 10, 320x180 
0x1382CA98, 37353950491130848, 90090318, 90090324, 6, 320x180 
0x1382CA98, 37353950491776184, 90090380, 90090383, 3, 320x180 
0x1382CA98, 37353950492417976, 90090446, 90090453, 7, 320x180 
0x1382CA98, 37353950493050416, 90090512, 90090520, 8, 320x180 
0x1382CA98, 37353950493855992, 90090585, 90090587, 2, 320x180 
0x1382CA98, 37353950494491544, 90090657, 90090658, 1, 320x180 
0x1382CA98, 37353950495129936, 90090723, 90090725, 2, 320x180 
0x1382CA98, 37353950495785920, 90090781, 90090785, 4, 320x180 
0x1382CA98, 37353950496415296, 90090847, 90090854, 7, 320x180 
0x1382CA98, 37353950497050456, 90090910, 90090913, 3, 320x180 
0x1382CA98, 37353950497877432, 90090987, 90090988, 1, 320x180 
0x1382CA98, 37353950498497584, 90091048, 90091056, 8, 320x180 
0x1382CA98, 37353950499133920, 90091117, 90091119, 2, 320x180 
0x1382CA98, 37353950499782512, 90091181, 90091188, 7, 320x180 
0x1382CA98, 37353950500410792, 90091249, 90091256, 7, 320x180 
0x1382CA98, 37353950501050032, 90091308, 90091312, 4, 320x180 
0x1382CA98, 37353950501853392, 90091398, 90091401, 3, 320x180 
0x1382CA98, 37353950502490344, 90091448, 90091455, 7, 320x180 
0x1382CA98, 37353950503130096, 90091513, 90091527, 14, 320x180 
0x1382CA98, 37353950503774592, 90091582, 90091583, 1, 320x180 
0x1382CA98, 37353950504416032, 90091657, 90091660, 3, 320x180 
0x1382CA98, 37353950505058976, 90091713, 90091717, 4, 320x180 
0x1382CA98, 37353950505849176, 90091790, 90091795, 5, 320x180 
0x1382CA98, 37353950506498208, 90091855, 90091856, 1, 320x180 
0x1382CA98, 37353950507134624, 90091911, 90091919, 8, 320x180 
0x1382CA98, 37353950507779096, 90091979, 90091988, 9, 320x180 
0x1382CA98, 37353950508440712, 90092048, 90092053, 5, 320x180 
0x1382CA98, 37353950509051216, 90092114, 90092124, 10, 320x180 
0x1382CA98, 37353950509853040, 90092187, 90092188, 1, 320x180 
0x1382CA98, 37353950510495896, 90092252, 90092258, 6, 320x180 
0x1382CA98, 37353950511134920, 90092311, 90092313, 2, 320x180 
0x1382CA98, 37353950511776312, 90092375, 90092382, 7, 320x180 
0x1382CA98, 37353950512410024, 90092447, 90092450, 3, 320x180 
0x1382CA98, 37353950513053360, 90092514, 90092516, 2, 320x180 
0x1382CA98, 37353950513695288, 90092567, 90092568, 1, 320x180 
0x1382CA98, 37353950514490184, 90092643, 90092646, 3, 320x180 
0x1382CA98, 37353950515129784, 90092715, 90092717, 2, 320x180 
0x1382CA98, 37353950515778040, 90092775, 90092777, 2, 320x180 
0x1382CA98, 37353950516456712, 90092842, 90092843, 1, 320x180 
0x1382CA98, 37353950517050544, 90092900, 90092902, 2, 320x180 
0x1382CA98, 37353950517710504, 90092972, 90092975, 3, 320x180 
0x1382CA98, 37353950518491680, 90093052, 90093056, 4, 320x180 
0x1382CA98, 37353950519129240, 90093111, 90093121, 10, 320x180 
0x1382CA98, 37353950519769280, 90093175, 90093184, 9, 320x180 
0x1382CA98, 37353950520410608, 90093237, 90093239, 2, 320x180 
0x1382CA98, 37353950521050240, 90093311, 90093314, 3, 320x180 
0x1382CA98, 37353950521689616, 90093374, 90093375, 1, 320x180 
0x1382CA98, 37353950522489512, 90093450, 90093452, 2, 320x180 
0x1382CA98, 37353950523129872, 90093509, 90093513, 4, 320x180 
0x1382CA98, 37353950523779040, 90093579, 90093585, 6, 320x180 
0x1382CA98, 37353950524410720, 90093648, 90093650, 2, 320x180 
0x1382CA98, 37353950525056200, 90093705, 90093715, 10, 320x180 
0x1382CA98, 37353950525689912, 90093773, 90093774, 1, 320x180 
0x1382CA98, 37353950526498064, 90093854, 90093855, 1, 320x180 
0x1382CA98, 37353950527129544, 90093908, 90093910, 2, 320x180 
0x1382CA98, 37353950527779104, 90093973, 90093974, 1, 320x180 
0x1382CA98, 37353950528414336, 90094048, 90094050, 2, 320x180 
0x1382CA98, 37353950529050688, 90094110, 90094114, 4, 320x180 
0x1382CA98, 37353950529694456, 90094172, 90094175, 3, 320x180 
0x1382CA98, 37353950530491352, 90094251, 90094252, 1, 320x180 
0x1382CA98, 37353950531134792, 90094323, 90094324, 1, 320x180 
0x1382CA98, 37353950531777768, 90094380, 90094391, 11, 320x180 
0x1382CA98, 37353950532416024, 90094437, 90094439, 2, 320x180 
0x1382CA98, 37353950533049248, 90094505, 90094506, 1, 320x180 
0x1382CA98, 37353950533696360, 90094568, 90094570, 2, 320x180 
0x1382CA98, 37353950534522344, 90094700, 90094704, 4, 320x180 
0x1382CA98, 37353950535183000, 90094749, 90094754, 5, 320x180 
0x1382CA98, 37353950535816816, 90094791, 90094799, 8, 320x180 
0x1382CA98, 37353950536437576, 90094852, 90094854, 2, 320x180 
0x1382CA98, 37353950537057088, 90094925, 90094931, 6, 320x180 
0x1382CA98, 37353950537694776, 90094997, 90095011, 14, 320x180 
0x1382CA98, 37353950538532080, 90095085, 90095088, 3, 320x180 
0x1382CA98, 37353950539140840, 90095166, 90095171, 5, 320x180 
0x1382CA98, 37353950539811584, 90095201, 90095219, 18, 320x180 
0x1382CA98, 37353950540436904, 90095266, 90095268, 2, 320x180 
0x1382CA98, 37353950541049120, 90095308, 90095325, 17, 320x180 
0x1382CA98, 37353950541699984, 90095376, 90095380, 4, 320x180 
0x1382CA98, 37353950542492440, 90095457, 90095458, 1, 320x180 
0x1382CA98, 37353950543128904, 90095511, 90095519, 8, 320x180 
0x1382CA98, 37353950543769512, 90095577, 90095582, 5, 320x180 
0x1382CA98, 37353950544410456, 90095642, 90095654, 12, 320x180 
0x1382CA98, 37353950545053664, 90095713, 90095715, 2, 320x180 
0x1382CA98, 37353950545689216, 90095775, 90095785, 10, 320x180 
0x1382CA98, 37353950546492960, 90095851, 90095853, 2, 320x180 
0x1382CA98, 37353950547129304, 90095911, 90095918, 7, 320x180 
0x1382CA98, 37353950547771720, 90095975, 90095980, 5, 320x180 
0x1382CA98, 37353950548409392, 90096046, 90096052, 6, 320x180 
0x1382CA98, 37353950549052576, 90096113, 90096116, 3, 320x180 
0x1382CA98, 37353950549689840, 90096172, 90096173, 1, 320x180 
0x1382CA98, 37353950550488904, 90096255, 90096256, 1, 320x180 
0x1382CA98, 37353950551133480, 90096311, 90096321, 10, 320x180 
0x1382CA98, 37353950551772016, 90096378, 90096386, 8, 320x180 
0x1382CA98, 37353950552409072, 90096441, 90096442, 1, 320x180 
0x1382CA98, 37353950553049440, 90096501, 90096507, 6, 320x180 
0x1382CA98, 37353950553688720, 90096565, 90096572, 7, 320x180 
0x1382CA98, 37353950554492120, 90096655, 90096657, 2, 320x180 
0x1382CA98, 37353950555127944, 90096711, 90096719, 8, 320x180 
0x1382CA98, 37353950555779032, 90096777, 90096783, 6, 320x180 
0x1382CA98, 37353950556409144, 90096846, 90096847, 1, 320x180 
0x1382CA98, 37353950557054800, 90096905, 90096906, 1, 320x180 
0x1382CA98, 37353950557692376, 90096978, 90096980, 2, 320x180 
0x1382CA98, 37353950558492840, 90097045, 90097052, 7, 320x180 
0x1382CA98, 37353950559129064, 90097122, 90097123, 1, 320x180 
0x1382CA98, 37353950559776680, 90097180, 90097192, 12, 320x180 
0x1382CA98, 37353950560408816, 90097240, 90097241, 1, 320x180 
0x1382CA98, 37353950561052112, 90097303, 90097305, 2, 320x180 
0x1382CA98, 37353950561691752, 90097370, 90097371, 1, 320x180 
0x1382CA98, 37353950562488432, 90097442, 90097445, 3, 320x180 
0x1382CA98, 37353950563129600, 90097516, 90097517, 1, 320x180 
0x1382CA98, 37353950563777064, 90097574, 90097577, 3, 320x180 
0x1382CA98, 37353950564410936, 90097646, 90097651, 5, 320x180 
0x1382CA98, 37353950565048040, 90097711, 90097713, 2, 320x180 
0x1382CA98, 37353950565690480, 90097769, 90097771, 2, 320x180 
0x1382CA98, 37353950566332200, 90097834, 90097841, 7, 320x180 
0x1382CA98, 37353950567128296, 90097912, 90097920, 8, 320x180 
0x1382CA98, 37353950567778472, 90097978, 90097987, 9, 320x180 
0x1382CA98, 37353950568413152, 90098047, 90098050, 3, 320x180 
0x1382CA98, 37353950569048976, 90098110, 90098120, 10, 320x180 
0x1382CA98, 37353950569699760, 90098170, 90098176, 6, 320x180 
0x1382CA98, 37353950570332144, 90098239, 90098241, 2, 320x180 
0x1382CA98, 37353950571130152, 90098308, 90098313, 5, 320x180 
0x1382CA98, 37353950571768712, 90098373, 90098374, 1, 320x180 
0x1382CA98, 37353950572413000, 90098446, 90098455, 9, 320x180 
0x1382CA98, 37353950573066936, 90098520, 90098524, 4, 320x180 
0x1382CA98, 37353950573692776, 90098595, 90098598, 3, 320x180 
0x1382CA98, 37353950574328200, 90098633, 90098635, 2, 320x180 
0x1382CA98, 37353950575132824, 90098715, 90098722, 7, 320x180 
0x1382CA98, 37353950575776416, 90098784, 90098798, 14, 320x180 
0x1382CA98, 37353950576407680, 90098841, 90098848, 7, 320x180 
0x1382CA98, 37353950577047832, 90098912, 90098914, 2, 320x180 
0x1382CA98, 37353950577687792, 90098969, 90098973, 4, 320x180 
0x1382CA98, 37353950578331928, 90099031, 90099033, 2, 320x180 
0x1382CA98, 37353950579128104, 90099117, 90099119, 2, 320x180 
0x1382CA98, 37353950579768320, 90099186, 90099192, 6, 320x180 
0x1382CA98, 37353950580408464, 90099246, 90099248, 2, 320x180 
0x1382CA98, 37353950581049040, 90099311, 90099313, 2, 320x180 
0x1382CA98, 37353950581703624, 90099373, 90099375, 2, 320x180 
0x1382CA98, 37353950582341072, 90099444, 90099448, 4, 320x180 
0x1382CA98, 37353950583129976, 90099534, 90099541, 7, 320x180 
0x1382CA98, 37353950583772784, 90099588, 90099590, 2, 320x180 
0x1382CA98, 37353950584407528, 90099640, 90099641, 1, 320x180 
0x1382CA98, 37353950585053608, 90099706, 90099707, 1, 320x180 
0x1382CA98, 37353950585690488, 90099773, 90099776, 3, 320x180 
0x1382CA98, 37353950586340816, 90099833, 90099835, 2, 320x180 
0x1382CA98, 37353950587127528, 90099912, 90099920, 8, 320x180 
0x1382CA98, 37353950587776704, 90099991, 90099996, 5, 320x180 
0x1382CA98, 37353950588407224, 90100049, 90100052, 3, 320x180 
0x1382CA98, 37353950589047624, 90100111, 90100113, 2, 320x180 
0x1382CA98, 37353950589687720, 90100170, 90100171, 1, 320x180 
0x1382CA98, 37353950590328440, 90100237, 90100239, 2, 320x180 
0x1382CA98, 37353950591128544, 90100318, 90100319, 1, 320x180 
0x1382CA98, 37353950591782576, 90100372, 90100374, 2, 320x180 
0x1382CA98, 37353950592456816, 90100441, 90100446, 5, 320x180 
0x1382CA98, 37353950593052848, 90100506, 90100507, 1, 320x180 
0x1382CA98, 37353950593694904, 90100608, 90100614, 6, 320x180 
0x1382CA98, 37353950594339552, 90100661, 90100679, 18, 320x180 
0x1382CA98, 37353950595131664, 90100722, 90100725, 3, 320x180 
0x1382CA98, 37353950595769664, 90100783, 90100785, 2, 320x180 
0x1382CA98, 37353950596409752, 90100840, 90100843, 3, 320x180 
0x1382CA98, 37353950597051488, 90100911, 90100921, 10, 320x180 
0x1382CA98, 37353950597691352, 90100969, 90100971, 2, 320x180 
0x1382CA98, 37353950598332896, 90101040, 90101041, 1, 320x180 
0x1382CA98, 37353950599131136, 90101109, 90101114, 5, 320x180 
0x1382CA98, 37353950599773744, 90101172, 90101175, 3, 320x180 
0x1382CA98, 37353950600407280, 90101248, 90101250, 2, 320x180 
0x1382CA98, 37353950601047264, 90101305, 90101306, 1, 320x180 
0x1382CA98, 37353950601693488, 90101373, 90101376, 3, 320x180 
0x1382CA98, 37353950602332920, 90101434, 90101435, 1, 320x180 
0x1382CA98, 37353950603127032, 90101510, 90101518, 8, 320x180 
0x1382CA98, 37353950603773088, 90101575, 90101588, 13, 320x180 
0x1382CA98, 37353950604417576, 90101650, 90101652, 2, 320x180 
0x1382CA98, 37353950605051024, 90101702, 90101703, 1, 320x180 
0x1382CA98, 37353950605687592, 90101766, 90101773, 7, 320x180 
0x1382CA98, 37353950606339256, 90101834, 90101835, 1, 320x180 
0x1382CA98, 37353950607127880, 90101907, 90101911, 4, 320x180 
0x1382CA98, 37353950607789800, 90101983, 90101994, 11, 320x180 
0x1382CA98, 37353950608407664, 90102063, 90102066, 3, 320x180 
0x1382CA98, 37353950609047704, 90102116, 90102118, 2, 320x180 
0x1382CA98, 37353950609690568, 90102170, 90102172, 2, 320x180 
0x1382CA98, 37353950610340736, 90102233, 90102234, 1, 320x180 
0x1382CA98, 37353950611126760, 90102312, 90102318, 6, 320x180 
0x1382CA98, 37353950611777616, 90102373, 90102377, 4, 320x180 
0x1382CA98, 37353950612406776, 90102453, 90102454, 1, 320x180 
0x1382CA98, 37353950613047096, 90102510, 90102513, 3, 320x180 
0x1382CA98, 37353950613690696, 90102572, 90102574, 2, 320x180 
0x1382CA98, 37353950614331640, 90102636, 90102637, 1, 320x180 
0x1382CA98, 37353950615132064, 90102722, 90102724, 2, 320x180 
0x1382CA98, 37353950615773664, 90102775, 90102783, 8, 320x180 
0x1382CA98, 37353950616414208, 90102840, 90102842, 2, 320x180 
0x1382CA98, 37353950617047408, 90102902, 90102903, 1, 320x180 
0x1382CA98, 37353950617687712, 90102973, 90102974, 1, 320x180 
0x1382CA98, 37353950618331680, 90103035, 90103036, 1, 320x180 
0x1382CA98, 37353950619132040, 90103123, 90103124, 1, 320x180 
0x1382CA98, 37353950619775344, 90103184, 90103186, 2, 320x180 
0x1382CA98, 37353950620407032, 90103240, 90103243, 3, 320x180 
0x1382CA98, 37353950621052320, 90103309, 90103319, 10, 320x180 
0x1382CA98, 37353950621707520, 90103381, 90103393, 12, 320x180 
0x1382CA98, 37353950622331120, 90103438, 90103439, 1, 320x180 
0x1382CA98, 37353950622980264, 90103516, 90103519, 3, 320x180 
0x1382CA98, 37353950623788616, 90103600, 90103603, 3, 320x180 
0x1382CA98, 37353950624409144, 90103652, 90103662, 10, 320x180 
0x1382CA98, 37353950625048088, 90103763, 90103769, 6, 320x180 
0x1382CA98, 37353950626016328, 90103834, 90103844, 10, 320x180 
0x1382CA98, 37353950626780232, 90103902, 90103939, 37, 320x180 
0x1382CA98, 37353950627453528, 90103962, 90103982, 20, 320x180 
0x1382CA98, 37353950628449032, 90104100, 90104136, 36, 320x180 
0x1382CA98, 37353950629140496, 90104139, 90104184, 45, 320x180 
0x1382CA98, 37353950629546864, 90104204, 90104207, 3, 320x180 
0x1382CA98, 37353950630200720, 90104250, 90104253, 3, 320x180 
0x1382CA98, 37353950630821408, 90104313, 90104319, 6, 320x180 
0x1382CA98, 37353950631768552, 90104389, 90104395, 6, 320x180 
0x1382CA98, 37353950632411472, 90104461, 90104464, 3, 320x180 
0x1382CA98, 37353950633047552, 90104520, 90104527, 7, 320x180 
0x1382CA98, 37353950633686304, 90104573, 90104574, 1, 320x180 
0x1382CA98, 37353950634327600, 90104640, 90104641, 1, 320x180 
0x1382CA98, 37353950634970552, 90104692, 90104701, 9, 320x180 
0x1382CA98, 37353950635784432, 90104781, 90104790, 9, 320x180 
0x1382CA98, 37353950636406720, 90104851, 90104853, 2, 320x180 
0x1382CA98, 37353950637050776, 90104903, 90104905, 2, 320x180 
0x1382CA98, 37353950637687216, 90104973, 90104974, 1, 320x180 
0x1382CA98, 37353950638326472, 90105036, 90105037, 1, 320x180 
0x1382CA98, 37353950638967400, 90105095, 90105097, 2, 320x180 
0x1382CA98, 37353950639773976, 90105174, 90105177, 3, 320x180 
0x1382CA98, 37353950640406496, 90105245, 90105248, 3, 320x180 
0x1382CA98, 37353950641047384, 90105311, 90105321, 10, 320x180 
0x1382CA98, 37353950641686360, 90105369, 90105370, 1, 320x180 
0x1382CA98, 37353950642328200, 90105440, 90105441, 1, 320x180 
0x1382CA98, 37353950642970120, 90105504, 90105505, 1, 320x180 
0x1382CA98, 37353950643772120, 90105573, 90105574, 1, 320x180 
0x1382CA98, 37353950644407272, 90105649, 90105651, 2, 320x180 
0x1382CA98, 37353950645051072, 90105705, 90105707, 2, 320x180 
0x1382CA98, 37353950645696264, 90105769, 90105771, 2, 320x180 
0x1382CA98, 37353950646338752, 90105846, 90105855, 9, 320x180 
0x1382CA98, 37353950646973160, 90105905, 90105906, 1, 320x180 
0x1382CA98, 37353950647771872, 90105981, 90105988, 7, 320x180 
0x1382CA98, 37353950648411008, 90106043, 90106050, 7, 320x180 
0x1382CA98, 37353950649046352, 90106111, 90106112, 1, 320x180 
0x1382CA98, 37353950649686048, 90106167, 90106168, 1, 320x180 
0x1382CA98, 37353950650325920, 90106231, 90106233, 2, 320x180 
0x1382CA98, 37353950650970592, 90106297, 90106298, 1, 320x180 
0x1382CA98, 37353950651775376, 90106374, 90106382, 8, 320x180 
0x1382CA98, 37353950652406472, 90106438, 90106439, 1, 320x180 
0x1382CA98, 37353950653046664, 90106504, 90106505, 1, 320x180 
0x1382CA98, 37353950653712008, 90106577, 90106585, 8, 320x180 
0x1382CA98, 37353950654328936, 90106645, 90106647, 2, 320x180 
0x1382CA98, 37353950654970872, 90106707, 90106709, 2, 320x180 
0x1382CA98, 37353950655771712, 90106778, 90106788, 10, 320x180 
0x1382CA98, 37353950656405864, 90106839, 90106845, 6, 320x180 
0x1382CA98, 37353950657046080, 90106905, 90106906, 1, 320x180 
0x1382CA98, 37353950657686056, 90106974, 90106979, 5, 320x180 
0x1382CA98, 37353950658327192, 90107032, 90107035, 3, 320x180 
0x1382CA98, 37353950658970600, 90107107, 90107108, 1, 320x180 
0x1382CA98, 37353950659771080, 90107174, 90107177, 3, 320x180 
0x1382CA98, 37353950660418760, 90107239, 90107240, 1, 320x180 
0x1382CA98, 37353950661050488, 90107310, 90107313, 3, 320x180 
0x1382CA98, 37353950661686856, 90107368, 90107369, 1, 320x180 
0x1382CA98, 37353950662329576, 90107434, 90107436, 2, 320x180 
0x1382CA98, 37353950662966816, 90107499, 90107509, 10, 320x180 
0x1382CA98, 37353950663775256, 90107578, 90107580, 2, 320x180 
0x1382CA98, 37353950664406264, 90107651, 90107653, 2, 320x180 
0x1382CA98, 37353950665365680, 90107735, 90107742, 7, 640x360 
0x1382CA98, 37353950665698672, 90107768, 90107771, 3, 640x360 
0x1382CA98, 37353950666010832, 90107809, 90107820, 11, 640x360 
0x1382CA98, 37353950666328520, 90107842, 90107853, 11, 640x360 
0x1382CA98, 37353950666646232, 90107877, 90107881, 4, 640x360 
0x1382CA98, 37353950666966984, 90107903, 90107909, 6, 640x360 
0x1382CA98, 37353950667286840, 90107932, 90107934, 2, 640x360 
0x1382CA98, 37353950667770152, 90107979, 90107981, 2, 640x360 
0x1382CA98, 37353950668114728, 90108008, 90108020, 12, 640x360 
0x1382CA98, 37353950668406000, 90108042, 90108055, 13, 640x360 
0x1382CA98, 37353950668729432, 90108075, 90108077, 2, 640x360 
0x1382CA98, 37353950669052104, 90108114, 90108116, 2, 640x360 
0x1382CA98, 37353950669369008, 90108135, 90108137, 2, 640x360 
0x1382CA98, 37353950669685328, 90108169, 90108171, 2, 640x360 
0x1382CA98, 37353950670005976, 90108200, 90108202, 2, 640x360 
0x1382CA98, 37353950670325512, 90108233, 90108235, 2, 640x360 
0x1382CA98, 37353950670649344, 90108265, 90108267, 2, 640x360 
0x1382CA98, 37353950670966424, 90108294, 90108296, 2, 640x360 
0x1382CA98, 37353950671285968, 90108334, 90108336, 2, 640x360 
0x1382CA98, 37353950671774816, 90108381, 90108383, 2, 640x360 
0x1382CA98, 37353950672110688, 90108430, 90108436, 6, 640x360 
0x1382CA98, 37353950672406288, 90108450, 90108459, 9, 640x360 
0x1382CA98, 37353950672741184, 90108480, 90108482, 2, 640x360 
0x1382CA98, 37353950673051776, 90108501, 90108503, 2, 640x360 
0x1382CA98, 37353950673373272, 90108541, 90108544, 3, 640x360 
0x1382CA98, 37353950673685048, 90108563, 90108571, 8, 640x360 
0x1382CA98, 37353950674006104, 90108599, 90108601, 2, 640x360 
0x1382CA98, 37353950674326728, 90108631, 90108644, 13, 640x360 
0x1382CA98, 37353950674650672, 90108661, 90108664, 3, 640x360 
0x1382CA98, 37353950674966040, 90108699, 90108701, 2, 640x360 
0x1382CA98, 37353950675288792, 90108733, 90108735, 2, 640x360 
0x1382CA98, 37353950675612296, 90108756, 90108758, 2, 640x360 
0x1382CA98, 37353950676094920, 90108809, 90108815, 6, 640x360 
0x1382CA98, 37353950676424552, 90108838, 90108841, 3, 640x360 
0x1382CA98, 37353950676727296, 90108873, 90108875, 2, 640x360 
0x1382CA98, 37353950677045272, 90108906, 90108908, 2, 640x360 
0x1382CA98, 37353950677365288, 90108933, 90108936, 3, 640x360 
0x1382CA98, 37353950677685600, 90108967, 90108969, 2, 640x360 
0x1382CA98, 37353950678005696, 90109002, 90109004, 2, 640x360 
0x1382CA98, 37353950678326008, 90109041, 90109045, 4, 640x360 
0x1382CA98, 37353950678653920, 90109060, 90109064, 4, 640x360 
0x1382CA98, 37353950678966192, 90109090, 90109103, 13, 640x360 
0x1382CA98, 37353950679285928, 90109126, 90109135, 9, 640x360 
0x1382CA98, 37353950679617904, 90109160, 90109169, 9, 640x360 
0x1382CA98, 37353950680090712, 90109206, 90109210, 4, 640x360 
0x1382CA98, 37353950680415720, 90109239, 90109242, 3, 640x360 
0x1382CA98, 37353950680728816, 90109272, 90109274, 2, 640x360 
0x1382CA98, 37353950681045584, 90109317, 90109323, 6, 640x360 
0x1382CA98, 37353950681379016, 90109340, 90109342, 2, 640x360 
0x1382CA98, 37353950681684824, 90109373, 90109375, 2, 640x360 
0x1382CA98, 37353950682009256, 90109404, 90109406, 2, 640x360 
0x1382CA98, 37353950682325496, 90109435, 90109438, 3, 640x360 
0x1382CA98, 37353950682645856, 90109468, 90109471, 3, 640x360 
0x1382CA98, 37353950682966088, 90109496, 90109501, 5, 640x360 
0x1382CA98, 37353950683285752, 90109528, 90109531, 3, 640x360 
0x1382CA98, 37353950683605904, 90109558, 90109562, 4, 640x360 
0x1382CA98, 37353950684087720, 90109614, 90109616, 2, 640x360 
0x1382CA98, 37353950684417440, 90109638, 90109641, 3, 640x360 
0x1382CA98, 37353950684730160, 90109683, 90109686, 3, 640x360 
0x1382CA98, 37353950685048552, 90109703, 90109705, 2, 640x360 
0x1382CA98, 37353950685372104, 90109744, 90109747, 3, 640x360 
0x1382CA98, 37353950685689128, 90109766, 90109773, 7, 640x360 
0x1382CA98, 37353950686005376, 90109799, 90109801, 2, 640x360 
0x1382CA98, 37353950686325848, 90109840, 90109844, 4, 640x360 
0x1382CA98, 37353950686646656, 90109861, 90109872, 11, 640x360 
0x1382CA98, 37353950686966256, 90109908, 90109916, 8, 640x360 
0x1382CA98, 37353950687295064, 90109930, 90109934, 4, 640x360 
0x1382CA98, 37353950687624168, 90109957, 90109961, 4, 640x360 
0x1382CA98, 37353950688085264, 90110016, 90110019, 3, 640x360 
0x1382CA98, 37353950688407728, 90110041, 90110043, 2, 640x360 
0x1382CA98, 37353950688730160, 90110113, 90110118, 5, 640x360 
0x1382CA98, 37353950689052184, 90110118, 90110131, 13, 640x360 
0x1382CA98, 37353950689395064, 90110146, 90110151, 5, 640x360 
0x1382CA98, 37353950689689232, 90110178, 90110181, 3, 640x360 
0x1382CA98, 37353950690011824, 90110203, 90110212, 9, 640x360 
0x1382CA98, 37353950690334848, 90110237, 90110240, 3, 640x360 
0x1382CA98, 37353950690646336, 90110275, 90110285, 10, 640x360 
0x1382CA98, 37353950690966336, 90110311, 90110322, 11, 640x360 
0x1382CA98, 37353950691315104, 90110363, 90110366, 3, 640x360 
0x1382CA98, 37353950691684840, 90110373, 90110383, 10, 640x360 
0x1382CA98, 37353950692104904, 90110424, 90110426, 2, 640x360 
0x1382CA98, 37353950692404728, 90110451, 90110453, 2, 640x360 
0x1382CA98, 37353950692749632, 90110473, 90110476, 3, 640x360 
0x1382CA98, 37353950693045928, 90110511, 90110515, 4, 640x360 
0x1382CA98, 37353950693372000, 90110546, 90110549, 3, 640x360 
0x1382CA98, 37353950693684696, 90110569, 90110574, 5, 640x360 
0x1382CA98, 37353950694005712, 90110601, 90110606, 5, 640x360 
0x1382CA98, 37353950694329392, 90110633, 90110635, 2, 640x360 
0x1382CA98, 37353950694648536, 90110661, 90110666, 5, 640x360 
0x1382CA98, 37353950694970416, 90110693, 90110705, 12, 640x360 
0x1382CA98, 37353950695291928, 90110739, 90110747, 8, 640x360 
0x1382CA98, 37353950695616152, 90110769, 90110771, 2, 640x360 
0x1382CA98, 37353950696091712, 90110816, 90110823, 7, 640x360 
0x1382CA98, 37353950696408504, 90110846, 90110853, 7, 640x360 
0x1382CA98, 37353950696724464, 90110875, 90110881, 6, 640x360 
0x1382CA98, 37353950697044496, 90110912, 90110914, 2, 640x360 
0x1382CA98, 37353950697368648, 90110936, 90110938, 2, 640x360 
0x1382CA98, 37353950697687104, 90110972, 90110974, 2, 640x360 
0x1382CA98, 37353950698008600, 90111007, 90111010, 3, 640x360 
0x1382CA98, 37353950698328656, 90111035, 90111042, 7, 640x360 
0x1382CA98, 37353950698645168, 90111067, 90111069, 2, 640x360 
0x1382CA98, 37353950698964896, 90111094, 90111104, 10, 640x360 
0x1382CA98, 37353950699294688, 90111135, 90111140, 5, 640x360 
0x1382CA98, 37353950699630464, 90111162, 90111166, 4, 640x360 
0x1382CA98, 37353950700090072, 90111213, 90111222, 9, 640x360 
0x1382CA98, 37353950700408696, 90111238, 90111241, 3, 640x360 
0x1382CA98, 37353950700728560, 90111279, 90111282, 3, 640x360 
0x1382CA98, 37353950701046840, 90111306, 90111307, 1, 640x360 
0x1382CA98, 37353950701364616, 90111337, 90111338, 1, 640x360 
0x1382CA98, 37353950701684904, 90111369, 90111371, 2, 640x360 
0x1382CA98, 37353950702004800, 90111407, 90111409, 2, 640x360 
0x1382CA98, 37353950702328256, 90111433, 90111440, 7, 640x360 
0x1382CA98, 37353950702653240, 90111467, 90111470, 3, 640x360 
0x1382CA98, 37353950702966104, 90111493, 90111505, 12, 640x360 
0x1382CA98, 37353950703289872, 90111528, 90111539, 11, 640x360 
0x1382CA98, 37353950703615248, 90111581, 90111584, 3, 640x360 
0x1382CA98, 37353950703926928, 90111591, 90111594, 3, 640x360 
0x1382CA98, 37353950704404200, 90111638, 90111641, 3, 640x360 
0x1382CA98, 37353950704729824, 90111680, 90111682, 2, 640x360 
0x1382CA98, 37353950705049216, 90111703, 90111708, 5, 640x360 
0x1382CA98, 37353950705364432, 90111736, 90111739, 3, 640x360 
0x1382CA98, 37353950705686680, 90111774, 90111776, 2, 640x360 
0x1382CA98, 37353950706005088, 90111800, 90111808, 8, 640x360 
0x1382CA98, 37353950706330544, 90111843, 90111847, 4, 640x360 
0x1382CA98, 37353950706650720, 90111871, 90111873, 2, 640x360 
0x1382CA98, 37353950706965288, 90111908, 90111917, 9, 640x360 
0x1382CA98, 37353950707298288, 90111939, 90111943, 4, 640x360 
0x1382CA98, 37353950707636888, 90111981, 90111984, 3, 640x360 
0x1382CA98, 37353950707939208, 90112004, 90112007, 3, 640x360 
0x1382CA98, 37353950708404264, 90112052, 90112063, 11, 640x360 
0x1382CA98, 37353950708777584, 90112087, 90112089, 2, 640x360 
0x1382CA98, 37353950709044792, 90112101, 90112105, 4, 640x360 
0x1382CA98, 37353950709364168, 90112138, 90112140, 2, 640x360 
0x1382CA98, 37353950709688368, 90112174, 90112176, 2, 640x360 
0x1382CA98, 37353950710004264, 90112201, 90112203, 2, 640x360 
0x1382CA98, 37353950710324280, 90112232, 90112238, 6, 640x360 
0x1382CA98, 37353950710645056, 90112275, 90112278, 3, 640x360 
0x1382CA98, 37353950710965360, 90112300, 90112311, 11, 640x360 
0x1382CA98, 37353950711284680, 90112343, 90112355, 12, 640x360 
0x1382CA98, 37353950711622712, 90112381, 90112385, 4, 640x360 
0x1382CA98, 37353950711951520, 90112402, 90112404, 2, 640x360 
0x1382CA98, 37353950712404168, 90112450, 90112453, 3, 640x360 
0x1382CA98, 37353950712728688, 90112481, 90112491, 10, 640x360 
0x1382CA98, 37353950713045656, 90112508, 90112514, 6, 640x360 
0x1382CA98, 37353950713369504, 90112551, 90112557, 6, 640x360 
0x1382CA98, 37353950713716896, 90112573, 90112587, 14, 640x360 
0x1382CA98, 37353950714019656, 90112614, 90112616, 2, 640x360 
0x1382CA98, 37353950714328040, 90112639, 90112641, 2, 640x360 
0x1382CA98, 37353950714644888, 90112668, 90112670, 2, 640x360 
0x1382CA98, 37353950714968776, 90112695, 90112710, 15, 640x360 
0x1382CA98, 37353950715297832, 90112725, 90112731, 6, 640x360 
0x1382CA98, 37353950715605640, 90112758, 90112765, 7, 640x360 
0x1382CA98, 37353950715964496, 90112795, 90112802, 7, 640x360 
0x1382CA98, 37353950716407832, 90112840, 90112843, 3, 640x360 
0x1382CA98, 37353950716724128, 90112868, 90112871, 3, 640x360 
0x1382CA98, 37353950717043984, 90112912, 90112919, 7, 640x360 
0x1382CA98, 37353950717364232, 90112941, 90112944, 3, 640x360 
0x1382CA98, 37353950717684568, 90112967, 90112973, 6, 640x360 
0x1382CA98, 37353950718005312, 90113000, 90113004, 4, 640x360 
0x1382CA98, 37353950718337296, 90113034, 90113036, 2, 640x360 
0x1382CA98, 37353950718680856, 90113069, 90113071, 2, 640x360 
0x1382CA98, 37353950718979576, 90113095, 90113100, 5, 640x360 
0x1382CA98, 37353950719317160, 90113139, 90113141, 2, 640x360 
0x1382CA98, 37353950719607168, 90113157, 90113161, 4, 640x360 
0x1382CA98, 37353950719925232, 90113200, 90113202, 2, 640x360 
0x1382CA98, 37353950720407840, 90113248, 90113251, 3, 640x360 
0x1382CA98, 37353950720723856, 90113269, 90113272, 3, 640x360 
0x1382CA98, 37353950721043784, 90113311, 90113321, 10, 640x360 
0x1382CA98, 37353950721373008, 90113334, 90113341, 7, 640x360 
0x1382CA98, 37353950721686416, 90113369, 90113374, 5, 640x360 
0x1382CA98, 37353950722003792, 90113402, 90113404, 2, 640x360 
0x1382CA98, 37353950722327616, 90113435, 90113437, 2, 640x360 
0x1382CA98, 37353950722648712, 90113470, 90113472, 2, 640x360 
0x1382CA98, 37353950722968968, 90113497, 90113501, 4, 640x360 
0x1382CA98, 37353950723284224, 90113524, 90113528, 4, 640x360 
0x1382CA98, 37353950723609616, 90113569, 90113572, 3, 640x360 
0x1382CA98, 37353950723928024, 90113599, 90113602, 3, 640x360 
0x1382CA98, 37353950724427008, 90113657, 90113665, 8, 640x360 
0x1382CA98, 37353950724747488, 90113675, 90113678, 3, 640x360 
0x1382CA98, 37353950725049296, 90113716, 90113718, 2, 640x360 
0x1382CA98, 37353950725368784, 90113742, 90113748, 6, 640x360 
0x1382CA98, 37353950725692840, 90113770, 90113772, 2, 640x360 
0x1382CA98, 37353950726005624, 90113811, 90113821, 10, 640x360 
0x1382CA98, 37353950726329904, 90113835, 90113837, 2, 640x360 
0x1382CA98, 37353950726648848, 90113867, 90113872, 5, 640x360 
0x1382CA98, 37353950726964264, 90113890, 90113894, 4, 640x360 
0x1382CA98, 37353950727287072, 90113924, 90113927, 3, 640x360 
0x1382CA98, 37353950727612744, 90113964, 90113971, 7, 640x360 
0x1382CA98, 37353950727929184, 90113988, 90113990, 2, 640x360 
0x1382CA98, 37353950728244808, 90114032, 90114038, 6, 640x360 
0x1382CA98, 37353950728723384, 90114072, 90114076, 4, 640x360 
0x1382CA98, 37353950729044384, 90114103, 90114106, 3, 640x360 
0x1382CA98, 37353950729365464, 90114147, 90114151, 4, 640x360 
0x1382CA98, 37353950729692080, 90114173, 90114181, 8, 640x360 
0x1382CA98, 37353950730004584, 90114206, 90114208, 2, 640x360 
0x1382CA98, 37353950730323808, 90114238, 90114240, 2, 640x360 
0x1382CA98, 37353950730644296, 90114274, 90114276, 2, 640x360 
0x1382CA98, 37353950730970368, 90114304, 90114306, 2, 640x360 
0x1382CA98, 37353950731288664, 90114331, 90114335, 4, 640x360 
0x1382CA98, 37353950731608096, 90114358, 90114371, 13, 640x360 
0x1382CA98, 37353950731931072, 90114391, 90114397, 6, 640x360 
0x1382CA98, 37353950732244760, 90114423, 90114429, 6, 640x360 
0x1382CA98, 37353950732723576, 90114471, 90114474, 3, 640x360 
0x1382CA98, 37353950733044376, 90114507, 90114510, 3, 640x360 
0x1382CA98, 37353950733366848, 90114535, 90114537, 2, 640x360 
0x1382CA98, 37353950733691136, 90114568, 90114576, 8, 640x360 
0x1382CA98, 37353950734004080, 90114599, 90114606, 7, 640x360 
0x1382CA98, 37353950734324632, 90114627, 90114634, 7, 640x360 
0x1382CA98, 37353950734693432, 90114674, 90114686, 12, 640x360 
0x1382CA98, 37353950734964360, 90114698, 90114707, 9, 640x360 
0x1382CA98, 37353950735292088, 90114724, 90114729, 5, 640x360 
0x1382CA98, 37353950735607904, 90114755, 90114757, 2, 640x360 
0x1382CA98, 37353950735931016, 90114789, 90114792, 3, 640x360 
0x1382CA98, 37353950736244648, 90114830, 90114833, 3, 640x360 
0x1382CA98, 37353950736724096, 90114880, 90114882, 2, 640x360 
0x1382CA98, 37353950737046720, 90114905, 90114907, 2, 640x360 
0x1382CA98, 37353950737374168, 90114939, 90114941, 2, 640x360 
0x1382CA98, 37353950737688504, 90114967, 90114973, 6, 640x360 
0x1382CA98, 37353950738004104, 90115001, 90115007, 6, 640x360 
0x1382CA98, 37353950738330216, 90115039, 90115044, 5, 640x360 
0x1382CA98, 37353950738649352, 90115060, 90115073, 13, 640x360 
0x1382CA98, 37353950738980912, 90115106, 90115108, 2, 640x360 
0x1382CA98, 37353950739287768, 90115124, 90115127, 3, 640x360 
0x1382CA98, 37353950739618168, 90115157, 90115160, 3, 640x360 
0x1382CA98, 37353950739924984, 90115188, 90115190, 2, 640x360 
0x1382CA98, 37353950740249344, 90115226, 90115231, 5, 640x360 
0x1382CA98, 37353950740723456, 90115274, 90115281, 7, 640x360 
0x1382CA98, 37353950741044024, 90115303, 90115305, 2, 640x360 
0x1382CA98, 37353950741367960, 90115340, 90115342, 2, 640x360 
0x1382CA98, 37353950741702696, 90115367, 90115370, 3, 640x360 
0x1382CA98, 37353950742003784, 90115403, 90115405, 2, 640x360 
0x1382CA98, 37353950742351280, 90115438, 90115439, 1, 640x360 
0x1382CA98, 37353950742657648, 90115465, 90115474, 9, 640x360 
0x1382CA98, 37353950742964504, 90115500, 90115502, 2, 640x360 
0x1382CA98, 37353950743288600, 90115529, 90115532, 3, 640x360 
0x1382CA98, 37353950743605008, 90115553, 90115555, 2, 640x360 
0x1382CA98, 37353950743938992, 90115590, 90115595, 5, 640x360 
0x1382CA98, 37353950744244952, 90115622, 90115626, 4, 640x360 
0x1382CA98, 37353950744727248, 90115676, 90115686, 10, 640x360 
0x1382CA98, 37353950745048864, 90115714, 90115716, 2, 640x360 
0x1382CA98, 37353950745364976, 90115734, 90115737, 3, 640x360 
0x1382CA98, 37353950745687984, 90115773, 90115774, 1, 640x360 
0x1382CA98, 37353950746003792, 90115799, 90115801, 2, 640x360 
0x1382CA98, 37353950746323872, 90115833, 90115840, 7, 640x360 
0x1382CA98, 37353950746644224, 90115869, 90115875, 6, 640x360 
0x1382CA98, 37353950746964352, 90115890, 90115894, 4, 640x360 
0x1382CA98, 37353950747283848, 90115922, 90115924, 2, 640x360 
0x1382CA98, 37353950747610784, 90115968, 90115978, 10, 640x360 
0x1382CA98, 37353950747924480, 90115990, 90115993, 3, 640x360 
0x1382CA98, 37353950748245424, 90116023, 90116026, 3, 640x360 
0x1382CA98, 37353950748723416, 90116073, 90116076, 3, 640x360 
0x1382CA98, 37353950749043920, 90116107, 90116112, 5, 640x360 
0x1382CA98, 37353950749368608, 90116146, 90116153, 7, 640x360 
0x1382CA98, 37353950749687776, 90116171, 90116174, 3, 640x360 
0x1382CA98, 37353950750003296, 90116202, 90116204, 2, 640x360 
0x1382CA98, 37353950750327520, 90116233, 90116241, 8, 640x360 
0x1382CA98, 37353950750643488, 90116268, 90116270, 2, 640x360 
0x1382CA98, 37353950750966240, 90116292, 90116298, 6, 640x360 
0x1382CA98, 37353950751288776, 90116323, 90116326, 3, 640x360 
0x1382CA98, 37353950751608824, 90116355, 90116358, 3, 640x360 
0x1382CA98, 37353950751927552, 90116402, 90116405, 3, 640x360 
0x1382CA98, 37353950752244544, 90116423, 90116429, 6, 640x360 
0x1382CA98, 37353950752723040, 90116472, 90116475, 3, 640x360 
0x1382CA98, 37353950753048104, 90116503, 90116506, 3, 640x360 
0x1382CA98, 37353950753368024, 90116535, 90116537, 2, 640x360 
0x1382CA98, 37353950753685200, 90116566, 90116569, 3, 640x360 
0x1382CA98, 37353950754003160, 90116598, 90116601, 3, 640x360 
0x1382CA98, 37353950754323912, 90116629, 90116631, 2, 640x360 
0x1382CA98, 37353950754644528, 90116660, 90116663, 3, 640x360 
0x1382CA98, 37353950754963632, 90116692, 90116701, 9, 640x360 
0x1382CA98, 37353950755283864, 90116723, 90116732, 9, 640x360 
0x1382CA98, 37353950755604888, 90116763, 90116765, 2, 640x360 
0x1382CA98, 37353950755924888, 90116791, 90116800, 9, 640x360 
0x1382CA98, 37353950756261640, 90116830, 90116833, 3, 640x360 
0x1382CA98, 37353950756564200, 90116854, 90116857, 3, 640x360 
0x1382CA98, 37353950757043392, 90116905, 90116919, 14, 640x360 
0x1382CA98, 37353950757363304, 90116941, 90116944, 3, 640x360 
0x1382CA98, 37353950757690504, 90116974, 90116976, 2, 640x360 
0x1382CA98, 37353950758006800, 90117000, 90117002, 2, 640x360 
0x1382CA98, 37353950758327592, 90117036, 90117045, 9, 640x360 
0x1382CA98, 37353950758645152, 90117065, 90117067, 2, 640x360 
0x1382CA98, 37353950758966224, 90117096, 90117110, 14, 640x360 
0x1382CA98, 37353950759301600, 90117138, 90117142, 4, 640x360 
0x1382CA98, 37353950759616072, 90117175, 90117182, 7, 640x360 
0x1382CA98, 37353950759930352, 90117201, 90117207, 6, 640x360 
0x1382CA98, 37353950760244720, 90117224, 90117228, 4, 640x360 
0x1382CA98, 37353950760568424, 90117264, 90117267, 3, 640x360 
0x1382CA98, 37353950761048360, 90117301, 90117304, 3, 640x360 
0x1382CA98, 37353950761376472, 90117342, 90117346, 4, 640x360 
0x1382CA98, 37353950761688048, 90117367, 90117370, 3, 640x360 
0x1382CA98, 37353950762003144, 90117399, 90117402, 3, 640x360 
0x1382CA98, 37353950762328344, 90117435, 90117442, 7, 640x360 
0x1382CA98, 37353950762644024, 90117466, 90117468, 2, 640x360 
0x1382CA98, 37353950762968016, 90117490, 90117494, 4, 640x360 
0x1382CA98, 37353950763287976, 90117534, 90117540, 6, 640x360 
0x1382CA98, 37353950763625360, 90117570, 90117572, 2, 640x360 
0x1382CA98, 37353950763934720, 90117601, 90117603, 2, 640x360 
0x1382CA98, 37353950764244544, 90117633, 90117636, 3, 640x360 
0x1382CA98, 37353950764568168, 90117666, 90117670, 4, 640x360 
0x1382CA98, 37353950765042408, 90117713, 90117715, 2, 640x360 
0x1382CA98, 37353950765367520, 90117734, 90117737, 3, 640x360 
0x1382CA98, 37353950765682536, 90117766, 90117768, 2, 640x360 
0x1382CA98, 37353950766006888, 90117798, 90117799, 1, 640x360 
0x1382CA98, 37353950766323192, 90117828, 90117836, 8, 640x360 
0x1382CA98, 37353950766643984, 90117861, 90117865, 4, 640x360 
0x1382CA98, 37353950766970024, 90117901, 90117903, 2, 640x360 
0x1382CA98, 37353950767288968, 90117932, 90117935, 3, 640x360 
0x1382CA98, 37353950767603680, 90117961, 90117965, 4, 640x360 
0x1382CA98, 37353950767931192, 90117987, 90117990, 3, 640x360 
0x1382CA98, 37353950768244904, 90118041, 90118044, 3, 640x360 
0x1382CA98, 37353950768564080, 90118066, 90118075, 9, 640x360 
0x1382CA98, 37353950769047664, 90118105, 90118107, 2, 640x360 
0x1382CA98, 37353950769366688, 90118139, 90118141, 2, 640x360 
0x1382CA98, 37353950769687040, 90118175, 90118180, 5, 640x360 
0x1382CA98, 37353950770017408, 90118200, 90118202, 2, 640x360 
0x1382CA98, 37353950770322608, 90118234, 90118237, 3, 640x360 
0x1382CA98, 37353950770646240, 90118272, 90118273, 1, 640x360 
0x1382CA98, 37353950770963184, 90118298, 90118300, 2, 640x360 
0x1382CA98, 37353950771283320, 90118332, 90118337, 5, 640x360 
0x1382CA98, 37353950771614192, 90118361, 90118369, 8, 640x360 
0x1382CA98, 37353950771927344, 90118392, 90118405, 13, 640x360 
0x1382CA98, 37353950772243592, 90118424, 90118427, 3, 640x360 
0x1382CA98, 37353950772564568, 90118464, 90118466, 2, 640x360 
0x1382CA98, 37353950773042984, 90118507, 90118510, 3, 640x360 
0x1382CA98, 37353950773363248, 90118531, 90118534, 3, 640x360 
0x1382CA98, 37353950773686872, 90118562, 90118565, 3, 640x360 
0x1382CA98, 37353950774002808, 90118593, 90118596, 3, 640x360 
0x1382CA98, 37353950774327224, 90118631, 90118633, 2, 640x360 
0x1382CA98, 37353950774649944, 90118664, 90118667, 3, 640x360 
0x1382CA98, 37353950774962912, 90118701, 90118704, 3, 640x360 
0x1382CA98, 37353950775293056, 90118735, 90118738, 3, 640x360 
0x1382CA98, 37353950775605000, 90118758, 90118761, 3, 640x360 
0x1382CA98, 37353950775923736, 90118790, 90118794, 4, 640x360 
0x1382CA98, 37353950776243984, 90118831, 90118833, 2, 640x360 
0x1382CA98, 37353950776563672, 90118879, 90118883, 4, 640x360 
0x1382CA98, 37353950777046344, 90118907, 90118910, 3, 640x360 
0x1382CA98, 37353950777363368, 90118941, 90118953, 12, 640x360 
0x1382CA98, 37353950777685792, 90118967, 90118970, 3, 640x360 
0x1382CA98, 37353950778006240, 90119003, 90119004, 1, 640x360 
0x1382CA98, 37353950778322736, 90119033, 90119035, 2, 640x360 
0x1382CA98, 37353950778647632, 90119061, 90119065, 4, 640x360 
0x1382CA98, 37353950778962912, 90119097, 90119105, 8, 640x360 
0x1382CA98, 37353950779298280, 90119131, 90119133, 2, 640x360 
0x1382CA98, 37353950779609056, 90119167, 90119169, 2, 640x360 
0x1382CA98, 37353950779927016, 90119194, 90119206, 12, 640x360 
0x1382CA98, 37353950780244664, 90119230, 90119239, 9, 640x360 
0x1382CA98, 37353950780568360, 90119263, 90119270, 7, 640x360 
0x1382CA98, 37353950781042616, 90119306, 90119308, 2, 640x360 
0x1382CA98, 37353950781362384, 90119341, 90119344, 3, 640x360 
0x1382CA98, 37353950781684408, 90119365, 90119374, 9, 640x360 
0x1382CA98, 37353950782004984, 90119401, 90119407, 6, 640x360 
0x1382CA98, 37353950782324352, 90119435, 90119441, 6, 640x360 
0x1382CA98, 37353950782642520, 90119461, 90119464, 3, 640x360 
0x1382CA98, 37353950782970288, 90119493, 90119496, 3, 640x360 
0x1382CA98, 37353950783290152, 90119532, 90119534, 2, 640x360 
0x1382CA98, 37353950783604568, 90119555, 90119557, 2, 640x360 
0x1382CA98, 37353950783926592, 90119588, 90119590, 2, 640x360 
0x1382CA98, 37353950784243712, 90119623, 90119627, 4, 640x360 
0x1382CA98, 37353950784563480, 90119655, 90119658, 3, 640x360 
0x1382CA98, 37353950784883376, 90119691, 90119703, 12, 640x360 
0x1382CA98, 37353950785363064, 90119736, 90119740, 4, 640x360 
0x1382CA98, 37353950785704824, 90119768, 90119772, 4, 640x360 
0x1382CA98, 37353950786007960, 90119801, 90119806, 5, 640x360 
0x1382CA98, 37353950786326672, 90119835, 90119837, 2, 640x360 
0x1382CA98, 37353950786642384, 90119864, 90119866, 2, 640x360 
0x1382CA98, 37353950786967648, 90119905, 90119906, 1, 640x360 
0x1382CA98, 37353950787282712, 90119925, 90119931, 6, 640x360 
0x1382CA98, 37353950787604024, 90119957, 90119960, 3, 640x360 
0x1382CA98, 37353950787923456, 90119990, 90119991, 1, 640x360 
0x1382CA98, 37353950788244272, 90120022, 90120025, 3, 640x360 
0x1382CA98, 37353950788562856, 90120057, 90120061, 4, 640x360 
0x1382CA98, 37353950788882488, 90120090, 90120092, 2, 640x360 
0x1382CA98, 37353950789365576, 90120145, 90120150, 5, 640x360 
0x1382CA98, 37353950789694200, 90120170, 90120173, 3, 640x360 
0x1382CA98, 37353950790003816, 90120199, 90120201, 2, 640x360 
0x1382CA98, 37353950790325864, 90120227, 90120234, 7, 640x360 
0x1382CA98, 37353950790664888, 90120271, 90120273, 2, 640x360 
0x1382CA98, 37353950790967376, 90120297, 90120299, 2, 640x360 
0x1382CA98, 37353950791284744, 90120322, 90120324, 2, 640x360 
0x1382CA98, 37353950791616880, 90120358, 90120366, 8, 640x360 
0x1382CA98, 37353950791928328, 90120391, 90120394, 3, 640x360 
0x1382CA98, 37353950792242960, 90120424, 90120428, 4, 640x360 
0x1382CA98, 37353950792566976, 90120455, 90120458, 3, 640x360 
0x1382CA98, 37353950792882656, 90120495, 90120498, 3, 640x360 
0x1382CA98, 37353950793374064, 90120546, 90120548, 2, 640x360 
0x1382CA98, 37353950793686104, 90120569, 90120578, 9, 640x360 
0x1382CA98, 37353950794007968, 90120611, 90120614, 3, 640x360 
0x1382CA98, 37353950794322464, 90120636, 90120638, 2, 640x360 
0x1382CA98, 37353950794642496, 90120669, 90120676, 7, 640x360 
0x1382CA98, 37353950794962384, 90120700, 90120702, 2, 640x360 
0x1382CA98, 37353950795282544, 90120728, 90120732, 4, 640x360 
0x1382CA98, 37353950795612872, 90120769, 90120773, 4, 640x360 
0x1382CA98, 37353950795945160, 90120817, 90120819, 2, 640x360 
0x1382CA98, 37353950796247384, 90120837, 90120839, 2, 640x360 
0x1382CA98, 37353950796563232, 90120870, 90120873, 3, 640x360 
0x1382CA98, 37353950796883392, 90120888, 90120893, 5, 640x360 
0x1382CA98, 37353950797373456, 90120947, 90120962, 15, 640x360 
0x1382CA98, 37353950797700304, 90120974, 90120978, 4, 640x360 
0x1382CA98, 37353950798014152, 90121002, 90121005, 3, 640x360 
0x1382CA98, 37353950798323424, 90121035, 90121047, 12, 640x360 
0x1382CA98, 37353950798659224, 90121084, 90121091, 7, 640x360 
0x1382CA98, 37353950798968984, 90121113, 90121119, 6, 640x360 
0x1382CA98, 37353950799317592, 90121138, 90121141, 3, 640x360 
0x1382CA98, 37353950799608880, 90121171, 90121201, 30, 640x360 
0x1382CA98, 37353950799989216, 90121201, 90121205, 4, 640x360 
0x1382CA98, 37353950800263744, 90121236, 90121238, 2, 640x360 
0x1382CA98, 37353950800562256, 90121273, 90121279, 6, 640x360 
0x1382CA98, 37353950800885088, 90121301, 90121303, 2, 640x360 
0x1382CA98, 37353950801366232, 90121347, 90121355, 8, 640x360 
0x1382CA98, 37353950801686328, 90121378, 90121389, 11, 640x360 
0x1382CA98, 37353950802009072, 90121436, 90121452, 16, 640x360 
0x1382CA98, 37353950802342136, 90121455, 90121461, 6, 640x360 
0x1382CA98, 37353950802671920, 90121479, 90121482, 3, 640x360 
0x1382CA98, 37353950802965272, 90121500, 90121502, 2, 640x360 
0x1382CA98, 37353950803292192, 90121531, 90121538, 7, 640x360 
0x1382CA98, 37353950803608832, 90121562, 90121570, 8, 640x360 
0x1382CA98, 37353950803929352, 90121596, 90121600, 4, 640x360 
0x1382CA98, 37353950804251848, 90121632, 90121634, 2, 640x360 
0x1382CA98, 37353950804568648, 90121670, 90121673, 3, 640x360 
0x1382CA98, 37353950804885152, 90121690, 90121696, 6, 640x360 
0x1382CA98, 37353950805374968, 90121745, 90121747, 2, 640x360 
0x1382CA98, 37353950805687272, 90121766, 90121769, 3, 640x360 
0x1382CA98, 37353950806008400, 90121801, 90121806, 5, 640x360 
0x1382CA98, 37353950806321608, 90121833, 90121835, 2, 640x360 
0x1382CA98, 37353950806641872, 90121868, 90121870, 2, 640x360 
0x1382CA98, 37353950806963448, 90121894, 90121899, 5, 640x360 
0x1382CA98, 37353950807287472, 90121925, 90121932, 7, 640x360 
0x1382CA98, 37353950807604816, 90121955, 90121957, 2, 640x360 
0x1382CA98, 37353950807942264, 90121990, 90121994, 4, 640x360 
0x1382CA98, 37353950808258968, 90122026, 90122040, 14, 640x360 
0x1382CA98, 37353950808565912, 90122057, 90122060, 3, 640x360 
0x1382CA98, 37353950808888064, 90122087, 90122090, 3, 640x360 
0x1382CA98, 37353950809206152, 90122116, 90122119, 3, 640x360 
0x1382CA98, 37353950809685976, 90122174, 90122177, 3, 640x360 
0x1382CA98, 37353950810007304, 90122199, 90122202, 3, 640x360 
0x1382CA98, 37353950810326592, 90122232, 90122238, 6, 640x360 
0x1382CA98, 37353950810641848, 90122268, 90122270, 2, 640x360 
0x1382CA98, 37353950810967472, 90122295, 90122305, 10, 640x360 
0x1382CA98, 37353950811295040, 90122330, 90122334, 4, 640x360 
0x1382CA98, 37353950811609096, 90122364, 90122367, 3, 640x360 
0x1382CA98, 37353950811951312, 90122396, 90122404, 8, 640x360 
0x1382CA98, 37353950812242112, 90122433, 90122441, 8, 640x360 
0x1382CA98, 37353950812571392, 90122466, 90122469, 3, 640x360 
0x1382CA98, 37353950812881944, 90122491, 90122497, 6, 640x360 
0x1382CA98, 37353950813202080, 90122529, 90122532, 3, 640x360 
0x1382CA98, 37353950813686432, 90122568, 90122570, 2, 640x360 
0x1382CA98, 37353950814004144, 90122601, 90122603, 2, 640x360 
0x1382CA98, 37353950814324560, 90122626, 90122634, 8, 640x360 
0x1382CA98, 37353950814642272, 90122659, 90122672, 13, 640x360 
0x1382CA98, 37353950814962400, 90122691, 90122703, 12, 640x360 
0x1382CA98, 37353950815291688, 90122737, 90122740, 3, 640x360 
0x1382CA98, 37353950815622728, 90122760, 90122773, 13, 640x360 
0x1382CA98, 37353950815933072, 90122794, 90122804, 10, 640x360 
0x1382CA98, 37353950816245264, 90122834, 90122846, 12, 640x360 
0x1382CA98, 37353950816569272, 90122892, 90122899, 7, 640x360 
0x1382CA98, 37353950816899816, 90122919, 90122930, 11, 640x360 
0x1382CA98, 37353950817219552, 90122953, 90122957, 4, 640x360 
0x1382CA98, 37353950817692192, 90122982, 90122995, 13, 640x360 
0x1382CA98, 37353950818008440, 90123032, 90123040, 8, 640x360 
0x1382CA98, 37353950818332760, 90123060, 90123063, 3, 640x360 
0x1382CA98, 37353950818663152, 90123084, 90123094, 10, 640x360 
0x1382CA98, 37353950818979064, 90123131, 90123135, 4, 640x360 
0x1382CA98, 37353950819306984, 90123153, 90123155, 2, 640x360 
0x1382CA98, 37353950819607768, 90123175, 90123178, 3, 640x360 
0x1382CA98, 37353950819926032, 90123207, 90123210, 3, 640x360 
0x1382CA98, 37353950820243448, 90123224, 90123231, 7, 640x360 
0x1382CA98, 37353950820563352, 90123263, 90123266, 3, 640x360 
0x1382CA98, 37353950820885608, 90123285, 90123288, 3, 640x360 
0x1382CA98, 37353950821201728, 90123321, 90123323, 2, 640x360 
0x1382CA98, 37353950821684872, 90123374, 90123376, 2, 640x360 
0x1382CA98, 37353950822007168, 90123405, 90123407, 2, 640x360 
0x1382CA98, 37353950822337224, 90123434, 90123436, 2, 640x360 
0x1382CA98, 37353950822648896, 90123467, 90123470, 3, 640x360 
0x1382CA98, 37353950822996832, 90123502, 90123504, 2, 640x360 
0x1382CA98, 37353950823300864, 90123535, 90123537, 2, 640x360 
0x1382CA98, 37353950823601864, 90123562, 90123572, 10, 640x360 
0x1382CA98, 37353950823922032, 90123603, 90123614, 11, 640x360 
0x1382CA98, 37353950824254928, 90123630, 90123638, 8, 640x360 
0x1382CA98, 37353950824569752, 90123656, 90123659, 3, 640x360 
0x1382CA98, 37353950824884864, 90123684, 90123686, 2, 640x360 
0x1382CA98, 37353950825202368, 90123717, 90123721, 4, 640x360 
0x1382CA98, 37353950825685760, 90123774, 90123776, 2, 640x360 
0x1382CA98, 37353950826006552, 90123816, 90123819, 3, 640x360 
0x1382CA98, 37353950826322088, 90123833, 90123839, 6, 640x360 
0x1382CA98, 37353950826646928, 90123885, 90123887, 2, 640x360 
0x1382CA98, 37353950826978008, 90123896, 90123898, 2, 640x360 
0x1382CA98, 37353950827293400, 90123941, 90123958, 17, 640x360 
0x1382CA98, 37353950827611088, 90123968, 90123986, 18, 640x360 
0x1382CA98, 37353950827936032, 90124025, 90124032, 7, 640x360 
0x1382CA98, 37353950828280688, 90124057, 90124067, 10, 640x360 
0x1382CA98, 37353950828573664, 90124096, 90124101, 5, 640x360 
0x1382CA98, 37353950829211824, 90124145, 90124155, 10, 640x360 
0x1382CA98, 37353950829714992, 90124172, 90124187, 15, 640x360 
0x1382CA98, 37353950830010048, 90124242, 90124274, 32, 640x360 
0x1382CA98, 37353950830326440, 90124285, 90124309, 24, 640x360 
0x1382CA98, 37353950830969328, 90124345, 90124356, 11, 640x360 
0x1382CA98, 37353950831304536, 90124378, 90124413, 35, 640x360 
0x1382CA98, 37353950831940672, 90124413, 90124420, 7, 640x360 
0x1382CA98, 37353950832248552, 90124436, 90124439, 3, 640x360 
0x1382CA98, 37353950832562208, 90124483, 90124494, 11, 640x360 
0x1382CA98, 37353950832897552, 90124500, 90124502, 2, 640x360 
0x1382CA98, 37353950833203576, 90124531, 90124534, 3, 640x360 
0x1382CA98, 37353950833684936, 90124565, 90124571, 6, 640x360 
0x1382CA98, 37353950834004720, 90124611, 90124614, 3, 640x360 
0x1382CA98, 37353950834320864, 90124635, 90124637, 2, 640x360 
0x1382CA98, 37353950834646872, 90124674, 90124689, 15, 640x360 
0x1382CA98, 37353950834975120, 90124707, 90124716, 9, 640x360 
0x1382CA98, 37353950835297000, 90124736, 90124738, 2, 640x360 
0x1382CA98, 37353950835613560, 90124768, 90124771, 3, 640x360 
0x1382CA98, 37353950835930560, 90124797, 90124805, 8, 640x360 
0x1382CA98, 37353950836246488, 90124831, 90124834, 3, 640x360 
0x1382CA98, 37353950836563280, 90124854, 90124857, 3, 640x360 
0x1382CA98, 37353950836881104, 90124900, 90124904, 4, 640x360 
0x1382CA98, 37353950837202432, 90124926, 90124937, 11, 640x360 
0x1382CA98, 37353950837522928, 90124951, 90124955, 4, 640x360 
0x1382CA98, 37353950838000400, 90125005, 90125008, 3, 640x360 
0x1382CA98, 37353950838320512, 90125038, 90125040, 2, 640x360 
0x1382CA98, 37353950838640984, 90125065, 90125071, 6, 640x360 
0x1382CA98, 37353950838961136, 90125096, 90125104, 8, 640x360 
0x1382CA98, 37353950839297888, 90125130, 90125136, 6, 640x360 
0x1382CA98, 37353950839612008, 90125161, 90125173, 12, 640x360 
0x1382CA98, 37353950839926776, 90125193, 90125198, 5, 640x360 
0x1382CA98, 37353950840243288, 90125229, 90125232, 3, 640x360 
0x1382CA98, 37353950840560856, 90125253, 90125261, 8, 640x360 
0x1382CA98, 37353950840881104, 90125289, 90125291, 2, 640x360 
0x1382CA98, 37353950841201272, 90125324, 90125326, 2, 640x360 
0x1382CA98, 37353950841521128, 90125350, 90125352, 2, 640x360 
0x1382CA98, 37353950842010192, 90125401, 90125407, 6, 640x360 
0x1382CA98, 37353950842321176, 90125427, 90125432, 5, 640x360 
0x1382CA98, 37353950842646376, 90125460, 90125465, 5, 640x360 
0x1382CA98, 37353950842961272, 90125490, 90125494, 4, 640x360 
0x1382CA98, 37353950843282216, 90125525, 90125531, 6, 640x360 
0x1382CA98, 37353950843616288, 90125556, 90125562, 6, 640x360 
0x1382CA98, 37353950843922568, 90125599, 90125602, 3, 640x360 
0x1382CA98, 37353950844245560, 90125620, 90125623, 3, 640x360 
0x1382CA98, 37353950844567728, 90125659, 90125663, 4, 640x360 
0x1382CA98, 37353950844881656, 90125690, 90125692, 2, 640x360 
0x1382CA98, 37353950845204968, 90125723, 90125725, 2, 640x360 
0x1382CA98, 37353950845526688, 90125749, 90125752, 3, 640x360 
0x1382CA98, 37353950846001528, 90125801, 90125803, 2, 640x360 
0x1382CA98, 37353950846323192, 90125832, 90125835, 3, 640x360 
0x1382CA98, 37353950846641152, 90125863, 90125866, 3, 640x360 
0x1382CA98, 37353950846963392, 90125895, 90125904, 9, 640x360 
0x1382CA98, 37353950847287736, 90125932, 90125938, 6, 640x360 
0x1382CA98, 37353950847611728, 90125961, 90125964, 3, 640x360 
0x1382CA98, 37353950847921392, 90125988, 90125990, 2, 640x360 
0x1382CA98, 37353950848251432, 90126022, 90126024, 2, 640x360 
0x1382CA98, 37353950848567704, 90126053, 90126056, 3, 640x360 
0x1382CA98, 37353950848882736, 90126092, 90126104, 12, 640x360 
0x1382CA98, 37353950849202520, 90126122, 90126124, 2, 640x360 
0x1382CA98, 37353950849521784, 90126155, 90126157, 2, 640x360 
0x1382CA98, 37353950850004176, 90126206, 90126208, 2, 640x360 
0x1382CA98, 37353950850322528, 90126236, 90126242, 6, 640x360 
0x1382CA98, 37353950850640696, 90126262, 90126266, 4, 640x360 
0x1382CA98, 37353950850961224, 90126296, 90126303, 7, 640x360 
0x1382CA98, 37353950851318912, 90126352, 90126354, 2, 640x360 
0x1382CA98, 37353950851608984, 90126370, 90126372, 2, 640x360 
0x1382CA98, 37353950851930352, 90126396, 90126402, 6, 640x360 
0x1382CA98, 37353950852240712, 90126427, 90126432, 5, 640x360 
0x1382CA98, 37353950852575688, 90126454, 90126457, 3, 640x360 
0x1382CA98, 37353950852886424, 90126502, 90126505, 3, 640x360 
0x1382CA98, 37353950853201824, 90126531, 90126534, 3, 640x360 
0x1382CA98, 37353950853520856, 90126548, 90126560, 12, 640x360 
0x1382CA98, 37353950854000400, 90126601, 90126603, 2, 640x360 
0x1382CA98, 37353950854320360, 90126636, 90126639, 3, 640x360 
0x1382CA98, 37353950854644248, 90126694, 90126703, 9, 640x360 
0x1382CA98, 37353950854968728, 90126708, 90126714, 6, 640x360 
0x1382CA98, 37353950855307528, 90126742, 90126746, 4, 640x360 
0x1382CA98, 37353950855611600, 90126771, 90126773, 2, 640x360 
0x1382CA98, 37353950855922488, 90126793, 90126807, 14, 640x360 
0x1382CA98, 37353950856240944, 90126825, 90126828, 3, 640x360 
0x1382CA98, 37353950856565320, 90126857, 90126859, 2, 640x360 
0x1382CA98, 37353950856880536, 90126896, 90126904, 8, 640x360 
0x1382CA98, 37353950857201136, 90126930, 90126937, 7, 640x360 
0x1382CA98, 37353950857521544, 90126958, 90126960, 2, 640x360 
0x1382CA98, 37353950858000200, 90127006, 90127011, 5, 640x360 
0x1382CA98, 37353950858322272, 90127029, 90127035, 6, 640x360 
0x1382CA98, 37353950858643840, 90127065, 90127072, 7, 640x360 
0x1382CA98, 37353950858960784, 90127097, 90127104, 7, 640x360 
0x1382CA98, 37353950859302248, 90127130, 90127134, 4, 640x360 
0x1382CA98, 37353950859605392, 90127158, 90127160, 2, 640x360 
0x1382CA98, 37353950859920768, 90127192, 90127196, 4, 640x360 
0x1382CA98, 37353950860240312, 90127224, 90127227, 3, 640x360 
0x1382CA98, 37353950860560440, 90127265, 90127272, 7, 640x360 
0x1382CA98, 37353950860884472, 90127288, 90127296, 8, 640x360 
0x1382CA98, 37353950861200544, 90127327, 90127332, 5, 640x360 
0x1382CA98, 37353950861534040, 90127357, 90127363, 6, 640x360 
0x1382CA98, 37353950861999880, 90127405, 90127407, 2, 640x360 
0x1382CA98, 37353950862320544, 90127436, 90127443, 7, 640x360 
0x1382CA98, 37353950862642104, 90127472, 90127478, 6, 640x360 
0x1382CA98, 37353950862960792, 90127493, 90127506, 13, 640x360 
0x1382CA98, 37353950863284888, 90127525, 90127529, 4, 640x360 
0x1382CA98, 37353950863608040, 90127562, 90127568, 6, 640x360 
0x1382CA98, 37353950863928928, 90127589, 90127596, 7, 640x360 
0x1382CA98, 37353950864249720, 90127622, 90127626, 4, 640x360 
0x1382CA98, 37353950864561264, 90127663, 90127666, 3, 640x360 
0x1382CA98, 37353950864885872, 90127691, 90127694, 3, 640x360 
0x1382CA98, 37353950865210160, 90127723, 90127724, 1, 640x360 
0x1382CA98, 37353950865526296, 90127749, 90127751, 2, 640x360 
0x1382CA98, 37353950865840600, 90127780, 90127783, 3, 640x360 
0x1382CA98, 37353950866320744, 90127833, 90127835, 2, 640x360 
0x1382CA98, 37353950866640896, 90127860, 90127863, 3, 640x360 
0x1382CA98, 37353950866965280, 90127894, 90127896, 2, 640x360 
0x1382CA98, 37353950867287536, 90127928, 90127933, 5, 640x360 
0x1382CA98, 37353950867602976, 90127959, 90127964, 5, 640x360 
0x1382CA98, 37353950867968616, 90128002, 90128006, 4, 640x360 
0x1382CA98, 37353950868243016, 90128022, 90128024, 2, 640x360 
0x1382CA98, 37353950868560680, 90128057, 90128059, 2, 640x360 
0x1382CA98, 37353950868882136, 90128091, 90128094, 3, 640x360 
0x1382CA98, 37353950869203384, 90128130, 90128132, 2, 640x360 
0x1382CA98, 37353950869524048, 90128151, 90128154, 3, 640x360 
0x1382CA98, 37353950869845560, 90128187, 90128189, 2, 640x360 
0x1382CA98, 37353950870323424, 90128254, 90128262, 8, 640x360 
0x1382CA98, 37353950870641816, 90128276, 90128282, 6, 640x360 
0x1382CA98, 37353950870967448, 90128306, 90128308, 2, 640x360 
0x1382CA98, 37353950871284040, 90128340, 90128342, 2, 640x360 
0x1382CA98, 37353950871611616, 90128369, 90128371, 2, 640x360 
0x1382CA98, 37353950871922296, 90128415, 90128429, 14, 640x360 
0x1382CA98, 37353950872241688, 90128447, 90128451, 4, 640x360 
0x1382CA98, 37353950872570120, 90128466, 90128472, 6, 640x360 
0x1382CA98, 37353950872882832, 90128495, 90128513, 18, 640x360 
0x1382CA98, 37353950873216408, 90128531, 90128533, 2, 640x360 
0x1382CA98, 37353950873538608, 90128567, 90128571, 4, 640x360 
0x1382CA98, 37353950873842072, 90128584, 90128586, 2, 640x360 
0x1382CA98, 37353950874324568, 90128640, 90128642, 2, 640x360 
0x1382CA98, 37353950874639576, 90128673, 90128675, 2, 640x360 
0x1382CA98, 37353950874967640, 90128705, 90128707, 2, 640x360 
0x1382CA98, 37353950875281104, 90128727, 90128738, 11, 640x360 
0x1382CA98, 37353950875612816, 90128768, 90128773, 5, 640x360 
0x1382CA98, 37353950875936304, 90128800, 90128802, 2, 640x360 
0x1382CA98, 37353950876239984, 90128822, 90128824, 2, 640x360 
0x1382CA98, 37353950876560024, 90128858, 90128860, 2, 640x360 
0x1382CA98, 37353950876885320, 90128890, 90128894, 4, 640x360 
0x1382CA98, 37353950877200056, 90128925, 90128928, 3, 640x360 
0x1382CA98, 37353950877524968, 90128962, 90128972, 10, 640x360 
0x1382CA98, 37353950877845320, 90128984, 90128991, 7, 640x360 
0x1382CA98, 37353950878319400, 90129026, 90129037, 11, 640x360 
0x1382CA98, 37353950878639552, 90129062, 90129071, 9, 640x360 
0x1382CA98, 37353950878959432, 90129107, 90129108, 1, 640x360 
0x1382CA98, 37353950879282000, 90129134, 90129136, 2, 640x360 
0x1382CA98, 37353950879606688, 90129160, 90129169, 9, 640x360 
0x1382CA98, 37353950879935024, 90129191, 90129195, 4, 640x360 
0x1382CA98, 37353950880239960, 90129223, 90129227, 4, 640x360 
0x1382CA98, 37353950880560048, 90129256, 90129259, 3, 640x360 
0x1382CA98, 37353950880880040, 90129284, 90129287, 3, 640x360 
0x1382CA98, 37353950881206168, 90129317, 90129325, 8, 640x360 
0x1382CA98, 37353950881520392, 90129349, 90129355, 6, 640x360 
0x1382CA98, 37353950881841064, 90129382, 90129385, 3, 640x360 
0x1382CA98, 37353950882320584, 90129428, 90129431, 3, 640x360 
0x1382CA98, 37353950882640352, 90129461, 90129466, 5, 640x360 
0x1382CA98, 37353950882964280, 90129497, 90129499, 2, 640x360 
0x1382CA98, 37353950883280160, 90129523, 90129526, 3, 640x360 
0x1382CA98, 37353950883604792, 90129557, 90129560, 3, 640x360 
0x1382CA98, 37353950883925736, 90129590, 90129592, 2, 640x360 
0x1382CA98, 37353950884240584, 90129629, 90129633, 4, 640x360 
0x1382CA98, 37353950884560568, 90129661, 90129665, 4, 640x360 
0x1382CA98, 37353950884880248, 90129684, 90129687, 3, 640x360 
0x1382CA98, 37353950885204864, 90129722, 90129724, 2, 640x360 
0x1382CA98, 37353950885523560, 90129754, 90129760, 6, 640x360 
0x1382CA98, 37353950885840728, 90129779, 90129782, 3, 640x360 
0x1382CA98, 37353950886319928, 90129825, 90129828, 3, 640x360 
0x1382CA98, 37353950886640472, 90129866, 90129869, 3, 640x360 
0x1382CA98, 37353950886975824, 90129925, 90129937, 12, 640x360 
0x1382CA98, 37353950887296176, 90129937, 90129941, 4, 640x360 
0x1382CA98, 37353950887616976, 90129969, 90129971, 2, 640x360 
0x1382CA98, 37353950887922824, 90129997, 90130004, 7, 640x360 
0x1382CA98, 37353950888300400, 90130033, 90130041, 8, 640x360 
0x1382CA98, 37353950888569064, 90130057, 90130059, 2, 640x360 
0x1382CA98, 37353950888883624, 90130090, 90130092, 2, 640x360 
0x1382CA98, 37353950889203496, 90130125, 90130131, 6, 640x360 
0x1382CA98, 37353950889532608, 90130157, 90130161, 4, 640x360 
0x1382CA98, 37353950889843136, 90130181, 90130184, 3, 640x360 
0x1382CA98, 37353950890161296, 90130219, 90130226, 7, 640x360 
0x1382CA98, 37353950890639720, 90130272, 90130274, 2, 640x360 
0x1382CA98, 37353950890965592, 90130307, 90130313, 6, 640x360 
0x1382CA98, 37353950891282768, 90130326, 90130338, 12, 640x360 
0x1382CA98, 37353950891616792, 90130373, 90130375, 2, 640x360 
0x1382CA98, 37353950891923240, 90130391, 90130398, 7, 640x360 
0x1382CA98, 37353950892241904, 90130430, 90130433, 3, 640x360 
0x1382CA98, 37353950892563760, 90130453, 90130455, 2, 640x360 
0x1382CA98, 37353950892880512, 90130488, 90130491, 3, 640x360 
0x1382CA98, 37353950893204856, 90130517, 90130528, 11, 640x360 
0x1382CA98, 37353950893542568, 90130553, 90130555, 2, 640x360 
0x1382CA98, 37353950893852480, 90130590, 90130591, 1, 640x360 
0x1382CA98, 37353950894161928, 90130617, 90130624, 7, 640x360 
0x1382CA98, 37353950894643152, 90130673, 90130675, 2, 640x360 
0x1382CA98, 37353950894967352, 90130700, 90130702, 2, 640x360 
0x1382CA98, 37353950895281824, 90130726, 90130732, 6, 640x360 
0x1382CA98, 37353950895605600, 90130766, 90130768, 2, 640x360 
0x1382CA98, 37353950895928472, 90130791, 90130794, 3, 640x360 
0x1382CA98, 37353950896266296, 90130824, 90130826, 2, 640x360 
0x1382CA98, 37353950896559544, 90130856, 90130859, 3, 640x360 
0x1382CA98, 37353950896880304, 90130901, 90130904, 3, 640x360 
0x1382CA98, 37353950897203272, 90130930, 90130933, 3, 640x360 
0x1382CA98, 37353950897535856, 90130970, 90131003, 33, 640x360 
0x1382CA98, 37353950897851904, 90131009, 90131016, 7, 640x360 
0x1382CA98, 37353950898178016, 90131040, 90131043, 3, 640x360 
0x1382CA98, 37353950898639904, 90131068, 90131070, 2, 640x360 
0x1382CA98, 37353950898964800, 90131101, 90131104, 3, 640x360 
0x1382CA98, 37353950899325736, 90131139, 90131142, 3, 640x360 
0x1382CA98, 37353950899600368, 90131157, 90131162, 5, 640x360 
0x1382CA98, 37353950899929376, 90131190, 90131196, 6, 640x360 
0x1382CA98, 37353950900242976, 90131230, 90131238, 8, 640x360 
0x1382CA98, 37353950900563552, 90131266, 90131272, 6, 640x360 
0x1382CA98, 37353950900879448, 90131298, 90131300, 2, 640x360 
0x1382CA98, 37353950901203176, 90131323, 90131326, 3, 640x360 
0x1382CA98, 37353950901520808, 90131357, 90131360, 3, 640x360 
0x1382CA98, 37353950901843728, 90131385, 90131390, 5, 640x360 
0x1382CA98, 37353950902160616, 90131419, 90131421, 2, 640x360 
0x1382CA98, 37353950902638960, 90131465, 90131468, 3, 640x360 
0x1382CA98, 37353950902964584, 90131490, 90131494, 4, 640x360 
0x1382CA98, 37353950903281080, 90131523, 90131526, 3, 640x360 
0x1382CA98, 37353950903613368, 90131559, 90131565, 6, 640x360 
0x1382CA98, 37353950903920408, 90131590, 90131593, 3, 640x360 
0x1382CA98, 37353950904240304, 90131623, 90131625, 2, 640x360 
0x1382CA98, 37353950904560264, 90131658, 90131661, 3, 640x360 
0x1382CA98, 37353950904885368, 90131685, 90131688, 3, 640x360 
0x1382CA98, 37353950905199824, 90131717, 90131721, 4, 640x360 
0x1382CA98, 37353950905520144, 90131749, 90131754, 5, 640x360 
0x1382CA98, 37353950905840192, 90131778, 90131782, 4, 640x360 
0x1382CA98, 37353950906163736, 90131816, 90131818, 2, 640x360 
0x1382CA98, 37353950906639328, 90131861, 90131868, 7, 640x360 
0x1382CA98, 37353950906959736, 90131892, 90131900, 8, 640x360 
0x1382CA98, 37353950907302600, 90131940, 90131949, 9, 640x360 
0x1382CA98, 37353950907617712, 90131969, 90131971, 2, 640x360 
0x1382CA98, 37353950907919680, 90131991, 90131999, 8, 640x360 
0x1382CA98, 37353950908304456, 90132037, 90132040, 3, 640x360 
0x1382CA98, 37353950908560136, 90132057, 90132060, 3, 640x360 
0x1382CA98, 37353950908894336, 90132098, 90132101, 3, 640x360 
0x1382CA98, 37353950909199248, 90132123, 90132125, 2, 640x360 
0x1382CA98, 37353950909519448, 90132157, 90132164, 7, 640x360 
0x1382CA98, 37353950909868600, 90132183, 90132186, 3, 640x360 
0x1382CA98, 37353950910159504, 90132226, 90132230, 4, 640x360 
0x1382CA98, 37353950910644672, 90132262, 90132265, 3, 640x360 
0x1382CA98, 37353950910958864, 90132291, 90132298, 7, 640x360 
0x1382CA98, 37353950911281800, 90132325, 90132331, 6, 640x360 
0x1382CA98, 37353950911618024, 90132363, 90132372, 9, 640x360 
0x1382CA98, 37353950911921784, 90132388, 90132391, 3, 640x360 
0x1382CA98, 37353950912250664, 90132419, 90132421, 2, 640x360 
0x1382CA98, 37353950912559320, 90132460, 90132464, 4, 640x360 
0x1382CA98, 37353950912886000, 90132486, 90132489, 3, 640x360 
0x1382CA98, 37353950913204128, 90132517, 90132520, 3, 640x360 
0x1382CA98, 37353950913519024, 90132550, 90132554, 4, 640x360 
0x1382CA98, 37353950913840848, 90132584, 90132588, 4, 640x360 
0x1382CA98, 37353950914163832, 90132618, 90132621, 3, 640x360 
0x1382CA98, 37353950914638848, 90132674, 90132678, 4, 640x360 
0x1382CA98, 37353950914962408, 90132713, 90132715, 2, 640x360 
0x1382CA98, 37353950915291928, 90132734, 90132736, 2, 640x360 
0x1382CA98, 37353950915618896, 90132763, 90132772, 9, 640x360 
0x1382CA98, 37353950915919224, 90132790, 90132795, 5, 640x360 
0x1382CA98, 37353950916238624, 90132821, 90132824, 3, 640x360 
0x1382CA98, 37353950916558752, 90132854, 90132856, 2, 640x360 
0x1382CA98, 37353950916879360, 90132896, 90132899, 3, 640x360 
0x1382CA98, 37353950917198976, 90132918, 90132922, 4, 640x360 
0x1382CA98, 37353950917525360, 90132957, 90132962, 5, 640x360 
0x1382CA98, 37353950917852584, 90132986, 90132989, 3, 640x360 
0x1382CA98, 37353950918177000, 90133030, 90133034, 4, 640x360 
0x1382CA98, 37353950918495064, 90133066, 90133069, 3, 640x360 
0x1382CA98, 37353950918967032, 90133094, 90133104, 10, 640x360 
0x1382CA98, 37353950919283024, 90133137, 90133140, 3, 640x360 
0x1382CA98, 37353950919621792, 90133165, 90133171, 6, 640x360 
0x1382CA98, 37353950919919360, 90133193, 90133197, 4, 640x360 
0x1382CA98, 37353950920242304, 90133225, 90133231, 6, 640x360 
0x1382CA98, 37353950920559320, 90133260, 90133271, 11, 640x360 
0x1382CA98, 37353950920889240, 90133297, 90133308, 11, 640x360 
0x1382CA98, 37353950921206920, 90133323, 90133327, 4, 640x360 
0x1382CA98, 37353950921529272, 90133362, 90133371, 9, 640x360 
0x1382CA98, 37353950921848760, 90133385, 90133389, 4, 640x360 
0x1382CA98, 37353950922165040, 90133417, 90133424, 7, 640x360 
0x1382CA98, 37353950922481688, 90133450, 90133453, 3, 640x360 
0x1382CA98, 37353950922960600, 90133492, 90133499, 7, 640x360 
0x1382CA98, 37353950923279312, 90133530, 90133532, 2, 640x360 
0x1382CA98, 37353950923606680, 90133565, 90133569, 4, 640x360 
0x1382CA98, 37353950923923760, 90133590, 90133600, 10, 640x360 
0x1382CA98, 37353950924238840, 90133628, 90133633, 5, 640x360 
0x1382CA98, 37353950924558560, 90133654, 90133657, 3, 640x360 
0x1382CA98, 37353950924878944, 90133691, 90133697, 6, 640x360 
0x1382CA98, 37353950925215344, 90133724, 90133727, 3, 640x360 
0x1382CA98, 37353950925522672, 90133756, 90133758, 2, 640x360 
0x1382CA98, 37353950925839736, 90133790, 90133792, 2, 640x360 
0x1382CA98, 37353950926173160, 90133819, 90133820, 1, 640x360 
0x1382CA98, 37353950926502600, 90133848, 90133856, 8, 640x360 
0x1382CA98, 37353950926959696, 90133896, 90133903, 7, 640x360 
0x1382CA98, 37353950927284064, 90133930, 90133936, 6, 640x360 
0x1382CA98, 37353950927625496, 90133962, 90133970, 8, 640x360 
0x1382CA98, 37353950927922984, 90133997, 90134001, 4, 640x360 
0x1382CA98, 37353950928273616, 90134032, 90134035, 3, 640x360 
0x1382CA98, 37353950928567512, 90134055, 90134057, 2, 640x360 
0x1382CA98, 37353950928891176, 90134084, 90134086, 2, 640x360 
0x1382CA98, 37353950929198704, 90134117, 90134119, 2, 640x360 
0x1382CA98, 37353950929533640, 90134155, 90134157, 2, 640x360 
0x1382CA98, 37353950929848664, 90134185, 90134192, 7, 640x360 
0x1382CA98, 37353950930159248, 90134219, 90134222, 3, 640x360 
0x1382CA98, 37353950930479168, 90134252, 90134256, 4, 640x360 
0x1382CA98, 37353950930958520, 90134300, 90134307, 7, 640x360 
0x1382CA98, 37353950931306568, 90134342, 90134347, 5, 640x360 
0x1382CA98, 37353950931624232, 90134368, 90134370, 2, 640x360 
0x1382CA98, 37353950931920872, 90134390, 90134394, 4, 640x360 
0x1382CA98, 37353950932238840, 90134431, 90134434, 3, 640x360 
0x1382CA98, 37353950932569704, 90134465, 90134473, 8, 640x360 
0x1382CA98, 37353950932882328, 90134485, 90134488, 3, 640x360 
0x1382CA98, 37353950933204512, 90134524, 90134527, 3, 640x360 
0x1382CA98, 37353950933522232, 90134552, 90134557, 5, 640x360 
0x1382CA98, 37353950933842304, 90134584, 90134592, 8, 640x360 
0x1382CA98, 37353950934164784, 90134618, 90134620, 2, 640x360 
0x1382CA98, 37353950934479728, 90134650, 90134652, 2, 640x360 
0x1382CA98, 37353950934958504, 90134693, 90134703, 10, 640x360 
0x1382CA98, 37353950935299288, 90134745, 90134753, 8, 640x360 
0x1382CA98, 37353950935624152, 90134767, 90134770, 3, 640x360 
0x1382CA98, 37353950935922200, 90134796, 90134803, 7, 640x360 
0x1382CA98, 37353950936242088, 90134825, 90134835, 10, 640x360 
0x1382CA98, 37353950936561224, 90134856, 90134860, 4, 640x360 
0x1382CA98, 37353950936879256, 90134891, 90134897, 6, 640x360 
0x1382CA98, 37353950937200008, 90134928, 90134931, 3, 640x360 
0x1382CA98, 37353950937523720, 90134955, 90134961, 6, 640x360 
0x1382CA98, 37353950937838160, 90134992, 90134997, 5, 640x360 
0x1382CA98, 37353950938158296, 90135019, 90135021, 2, 640x360 
0x1382CA98, 37353950938478552, 90135043, 90135047, 4, 640x360 
0x1382CA98, 37353950938959240, 90135097, 90135102, 5, 640x360 
0x1382CA98, 37353950939278912, 90135124, 90135137, 13, 640x360 
0x1382CA98, 37353950939599488, 90135168, 90135170, 2, 640x360 
0x1382CA98, 37353950939940616, 90135193, 90135200, 7, 640x360 
0x1382CA98, 37353950940241992, 90135231, 90135234, 3, 640x360 
0x1382CA98, 37353950940576544, 90135272, 90135277, 5, 640x360 
0x1382CA98, 37353950940889488, 90135295, 90135307, 12, 640x360 
0x1382CA98, 37353950941217136, 90135325, 90135337, 12, 640x360 
0x1382CA98, 37353950941521344, 90135359, 90135365, 6, 640x360 
0x1382CA98, 37353950941845208, 90135389, 90135392, 3, 640x360 
0x1382CA98, 37353950942183952, 90135423, 90135427, 4, 640x360 
0x1382CA98, 37353950942487520, 90135451, 90135453, 2, 640x360 
0x1382CA98, 37353950942962840, 90135507, 90135511, 4, 640x360 
0x1382CA98, 37353950943285952, 90135530, 90135543, 13, 640x360 
0x1382CA98, 37353950943616568, 90135568, 90135572, 4, 640x360 
0x1382CA98, 37353950943918360, 90135602, 90135617, 15, 640x360 
0x1382CA98, 37353950944257592, 90135636, 90135638, 2, 640x360 
0x1382CA98, 37353950944562720, 90135676, 90135681, 5, 640x360 
0x1382CA98, 37353950944887536, 90135697, 90135701, 4, 640x360 
0x1382CA98, 37353950945201872, 90135724, 90135730, 6, 640x360 
0x1382CA98, 37353950945523112, 90135766, 90135773, 7, 640x360 
0x1382CA98, 37353950945861096, 90135797, 90135804, 7, 640x360 
0x1382CA98, 37353950946164968, 90135837, 90135847, 10, 640x360 
0x1382CA98, 37353950946506680, 90135872, 90135876, 4, 640x360 
0x1382CA98, 37353950946816144, 90135898, 90135905, 7, 640x360 
0x1382CA98, 37353950947281352, 90135934, 90135936, 2, 640x360 
0x1382CA98, 37353950947611712, 90135956, 90135960, 4, 640x360 
0x1382CA98, 37353950947942352, 90135990, 90135997, 7, 640x360 
0x1382CA98, 37353950948238456, 90136034, 90136040, 6, 640x360 
0x1382CA98, 37353950948558632, 90136067, 90136070, 3, 640x360 
0x1382CA98, 37353950948882520, 90136098, 90136101, 3, 640x360 
0x1382CA98, 37353950949250280, 90136124, 90136130, 6, 640x360 
0x1382CA98, 37353950949542808, 90136152, 90136162, 10, 640x360 
0x1382CA98, 37353950949844456, 90136197, 90136201, 4, 640x360 
0x1382CA98, 37353950950160696, 90136235, 90136246, 11, 640x360 
0x1382CA98, 37353950950480712, 90136261, 90136264, 3, 640x360 
0x1382CA98, 37353950950803888, 90136287, 90136297, 10, 640x360 
0x1382CA98, 37353950951301320, 90136343, 90136348, 5, 640x360 
0x1382CA98, 37353950951607720, 90136381, 90136384, 3, 640x360 
0x1382CA98, 37353950951940680, 90136424, 90136438, 14, 640x360 
0x1382CA98, 37353950952238264, 90136456, 90136462, 6, 640x360 
0x1382CA98, 37353950952566072, 90136479, 90136488, 9, 640x360 
0x1382CA98, 37353950952883904, 90136488, 90136513, 25, 640x360 
0x1382CA98, 37353950953207440, 90136530, 90136533, 3, 640x360 
0x1382CA98, 37353950953518872, 90136561, 90136564, 3, 640x360 
0x1382CA98, 37353950953866528, 90136599, 90136601, 2, 640x360 
0x1382CA98, 37353950954158832, 90136623, 90136627, 4, 640x360 
0x1382CA98, 37353950954486624, 90136651, 90136655, 4, 640x360 
0x1382CA98, 37353950954803792, 90136706, 90136711, 5, 640x360 
0x1382CA98, 37353950955283384, 90136732, 90136741, 9, 640x360 
0x1382CA98, 37353950955604360, 90136771, 90136774, 3, 640x360 
0x1382CA98, 37353950955968200, 90136803, 90136806, 3, 640x360 
0x1382CA98, 37353950956241136, 90136831, 90136838, 7, 640x360 
0x1382CA98, 37353950956567248, 90136859, 90136864, 5, 640x360 
0x1382CA98, 37353950956971784, 90136915, 90136920, 5, 640x360 
0x1382CA98, 37353950957212480, 90136941, 90136947, 6, 640x360 
0x1382CA98, 37353950957532680, 90136989, 90137000, 11, 640x360 
0x1382CA98, 37353950957849552, 90137000, 90137004, 4, 640x360 
0x1382CA98, 37353950958170592, 90137030, 90137033, 3, 640x360 
0x1382CA98, 37353950958485376, 90137058, 90137065, 7, 640x360 
0x1382CA98, 37353950958815072, 90137091, 90137098, 7, 640x360 
0x1382CA98, 37353950959343752, 90137155, 90137160, 5, 640x360 
0x1382CA98, 37353950959599704, 90137166, 90137179, 13, 640x360 
0x1382CA98, 37353950959952312, 90137208, 90137211, 3, 640x360 
0x1382CA98, 37353950960238088, 90137234, 90137236, 2, 640x360 
0x1382CA98, 37353950960560760, 90137258, 90137264, 6, 640x360 
0x1382CA98, 37353950960898080, 90137301, 90137306, 5, 640x360 
0x1382CA98, 37353950961200040, 90137330, 90137333, 3, 640x360 
0x1382CA98, 37353950961518600, 90137355, 90137360, 5, 640x360 
0x1382CA98, 37353950961857504, 90137383, 90137394, 11, 640x360 
0x1382CA98, 37353950962158696, 90137437, 90137439, 2, 640x360 
0x1382CA98, 37353950962487064, 90137453, 90137457, 4, 640x360 
0x1382CA98, 37353950962840736, 90137494, 90137504, 10, 640x360 
0x1382CA98, 37353950963294504, 90137549, 90137557, 8, 640x360 
0x1382CA98, 37353950963613976, 90137574, 90137579, 5, 640x360 
0x1382CA98, 37353950963924352, 90137615, 90137618, 3, 640x360 
0x1382CA98, 37353950964260872, 90137631, 90137640, 9, 640x360 
0x1382CA98, 37353950964562872, 90137685, 90137692, 7, 640x360 
0x1382CA98, 37353950964886552, 90137704, 90137717, 13, 640x360 
0x1382CA98, 37353950965199104, 90137729, 90137732, 3, 640x360 
0x1382CA98, 37353950965518048, 90137757, 90137761, 4, 640x360 
0x1382CA98, 37353950965840880, 90137791, 90137796, 5, 640x360 
0x1382CA98, 37353950966163480, 90137818, 90137821, 3, 640x360 
0x1382CA98, 37353950966480192, 90137855, 90137858, 3, 640x360 
0x1382CA98, 37353950966803328, 90137894, 90137899, 5, 640x360 
0x1382CA98, 37353950967278176, 90137939, 90137941, 2, 640x360 
0x1382CA98, 37353950967611584, 90137968, 90137970, 2, 640x360 
0x1382CA98, 37353950967944160, 90137991, 90138005, 14, 640x360 
0x1382CA98, 37353950968243520, 90138029, 90138034, 5, 640x360 
0x1382CA98, 37353950968557200, 90138057, 90138060, 3, 640x360 
0x1382CA98, 37353950968897104, 90138102, 90138104, 2, 640x360 
0x1382CA98, 37353950969201488, 90138124, 90138129, 5, 640x360 
0x1382CA98, 37353950969517432, 90138149, 90138162, 13, 640x360 
0x1382CA98, 37353950969837472, 90138186, 90138188, 2, 640x360 
0x1382CA98, 37353950970157424, 90138208, 90138213, 5, 640x360 
0x1382CA98, 37353950970478032, 90138250, 90138253, 3, 640x360 
0x1382CA98, 37353950970805120, 90138281, 90138289, 8, 640x360 
0x1382CA98, 37353950971117752, 90138317, 90138319, 2, 640x360 
0x1382CA98, 37353950971611952, 90138367, 90138370, 3, 640x360 
0x1382CA98, 37353950971923184, 90138400, 90138406, 6, 640x360 
0x1382CA98, 37353950972248016, 90138425, 90138430, 5, 640x360 
0x1382CA98, 37353950972569072, 90138457, 90138459, 2, 640x360 
0x1382CA98, 37353950972882592, 90138495, 90138497, 2, 640x360 
0x1382CA98, 37353950973211704, 90138521, 90138523, 2, 640x360 
0x1382CA98, 37353950973522240, 90138549, 90138555, 6, 640x360 
0x1382CA98, 37353950973841192, 90138582, 90138589, 7, 640x360 
0x1382CA98, 37353950974159648, 90138616, 90138618, 2, 640x360 
0x1382CA98, 37353950974480368, 90138648, 90138651, 3, 640x360 
0x1382CA98, 37353950974798224, 90138677, 90138682, 5, 640x360 
0x1382CA98, 37353950975121984, 90138708, 90138715, 7, 640x360 
0x1382CA98, 37353950975602056, 90138763, 90138771, 8, 640x360 
0x1382CA98, 37353950975919000, 90138797, 90138800, 3, 640x360 
0x1382CA98, 37353950976237216, 90138824, 90138833, 9, 640x360 
0x1382CA98, 37353950976557096, 90138861, 90138864, 3, 640x360 
0x1382CA98, 37353950976883696, 90138898, 90138904, 6, 640x360 
0x1382CA98, 37353950977198368, 90138919, 90138921, 2, 640x360 
0x1382CA98, 37353950977518096, 90138956, 90138959, 3, 640x360 
0x1382CA98, 37353950977852328, 90138991, 90138994, 3, 640x360 
0x1382CA98, 37353950978158200, 90139023, 90139025, 2, 640x360 
0x1382CA98, 37353950978477288, 90139050, 90139053, 3, 640x360 
0x1382CA98, 37353950978797424, 90139085, 90139087, 2, 640x360 
0x1382CA98, 37353950979118160, 90139113, 90139116, 3, 640x360 
0x1382CA98, 37353950979612336, 90139170, 90139180, 10, 640x360 
0x1382CA98, 37353950979951960, 90139203, 90139244, 41, 640x360 
0x1382CA98, 37353950980275768, 90139269, 90139373, 104, 640x360 
0x1382CA98, 37353950980669096, 90139374, 90139380, 6, 640x360 
0x1382CA98, 37353950981820216, 90139388, 90139395, 7, 640x360 
0x1382CA98, 37353950981993392, 90139419, 90139422, 3, 640x360 
0x1382CA98, 37353950982498312, 90139453, 90139456, 3, 640x360 
0x1382CA98, 37353950983176920, 90139521, 90139523, 2, 640x360 
0x1382CA98, 37353950983603352, 90139573, 90139577, 4, 640x360 
0x1382CA98, 37353950983921064, 90139597, 90139600, 3, 640x360 
0x1382CA98, 37353950984244776, 90139630, 90139638, 8, 640x360 
0x1382CA98, 37353950984557480, 90139669, 90139680, 11, 640x360 
0x1382CA98, 37353950984885240, 90139690, 90139693, 3, 640x360 
0x1382CA98, 37353950985217368, 90139723, 90139728, 5, 640x360 
0x1382CA98, 37353950985517512, 90139757, 90139771, 14, 640x360 
0x1382CA98, 37353950985854784, 90139784, 90139786, 2, 640x360 
0x1382CA98, 37353950986168768, 90139822, 90139824, 2, 640x360 
0x1382CA98, 37353950986484216, 90139844, 90139860, 16, 640x360 
0x1382CA98, 37353950986804016, 90139891, 90139898, 7, 640x360 
0x1382CA98, 37353950987140376, 90139934, 90139948, 14, 640x360 
0x1382CA98, 37353950987619176, 90139968, 90139974, 6, 640x360 
0x1382CA98, 37353950987922328, 90140004, 90140012, 8, 640x360 
0x1382CA98, 37353950988288368, 90140036, 90140040, 4, 640x360 
0x1382CA98, 37353950988565960, 90140068, 90140073, 5, 640x360 
0x1382CA98, 37353950988882616, 90140102, 90140108, 6, 640x360 
0x1382CA98, 37353950989199600, 90140124, 90140157, 33, 640x360 
0x1382CA98, 37353950989521768, 90140162, 90140168, 6, 640x360 
0x1382CA98, 37353950989845768, 90140189, 90140191, 2, 640x360 
0x1382CA98, 37353950990157000, 90140223, 90140226, 3, 640x360 
0x1382CA98, 37353950990480784, 90140251, 90140263, 12, 640x360 
0x1382CA98, 37353950990798008, 90140281, 90140293, 12, 640x360 
0x1382CA98, 37353950991122640, 90140309, 90140313, 4, 640x360 
0x1382CA98, 37353950991622992, 90140360, 90140370, 10, 640x360 
0x1382CA98, 37353950991925736, 90140389, 90140393, 4, 640x360 
0x1382CA98, 37353950992272760, 90140435, 90140446, 11, 640x360 
0x1382CA98, 37353950992563008, 90140459, 90140473, 14, 640x360 
0x1382CA98, 37353950992886664, 90140497, 90140499, 2, 640x360 
0x1382CA98, 37353950993211056, 90140523, 90140525, 2, 640x360 
0x1382CA98, 37353950993535352, 90140554, 90140557, 3, 640x360 
0x1382CA98, 37353950993836896, 90140585, 90140594, 9, 640x360 
0x1382CA98, 37353950994160760, 90140619, 90140620, 1, 640x360 
0x1382CA98, 37353950994477688, 90140646, 90140649, 3, 640x360 
0x1382CA98, 37353950994801224, 90140677, 90140680, 3, 640x360 
0x1382CA98, 37353950995117320, 90140707, 90140716, 9, 640x360 
0x1382CA98, 37353950995599072, 90140758, 90140764, 6, 640x360 
0x1382CA98, 37353950995920888, 90140790, 90140796, 6, 640x360 
0x1382CA98, 37353950996241264, 90140822, 90140830, 8, 640x360 
0x1382CA98, 37353950996560616, 90140862, 90140872, 10, 640x360 
0x1382CA98, 37353950996877008, 90140889, 90140900, 11, 640x360 
0x1382CA98, 37353950997197176, 90140916, 90140922, 6, 640x360 
0x1382CA98, 37353950997528384, 90140953, 90140962, 9, 640x360 
0x1382CA98, 37353950997836800, 90140985, 90140987, 2, 640x360 
0x1382CA98, 37353950998160128, 90141023, 90141025, 2, 640x360 
0x1382CA98, 37353950998481120, 90141049, 90141058, 9, 640x360 
0x1382CA98, 37353950998797528, 90141077, 90141079, 2, 640x360 
0x1382CA98, 37353950999117552, 90141109, 90141113, 4, 640x360 
0x1382CA98, 37353950999450608, 90141146, 90141149, 3, 640x360 
0x1382CA98, 37353950999916416, 90141195, 90141198, 3, 640x360 
0x1382CA98, 37353951000241960, 90141221, 90141229, 8, 640x360 
0x1382CA98, 37353951000556528, 90141255, 90141257, 2, 640x360 
0x1382CA98, 37353951000876600, 90141284, 90141288, 4, 640x360 
0x1382CA98, 37353951001197600, 90141315, 90141322, 7, 640x360 
0x1382CA98, 37353951001517112, 90141347, 90141350, 3, 640x360 
0x1382CA98, 37353951001842112, 90141383, 90141385, 2, 640x360 
0x1382CA98, 37353951002160560, 90141409, 90141412, 3, 640x360 
0x1382CA98, 37353951002481608, 90141440, 90141443, 3, 640x360 
0x1382CA98, 37353951002797824, 90141476, 90141479, 3, 640x360 
0x1382CA98, 37353951003119560, 90141509, 90141514, 5, 640x360 
0x1382CA98, 37353951003437648, 90141536, 90141539, 3, 640x360 
0x1382CA98, 37353951003917016, 90141587, 90141590, 3, 640x360 
0x1382CA98, 37353951004237888, 90141633, 90141635, 2, 640x360 
0x1382CA98, 37353951004558000, 90141664, 90141668, 4, 640x360 
0x1382CA98, 37353951004877664, 90141695, 90141699, 4, 640x360 
0x1382CA98, 37353951005196240, 90141723, 90141725, 2, 640x360 
0x1382CA98, 37353951005516368, 90141748, 90141754, 6, 640x360 
0x1382CA98, 37353951005836424, 90141782, 90141784, 2, 640x360 
0x1382CA98, 37353951006157480, 90141814, 90141817, 3, 640x360 
0x1382CA98, 37353951006483792, 90141850, 90141853, 3, 640x360 
0x1382CA98, 37353951006797144, 90141884, 90141890, 6, 640x360 
0x1382CA98, 37353951007121080, 90141915, 90141921, 6, 640x360 
0x1382CA98, 37353951007441448, 90141946, 90141948, 2, 640x360 
0x1382CA98, 37353951007919392, 90141994, 90141998, 4, 640x360 
0x1382CA98, 37353951008236000, 90142024, 90142026, 2, 640x360 
0x1382CA98, 37353951008556168, 90142055, 90142057, 2, 640x360 
0x1382CA98, 37353951008882280, 90142084, 90142086, 2, 640x360 
0x1382CA98, 37353951009205112, 90142121, 90142124, 3, 640x360 
0x1382CA98, 37353951009521384, 90142147, 90142155, 8, 640x360 
0x1382CA98, 37353951009846144, 90142183, 90142185, 2, 640x360 
0x1382CA98, 37353951010160536, 90142214, 90142216, 2, 640x360 
0x1382CA98, 37353951010480464, 90142247, 90142251, 4, 640x360 
0x1382CA98, 37353951010803952, 90142285, 90142287, 2, 640x360 
0x1382CA98, 37353951011117344, 90142309, 90142314, 5, 640x360 
0x1382CA98, 37353951011455336, 90142345, 90142348, 3, 640x360 
0x1382CA98, 37353951011923600, 90142389, 90142401, 12, 640x360 
0x1382CA98, 37353951012237184, 90142418, 90142423, 5, 640x360 
0x1382CA98, 37353951012556584, 90142457, 90142462, 5, 640x360 
0x1382CA98, 37353951012880664, 90142486, 90142490, 4, 640x360 
0x1382CA98, 37353951013200712, 90142522, 90142532, 10, 640x360 
0x1382CA98, 37353951013516848, 90142549, 90142555, 6, 640x360 
0x1382CA98, 37353951013838632, 90142580, 90142583, 3, 640x360 
0x1382CA98, 37353951014160264, 90142611, 90142613, 2, 640x360 
0x1382CA98, 37353951014477544, 90142648, 90142650, 2, 640x360 
0x1382CA98, 37353951014804768, 90142674, 90142682, 8, 640x360 
0x1382CA98, 37353951015120936, 90142705, 90142708, 3, 640x360 
0x1382CA98, 37353951015445392, 90142744, 90142750, 6, 640x360 
0x1382CA98, 37353951015959568, 90142800, 90142802, 2, 640x360 
0x1382CA98, 37353951016235888, 90142831, 90142833, 2, 640x360 
0x1382CA98, 37353951016556240, 90142856, 90142859, 3, 640x360 
0x1382CA98, 37353951016879888, 90142885, 90142888, 3, 640x360 
0x1382CA98, 37353951017201872, 90142928, 90142930, 2, 640x360 
0x1382CA98, 37353951017516768, 90142948, 90142955, 7, 640x360 
0x1382CA98, 37353951017837240, 90142977, 90142980, 3, 640x360 
0x1382CA98, 37353951018156576, 90143013, 90143020, 7, 640x360 
0x1382CA98, 37353951018477584, 90143045, 90143047, 2, 640x360 
0x1382CA98, 37353951018797312, 90143075, 90143078, 3, 640x360 
0x1382CA98, 37353951019117528, 90143106, 90143109, 3, 640x360 
0x1382CA98, 37353951019437728, 90143138, 90143140, 2, 640x360 
0x1382CA98, 37353951019916512, 90143189, 90143193, 4, 640x360 
0x1382CA98, 37353951020244784, 90143224, 90143228, 4, 640x360 
0x1382CA98, 37353951020569728, 90143252, 90143254, 2, 640x360 
0x1382CA98, 37353951020884416, 90143285, 90143289, 4, 640x360 
0x1382CA98, 37353951021197000, 90143316, 90143322, 6, 640x360 
0x1382CA98, 37353951021516912, 90143348, 90143355, 7, 640x360 
0x1382CA98, 37353951021837176, 90143382, 90143385, 3, 640x360 
0x1382CA98, 37353951022157008, 90143411, 90143414, 3, 640x360 
0x1382CA98, 37353951022480376, 90143443, 90143448, 5, 640x360 
0x1382CA98, 37353951022797232, 90143486, 90143492, 6, 640x360 
0x1382CA98, 37353951023116824, 90143506, 90143511, 5, 640x360 
0x1382CA98, 37353951023438800, 90143538, 90143541, 3, 640x360 
0x1382CA98, 37353951023921528, 90143589, 90143593, 4, 640x360 
0x1382CA98, 37353951024239480, 90143620, 90143623, 3, 640x360 
0x1382CA98, 37353951024569392, 90143661, 90143673, 12, 640x360 
0x1382CA98, 37353951024878544, 90143691, 90143695, 4, 640x360 
0x1382CA98, 37353951025200112, 90143723, 90143725, 2, 640x360 
0x1382CA98, 37353951025520728, 90143752, 90143754, 2, 640x360 
0x1382CA98, 37353951025836336, 90143784, 90143786, 2, 640x360 
0x1382CA98, 37353951026158064, 90143817, 90143820, 3, 640x360 
0x1382CA98, 37353951026477160, 90143851, 90143853, 2, 640x360 
0x1382CA98, 37353951026800576, 90143880, 90143883, 3, 640x360 
0x1382CA98, 37353951027116720, 90143912, 90143915, 3, 640x360 
0x1382CA98, 37353951027439872, 90143946, 90143950, 4, 640x360 
0x1382CA98, 37353951027766928, 90144002, 90144004, 2, 640x360 
0x1382CA98, 37353951028241256, 90144031, 90144034, 3, 640x360 
0x1382CA98, 37353951028556064, 90144058, 90144060, 2, 640x360 
0x1382CA98, 37353951028892896, 90144098, 90144100, 2, 640x360 
0x1382CA98, 37353951029200480, 90144132, 90144134, 2, 640x360 
0x1382CA98, 37353951029518696, 90144156, 90144160, 4, 640x360 
0x1382CA98, 37353951029855392, 90144193, 90144205, 12, 640x360 
0x1382CA98, 37353951030163776, 90144241, 90144255, 14, 640x360 
0x1382CA98, 37353951030485744, 90144266, 90144274, 8, 640x360 
0x1382CA98, 37353951030816552, 90144318, 90144322, 4, 640x360 
0x1382CA98, 37353951031160168, 90144323, 90144350, 27, 640x360 
0x1382CA98, 37353951031446712, 90144372, 90144382, 10, 640x360 
0x1382CA98, 37353951031782824, 90144406, 90144415, 9, 640x360 
0x1382CA98, 37353951032266712, 90144448, 90144474, 26, 640x360 
0x1382CA98, 37353951032575568, 90144491, 90144501, 10, 640x360 
0x1382CA98, 37353951032942672, 90144540, 90144553, 13, 640x360 
0x1382CA98, 37353951033554824, 90144604, 90144613, 9, 640x360 
0x1382CA98, 37353951034173248, 90144652, 90144657, 5, 640x360 
0x1382CA98, 37353951034602032, 90144682, 90144716, 34, 640x360 
0x1382CA98, 37353951034836880, 90144717, 90144740, 23, 640x360 
0x1382CA98, 37353951035149144, 90144758, 90144798, 40, 640x360 
0x1382CA98, 37353951035445832, 90144800, 90144815, 15, 640x360 
0x1382CA98, 37353951036302208, 90144840, 90144843, 3, 640x360 
0x1382CA98, 37353951036555512, 90144866, 90144875, 9, 640x360 
0x1382CA98, 37353951036879416, 90144888, 90144895, 7, 640x360 
0x1382CA98, 37353951037195336, 90144929, 90144937, 8, 640x360 
0x1382CA98, 37353951037519360, 90144950, 90144953, 3, 640x360 
0x1382CA98, 37353951037839376, 90144983, 90144991, 8, 640x360 
0x1382CA98, 37353951038156416, 90145017, 90145018, 1, 640x360 
0x1382CA98, 37353951038476760, 90145040, 90145044, 4, 640x360 
0x1382CA98, 37353951038795760, 90145076, 90145084, 8, 640x360 
0x1382CA98, 37353951039117576, 90145121, 90145123, 2, 640x360 
0x1382CA98, 37353951039437480, 90145150, 90145152, 2, 640x360 
0x1382CA98, 37353951039758344, 90145176, 90145181, 5, 640x360 
0x1382CA98, 37353951040235128, 90145227, 90145231, 4, 640x360 
0x1382CA98, 37353951040555144, 90145250, 90145256, 6, 640x360 
0x1382CA98, 37353951040887848, 90145288, 90145291, 3, 640x360 
0x1382CA98, 37353951041206648, 90145319, 90145321, 2, 640x360 
0x1382CA98, 37353951041521136, 90145358, 90145361, 3, 640x360 
0x1382CA98, 37353951041836976, 90145385, 90145387, 2, 640x360 
0x1382CA98, 37353951042162096, 90145420, 90145424, 4, 640x360 
0x1382CA98, 37353951042479328, 90145452, 90145453, 1, 640x360 
0x1382CA98, 37353951042795552, 90145477, 90145480, 3, 640x360 
0x1382CA98, 37353951043117464, 90145513, 90145516, 3, 640x360 
0x1382CA98, 37353951043436144, 90145542, 90145549, 7, 640x360 
0x1382CA98, 37353951043758856, 90145581, 90145585, 4, 640x360 
0x1382CA98, 37353951044235176, 90145637, 90145646, 9, 640x360 
0x1382CA98, 37353951044560144, 90145679, 90145682, 3, 640x360 
0x1382CA98, 37353951044880664, 90145705, 90145707, 2, 640x360 
0x1382CA98, 37353951045196384, 90145732, 90145740, 8, 640x360 
0x1382CA98, 37353951045515240, 90145754, 90145764, 10, 640x360 
0x1382CA98, 37353951045839568, 90145790, 90145793, 3, 640x360 
0x1382CA98, 37353951046163096, 90145824, 90145828, 4, 640x360 
0x1382CA98, 37353951046480120, 90145856, 90145858, 2, 640x360 
0x1382CA98, 37353951046805192, 90145885, 90145887, 2, 640x360 
0x1382CA98, 37353951047118208, 90145911, 90145925, 14, 640x360 
0x1382CA98, 37353951047442912, 90145952, 90145954, 2, 640x360 
0x1382CA98, 37353951047762568, 90145972, 90145975, 3, 640x360 
0x1382CA98, 37353951048239072, 90146024, 90146028, 4, 640x360 
0x1382CA98, 37353951048564600, 90146057, 90146065, 8, 640x360 
0x1382CA98, 37353951048880272, 90146090, 90146092, 2, 640x360 
0x1382CA98, 37353951049196048, 90146124, 90146130, 6, 640x360 
0x1382CA98, 37353951049515592, 90146148, 90146151, 3, 640x360 
0x1382CA98, 37353951049844168, 90146189, 90146193, 4, 640x360 
0x1382CA98, 37353951050158120, 90146218, 90146224, 6, 640x360 
0x1382CA98, 37353951050480288, 90146250, 90146255, 5, 640x360 
0x1382CA98, 37353951050807960, 90146282, 90146290, 8, 640x360 
0x1382CA98, 37353951051118432, 90146310, 90146320, 10, 640x360 
0x1382CA98, 37353951051442768, 90146340, 90146342, 2, 640x360 
0x1382CA98, 37353951051760344, 90146372, 90146374, 2, 640x360 
0x1382CA98, 37353951052235080, 90146428, 90146437, 9, 640x360 
0x1382CA98, 37353951052555632, 90146460, 90146469, 9, 640x360 
0x1382CA98, 37353951052876368, 90146492, 90146498, 6, 640x360 
0x1382CA98, 37353951053195992, 90146526, 90146531, 5, 640x360 
0x1382CA98, 37353951053514960, 90146552, 90146554, 2, 640x360 
0x1382CA98, 37353951053837944, 90146585, 90146593, 8, 640x360 
0x1382CA98, 37353951054159616, 90146616, 90146625, 9, 640x360 
0x1382CA98, 37353951054478960, 90146647, 90146650, 3, 640x360 
0x1382CA98, 37353951054799880, 90146679, 90146683, 4, 640x360 
0x1382CA98, 37353951055121224, 90146707, 90146710, 3, 640x360 
0x1382CA98, 37353951055441448, 90146741, 90146744, 3, 640x360 
0x1382CA98, 37353951055759808, 90146773, 90146775, 2, 640x360 
0x1382CA98, 37353951056076472, 90146805, 90146808, 3, 640x360 
0x1382CA98, 37353951056559056, 90146857, 90146859, 2, 640x360 
0x1382CA98, 37353951056880176, 90146896, 90146899, 3, 640x360 
0x1382CA98, 37353951057198864, 90146919, 90146922, 3, 640x360 
0x1382CA98, 37353951057515536, 90146957, 90146959, 2, 640x360 
0x1382CA98, 37353951057836960, 90146983, 90146985, 2, 640x360 
0x1382CA98, 37353951058160168, 90147016, 90147019, 3, 640x360 
0x1382CA98, 37353951058479016, 90147048, 90147051, 3, 640x360 
0x1382CA98, 37353951058800192, 90147075, 90147081, 6, 640x360 
0x1382CA98, 37353951059120472, 90147109, 90147116, 7, 640x360 
0x1382CA98, 37353951059436256, 90147140, 90147142, 2, 640x360 
0x1382CA98, 37353951059760408, 90147176, 90147182, 6, 640x360 
0x1382CA98, 37353951060075656, 90147208, 90147213, 5, 640x360 
0x1382CA98, 37353951060554712, 90147260, 90147266, 6, 640x360 
0x1382CA98, 37353951060874848, 90147289, 90147291, 2, 640x360 
0x1382CA98, 37353951061205224, 90147328, 90147338, 10, 640x360 
0x1382CA98, 37353951061516472, 90147359, 90147371, 12, 640x360 
0x1382CA98, 37353951061838272, 90147385, 90147389, 4, 640x360 
0x1382CA98, 37353951062155760, 90147417, 90147426, 9, 640x360 
0x1382CA98, 37353951062481032, 90147444, 90147457, 13, 640x360 
0x1382CA98, 37353951062795136, 90147480, 90147483, 3, 640x360 
0x1382CA98, 37353951063130736, 90147513, 90147521, 8, 640x360 
0x1382CA98, 37353951063446520, 90147546, 90147549, 3, 640x360 
0x1382CA98, 37353951063785560, 90147579, 90147588, 9, 640x360 
0x1382CA98, 37353951064102408, 90147619, 90147629, 10, 640x360 
0x1382CA98, 37353951064559368, 90147664, 90147678, 14, 640x360 
0x1382CA98, 37353951064882736, 90147697, 90147700, 3, 640x360 
0x1382CA98, 37353951065196480, 90147730, 90147733, 3, 640x360 
0x1382CA98, 37353951065515232, 90147763, 90147770, 7, 640x360 
0x1382CA98, 37353951065838952, 90147784, 90147786, 2, 640x360 
0x1382CA98, 37353951066157768, 90147815, 90147817, 2, 640x360 
0x1382CA98, 37353951066474824, 90147841, 90147844, 3, 640x360 
0x1382CA98, 37353951066795888, 90147877, 90147881, 4, 640x360 
0x1382CA98, 37353951067115032, 90147913, 90147915, 2, 640x360 
0x1382CA98, 37353951067441728, 90147944, 90147947, 3, 640x360 
0x1382CA98, 37353951067762792, 90147974, 90147976, 2, 640x360 
0x1382CA98, 37353951068077904, 90148007, 90148010, 3, 640x360 
0x1382CA98, 37353951068559368, 90148050, 90148052, 2, 640x360 
0x1382CA98, 37353951068892504, 90148087, 90148090, 3, 640x360 
0x1382CA98, 37353951069205128, 90148124, 90148128, 4, 640x360 
0x1382CA98, 37353951069514984, 90148150, 90148155, 5, 640x360 
0x1382CA98, 37353951069839768, 90148183, 90148186, 3, 640x360 
0x1382CA98, 37353951070154728, 90148216, 90148226, 10, 640x360 
0x1382CA98, 37353951070474744, 90148243, 90148246, 3, 640x360 
0x1382CA98, 37353951070796416, 90148279, 90148282, 3, 640x360 
0x1382CA98, 37353951071115256, 90148310, 90148314, 4, 640x360 
0x1382CA98, 37353951071437576, 90148341, 90148344, 3, 640x360 
0x1382CA98, 37353951071757424, 90148374, 90148377, 3, 640x360 
0x1382CA98, 37353951072093480, 90148408, 90148414, 6, 640x360 
0x1382CA98, 37353951072555096, 90148455, 90148457, 2, 640x360 
0x1382CA98, 37353951072886104, 90148497, 90148500, 3, 640x360 
0x1382CA98, 37353951073199328, 90148523, 90148532, 9, 640x360 
0x1382CA98, 37353951073522536, 90148554, 90148556, 2, 640x360 
0x1382CA98, 37353951073836136, 90148585, 90148588, 3, 640x360 
0x1382CA98, 37353951074154664, 90148610, 90148615, 5, 640x360 
0x1382CA98, 37353951074475344, 90148646, 90148655, 9, 640x360 
0x1382CA98, 37353951074796056, 90148679, 90148685, 6, 640x360 
0x1382CA98, 37353951075116136, 90148711, 90148722, 11, 640x360 
0x1382CA98, 37353951075445040, 90148748, 90148754, 6, 640x360 
0x1382CA98, 37353951075759016, 90148779, 90148782, 3, 640x360 
0x1382CA98, 37353951076085632, 90148805, 90148808, 3, 640x360 
0x1382CA98, 37353951076554032, 90148860, 90148866, 6, 640x360 
0x1382CA98, 37353951076878048, 90148886, 90148889, 3, 640x360 
0x1382CA98, 37353951077196912, 90148917, 90148930, 13, 640x360 
0x1382CA98, 37353951077523216, 90148950, 90148957, 7, 640x360 
0x1382CA98, 37353951077839688, 90148983, 90148987, 4, 640x360 
0x1382CA98, 37353951078166616, 90149015, 90149021, 6, 640x360 
0x1382CA98, 37353951078489936, 90149051, 90149053, 2, 640x360 
0x1382CA98, 37353951078804856, 90149082, 90149089, 7, 640x360 
0x1382CA98, 37353951079116704, 90149117, 90149124, 7, 640x360 
0x1382CA98, 37353951079441040, 90149150, 90149152, 2, 640x360 
0x1382CA98, 37353951079786504, 90149186, 90149193, 7, 640x360 
0x1382CA98, 37353951080078056, 90149218, 90149221, 3, 640x360 
0x1382CA98, 37353951080399344, 90149239, 90149241, 2, 640x360 
0x1382CA98, 37353951080874192, 90149289, 90149291, 2, 640x360 
0x1382CA98, 37353951081198008, 90149317, 90149321, 4, 640x360 
0x1382CA98, 37353951081515112, 90149350, 90149360, 10, 640x360 
0x1382CA98, 37353951081834688, 90149380, 90149382, 2, 640x360 
0x1382CA98, 37353951082157256, 90149417, 90149420, 3, 640x360 
0x1382CA98, 37353951082479456, 90149450, 90149458, 8, 640x360 
0x1382CA98, 37353951082795664, 90149479, 90149482, 3, 640x360 
0x1382CA98, 37353951083125024, 90149520, 90149522, 2, 640x360 
0x1382CA98, 37353951083439616, 90149544, 90149548, 4, 640x360 
0x1382CA98, 37353951083755232, 90149575, 90149577, 2, 640x360 
0x1382CA98, 37353951084089848, 90149612, 90149615, 3, 640x360 
0x1382CA98, 37353951084399216, 90149646, 90149648, 2, 640x360 
0x1382CA98, 37353951084880168, 90149688, 90149691, 3, 640x360 
0x1382CA98, 37353951085200960, 90149725, 90149732, 7, 640x360 
0x1382CA98, 37353951085519592, 90149752, 90149758, 6, 640x360 
0x1382CA98, 37353951085839104, 90149783, 90149786, 3, 640x360 
0x1382CA98, 37353951086155088, 90149820, 90149822, 2, 640x360 
0x1382CA98, 37353951086475048, 90149842, 90149848, 6, 640x360 
0x1382CA98, 37353951086798824, 90149879, 90149882, 3, 640x360 
0x1382CA98, 37353951087121096, 90149913, 90149917, 4, 640x360 
0x1382CA98, 37353951087438520, 90149951, 90149965, 14, 640x360 
0x1382CA98, 37353951087776792, 90149983, 90149989, 6, 640x360 
0x1382CA98, 37353951088076320, 90150018, 90150033, 15, 640x360 
0x1382CA98, 37353951088438968, 90150051, 90150056, 5, 640x360 
0x1382CA98, 37353951088875272, 90150093, 90150103, 10, 640x360 
0x1382CA98, 37353951089195976, 90150123, 90150125, 2, 640x360 
0x1382CA98, 37353951089515800, 90150155, 90150158, 3, 640x360 
0x1382CA98, 37353951089851808, 90150185, 90150187, 2, 640x360 
0x1382CA98, 37353951090161144, 90150218, 90150220, 2, 640x360 
0x1382CA98, 37353951090479248, 90150244, 90150248, 4, 640x360 
0x1382CA98, 37353951090797960, 90150280, 90150288, 8, 640x360 
0x1382CA98, 37353951091122688, 90150313, 90150320, 7, 640x360 
0x1382CA98, 37353951091451840, 90150345, 90150354, 9, 640x360 
0x1382CA98, 37353951091755432, 90150377, 90150382, 5, 640x360 
0x1382CA98, 37353951092074320, 90150410, 90150413, 3, 640x360 
0x1382CA98, 37353951092394864, 90150443, 90150456, 13, 640x360 
0x1382CA98, 37353951092873664, 90150488, 90150490, 2, 640x360 
0x1382CA98, 37353951093197368, 90150523, 90150525, 2, 640x360 
0x1382CA98, 37353951093517352, 90150554, 90150556, 2, 640x360 
0x1382CA98, 37353951093833888, 90150586, 90150592, 6, 640x360 
0x1382CA98, 37353951094154872, 90150617, 90150625, 8, 640x360 
0x1382CA98, 37353951094479312, 90150655, 90150658, 3, 640x360 
0x1382CA98, 37353951094798576, 90150687, 90150689, 2, 640x360 
0x1382CA98, 37353951095116584, 90150717, 90150719, 2, 640x360 
0x1382CA98, 37353951095455752, 90150743, 90150753, 10, 640x360 
0x1382CA98, 37353951095757056, 90150774, 90150776, 2, 640x360 
0x1382CA98, 37353951096080984, 90150807, 90150811, 4, 640x360 
0x1382CA98, 37353951096395440, 90150840, 90150844, 4, 640x360 
0x1382CA98, 37353951096874296, 90150891, 90150894, 3, 640x360 
0x1382CA98, 37353951097202568, 90150917, 90150919, 2, 640x360 
0x1382CA98, 37353951097513720, 90150950, 90150953, 3, 640x360 
0x1382CA98, 37353951097843648, 90150981, 90150984, 3, 640x360 
0x1382CA98, 37353951098154760, 90151017, 90151020, 3, 640x360 
0x1382CA98, 37353951098475168, 90151050, 90151057, 7, 640x360 
0x1382CA98, 37353951098804880, 90151090, 90151093, 3, 640x360 
0x1382CA98, 37353951099125472, 90151118, 90151120, 2, 640x360 
0x1382CA98, 37353951099530968, 90151155, 90151157, 2, 640x360 
0x1382CA98, 37353951099763632, 90151174, 90151177, 3, 640x360 
0x1382CA98, 37353951100086672, 90151207, 90151209, 2, 640x360 
0x1382CA98, 37353951100398584, 90151240, 90151243, 3, 640x360 
0x1382CA98, 37353951100873408, 90151286, 90151292, 6, 640x360 
0x1382CA98, 37353951101193464, 90151319, 90151331, 12, 640x360 
0x1382CA98, 37353951101513576, 90151351, 90151359, 8, 640x360 
0x1382CA98, 37353951101833776, 90151383, 90151385, 2, 640x360 
0x1382CA98, 37353951102157560, 90151410, 90151415, 5, 640x360 
0x1382CA98, 37353951102474704, 90151446, 90151450, 4, 640x360 
0x1382CA98, 37353951102794376, 90151478, 90151488, 10, 640x360 
0x1382CA98, 37353951103118456, 90151515, 90151522, 7, 640x360 
0x1382CA98, 37353951103443232, 90151541, 90151545, 4, 640x360 
0x1382CA98, 37353951103759432, 90151578, 90151587, 9, 640x360 
0x1382CA98, 37353951104082352, 90151616, 90151620, 4, 640x360 
0x1382CA98, 37353951104395184, 90151645, 90151654, 9, 640x360 
0x1382CA98, 37353951104880760, 90151699, 90151706, 7, 640x360 
0x1382CA98, 37353951105206864, 90151738, 90151757, 19, 640x360 
0x1382CA98, 37353951105541328, 90151769, 90151773, 4, 640x360 
0x1382CA98, 37353951105837160, 90151790, 90151799, 9, 640x360 
0x1382CA98, 37353951106156808, 90151818, 90151825, 7, 640x360 
0x1382CA98, 37353951106473664, 90151844, 90151847, 3, 640x360 
0x1382CA98, 37353951106798032, 90151875, 90151877, 2, 640x360 
0x1382CA98, 37353951107119256, 90151910, 90151913, 3, 640x360 
0x1382CA98, 37353951107436616, 90151941, 90151944, 3, 640x360 
0x1382CA98, 37353951107754416, 90151983, 90151986, 3, 640x360 
0x1382CA98, 37353951108077592, 90152009, 90152014, 5, 640x360 
0x1382CA98, 37353951108403288, 90152038, 90152040, 2, 640x360 
0x1382CA98, 37353951108715032, 90152070, 90152075, 5, 640x360 
0x1382CA98, 37353951109197792, 90152125, 90152130, 5, 640x360 
0x1382CA98, 37353951109531480, 90152154, 90152156, 2, 640x360 
0x1382CA98, 37353951109834680, 90152183, 90152186, 3, 640x360 
0x1382CA98, 37353951110157440, 90152210, 90152213, 3, 640x360 
0x1382CA98, 37353951110473912, 90152240, 90152243, 3, 640x360 
0x1382CA98, 37353951110797936, 90152277, 90152281, 4, 640x360 
0x1382CA98, 37353951111119088, 90152307, 90152310, 3, 640x360 
0x1382CA98, 37353951111448024, 90152342, 90152346, 4, 640x360 
0x1382CA98, 37353951111757640, 90152374, 90152377, 3, 640x360 
0x1382CA98, 37353951112074680, 90152406, 90152410, 4, 640x360 
0x1382CA98, 37353951112395168, 90152438, 90152441, 3, 640x360 
0x1382CA98, 37353951112714424, 90152466, 90152468, 2, 640x360 
0x1382CA98, 37353951113194024, 90152515, 90152518, 3, 640x360 
0x1382CA98, 37353951113513736, 90152547, 90152555, 8, 640x360 
0x1382CA98, 37353951113834080, 90152583, 90152585, 2, 640x360 
0x1382CA98, 37353951114154088, 90152614, 90152617, 3, 640x360 
0x1382CA98, 37353951114476280, 90152652, 90152655, 3, 640x360 
0x1382CA98, 37353951114794272, 90152684, 90152687, 3, 640x360 
0x1382CA98, 37353951115114504, 90152711, 90152717, 6, 640x360 
0x1382CA98, 37353951115435576, 90152741, 90152747, 6, 640x360 
0x1382CA98, 37353951115762376, 90152777, 90152781, 4, 640x360 
0x1382CA98, 37353951116099536, 90152803, 90152805, 2, 640x360 
0x1382CA98, 37353951116399896, 90152839, 90152842, 3, 640x360 
0x1382CA98, 37353951116714696, 90152869, 90152871, 2, 640x360 
0x1382CA98, 37353951117193200, 90152923, 90152925, 2, 640x360 
0x1382CA98, 37353951117518592, 90152952, 90152954, 2, 640x360 
0x1382CA98, 37353951117837568, 90152983, 90152985, 2, 640x360 
0x1382CA98, 37353951118159376, 90153014, 90153017, 3, 640x360 
0x1382CA98, 37353951118477856, 90153046, 90153049, 3, 640x360 
0x1382CA98, 37353951118797672, 90153075, 90153084, 9, 640x360 
0x1382CA98, 37353951119143664, 90153118, 90153132, 14, 640x360 
0x1382CA98, 37353951119446272, 90153154, 90153156, 2, 640x360 
0x1382CA98, 37353951119777784, 90153186, 90153188, 2, 640x360 
0x1382CA98, 37353951120073632, 90153214, 90153217, 3, 640x360 
0x1382CA98, 37353951120393632, 90153247, 90153254, 7, 640x360 
0x1382CA98, 37353951120714768, 90153291, 90153295, 4, 640x360 
0x1382CA98, 37353951121198976, 90153340, 90153362, 22, 640x360 
0x1382CA98, 37353951121549408, 90153387, 90153405, 18, 640x360 
0x1382CA98, 37353951121850320, 90153406, 90153424, 18, 640x360 
0x1382CA98, 37353951122231496, 90153440, 90153446, 6, 640x360 
0x1382CA98, 37353951122487152, 90153463, 90153470, 7, 640x360 
0x1382CA98, 37353951122835512, 90153490, 90153493, 3, 640x360 
0x1382CA98, 37353951123125016, 90153528, 90153537, 9, 640x360 
0x1382CA98, 37353951123461544, 90153568, 90153572, 4, 640x360 
0x1382CA98, 37353951123785616, 90153598, 90153601, 3, 640x360 
0x1382CA98, 37353951124104400, 90153621, 90153640, 19, 640x360 
0x1382CA98, 37353951124405848, 90153652, 90153667, 15, 640x360 
0x1382CA98, 37353951124718672, 90153677, 90153683, 6, 640x360 
0x1382CA98, 37353951125195688, 90153735, 90153743, 8, 640x360 
0x1382CA98, 37353951125524104, 90153766, 90153771, 5, 640x360 
0x1382CA98, 37353951125857848, 90153795, 90153805, 10, 640x360 
0x1382CA98, 37353951126169256, 90153818, 90153824, 6, 640x360 
0x1382CA98, 37353951126473488, 90153850, 90153853, 3, 640x360 
0x1382CA98, 37353951126793344, 90153880, 90153888, 8, 640x360 
0x1382CA98, 37353951127118072, 90153908, 90153914, 6, 640x360 
0x1382CA98, 37353951127441904, 90153943, 90153955, 12, 640x360 
0x1382CA98, 37353951127756248, 90153984, 90153990, 6, 640x360 
0x1382CA98, 37353951128073872, 90154011, 90154018, 7, 640x360 
0x1382CA98, 37353951128398192, 90154043, 90154057, 14, 640x360 
0x1382CA98, 37353951128719864, 90154075, 90154084, 9, 640x360 
0x1382CA98, 37353951129193448, 90154128, 90154132, 4, 640x360 
0x1382CA98, 37353951129527312, 90154159, 90154171, 12, 640x360 
0x1382CA98, 37353951129864704, 90154190, 90154193, 3, 640x360 
0x1382CA98, 37353951130152792, 90154217, 90154221, 4, 640x360 
0x1382CA98, 37353951130473064, 90154244, 90154250, 6, 640x360 
0x1382CA98, 37353951130796960, 90154288, 90154290, 2, 640x360 
0x1382CA98, 37353951131118120, 90154307, 90154310, 3, 640x360 
0x1382CA98, 37353951131438232, 90154348, 90154350, 2, 640x360 
0x1382CA98, 37353951131766400, 90154373, 90154375, 2, 640x360 
0x1382CA98, 37353951132087312, 90154404, 90154406, 2, 640x360 
0x1382CA98, 37353951132394120, 90154444, 90154453, 9, 640x360 
0x1382CA98, 37353951132731624, 90154500, 90154511, 11, 640x360 
0x1382CA98, 37353951133040648, 90154514, 90154517, 3, 640x360 
0x1382CA98, 37353951133516168, 90154569, 90154573, 4, 640x360 
0x1382CA98, 37353951133833968, 90154590, 90154597, 7, 640x360 
0x1382CA98, 37353951134158160, 90154623, 90154627, 4, 640x360 
0x1382CA98, 37353951134473520, 90154650, 90154661, 11, 640x360 
0x1382CA98, 37353951134794064, 90154679, 90154688, 9, 640x360 
0x1382CA98, 37353951135118944, 90154709, 90154721, 12, 640x360 
0x1382CA98, 37353951135441440, 90154746, 90154755, 9, 640x360 
0x1382CA98, 37353951135753464, 90154780, 90154783, 3, 640x360 
0x1382CA98, 37353951136074928, 90154816, 90154818, 2, 640x360 
0x1382CA98, 37353951136393168, 90154839, 90154842, 3, 640x360 
0x1382CA98, 37353951136715440, 90154880, 90154883, 3, 640x360 
0x1382CA98, 37353951137044200, 90154905, 90154907, 2, 640x360 
0x1382CA98, 37353951137517440, 90154958, 90154961, 3, 640x360 
0x1382CA98, 37353951137833168, 90154992, 90154998, 6, 640x360 
0x1382CA98, 37353951138155728, 90155020, 90155022, 2, 640x360 
0x1382CA98, 37353951138476096, 90155054, 90155056, 2, 640x360 
0x1382CA98, 37353951138798808, 90155082, 90155087, 5, 640x360 
0x1382CA98, 37353951139131720, 90155116, 90155118, 2, 640x360 
0x1382CA98, 37353951139445632, 90155153, 90155155, 2, 640x360 
0x1382CA98, 37353951139755880, 90155178, 90155187, 9, 640x360 
0x1382CA98, 37353951140072960, 90155206, 90155214, 8, 640x360 
0x1382CA98, 37353951140392992, 90155236, 90155239, 3, 640x360 
0x1382CA98, 37353951140713072, 90155278, 90155286, 8, 640x360 
0x1382CA98, 37353951141034432, 90155309, 90155314, 5, 640x360 
0x1382CA98, 37353951141512736, 90155356, 90155358, 2, 640x360 
0x1382CA98, 37353951141832368, 90155382, 90155385, 3, 640x360 
0x1382CA98, 37353951142156840, 90155413, 90155420, 7, 640x360 
0x1382CA98, 37353951142472904, 90155447, 90155455, 8, 640x360 
0x1382CA98, 37353951142793568, 90155476, 90155485, 9, 640x360 
0x1382CA98, 37353951143164416, 90155518, 90155534, 16, 640x360 
0x1382CA98, 37353951143441560, 90155556, 90155562, 6, 640x360 
0x1382CA98, 37353951143770192, 90155595, 90155607, 12, 640x360 
0x1382CA98, 37353951144139008, 90155619, 90155621, 2, 640x360 
0x1382CA98, 37353951144392680, 90155646, 90155649, 3, 640x360 
0x1382CA98, 37353951144713152, 90155679, 90155682, 3, 640x360 
0x1382CA98, 37353951145033320, 90155705, 90155707, 2, 640x360 
0x1382CA98, 37353951145515520, 90155753, 90155758, 5, 640x360 
0x1382CA98, 37353951145838296, 90155784, 90155786, 2, 640x360 
0x1382CA98, 37353951146156672, 90155817, 90155819, 2, 640x360 
0x1382CA98, 37353951146479400, 90155848, 90155855, 7, 640x360 
0x1382CA98, 37353951146793224, 90155875, 90155885, 10, 640x360 
0x1382CA98, 37353951147115872, 90155906, 90155908, 2, 640x360 
0x1382CA98, 37353951147440328, 90155941, 90155945, 4, 640x360 
0x1382CA98, 37353951147753664, 90155973, 90155976, 3, 640x360 
0x1382CA98, 37353951148077712, 90156005, 90156007, 2, 640x360 
0x1382CA98, 37353951148394008, 90156038, 90156041, 3, 640x360 
0x1382CA98, 37353951148713704, 90156072, 90156075, 3, 640x360 
0x1382CA98, 37353951149043032, 90156104, 90156106, 2, 640x360 
0x1382CA98, 37353951149517904, 90156161, 90156167, 6, 640x360 
0x1382CA98, 37353951149850160, 90156189, 90156191, 2, 640x360 
0x1382CA98, 37353951150155088, 90156215, 90156222, 7, 640x360 
0x1382CA98, 37353951150477104, 90156245, 90156253, 8, 640x360 
0x1382CA98, 37353951150792416, 90156277, 90156285, 8, 640x360 
0x1382CA98, 37353951151117808, 90156309, 90156319, 10, 640x360 
0x1382CA98, 37353951151438960, 90156345, 90156353, 8, 640x360 
0x1382CA98, 37353951151753784, 90156377, 90156385, 8, 640x360 
0x1382CA98, 37353951152077824, 90156410, 90156414, 4, 640x360 
0x1382CA98, 37353951152397728, 90156443, 90156449, 6, 640x360 
0x1382CA98, 37353951152720592, 90156472, 90156475, 3, 640x360 
0x1382CA98, 37353951153032856, 90156502, 90156505, 3, 640x360 
0x1382CA98, 37353951153512360, 90156554, 90156556, 2, 640x360 
0x1382CA98, 37353951153839944, 90156591, 90156594, 3, 640x360 
0x1382CA98, 37353951154152536, 90156617, 90156619, 2, 640x360 
0x1382CA98, 37353951154479104, 90156643, 90156649, 6, 640x360 
0x1382CA98, 37353951154793680, 90156674, 90156677, 3, 640x360 
0x1382CA98, 37353951155116232, 90156706, 90156708, 2, 640x360 
0x1382CA98, 37353951155439344, 90156739, 90156741, 2, 640x360 
0x1382CA98, 37353951155753512, 90156778, 90156781, 3, 640x360 
0x1382CA98, 37353951156106416, 90156808, 90156812, 4, 640x360 
0x1382CA98, 37353951156398696, 90156846, 90156850, 4, 640x360 
0x1382CA98, 37353951156714592, 90156872, 90156874, 2, 640x360 
0x1382CA98, 37353951157033584, 90156909, 90156920, 11, 640x360 
0x1382CA98, 37353951157513056, 90156952, 90156954, 2, 640x360 
0x1382CA98, 37353951157832200, 90156984, 90156986, 2, 640x360 
0x1382CA98, 37353951158152552, 90157014, 90157017, 3, 640x360 
0x1382CA98, 37353951158472816, 90157045, 90157049, 4, 640x360 
0x1382CA98, 37353951158792776, 90157076, 90157081, 5, 640x360 
0x1382CA98, 37353951159112808, 90157108, 90157114, 6, 640x360 
0x1382CA98, 37353951159433920, 90157141, 90157144, 3, 640x360 
0x1382CA98, 37353951159760472, 90157179, 90157189, 10, 640x360 
0x1382CA98, 37353951160081224, 90157208, 90157220, 12, 640x360 
0x1382CA98, 37353951160392560, 90157246, 90157250, 4, 640x360 
0x1382CA98, 37353951160719408, 90157279, 90157282, 3, 640x360 
0x1382CA98, 37353951161037032, 90157306, 90157315, 9, 640x360 
0x1382CA98, 37353951161352976, 90157336, 90157338, 2, 640x360 
0x1382CA98, 37353951161835080, 90157389, 90157391, 2, 640x360 
0x1382CA98, 37353951162152152, 90157414, 90157417, 3, 640x360 
0x1382CA98, 37353951162472368, 90157445, 90157452, 7, 640x360 
0x1382CA98, 37353951162792840, 90157478, 90157483, 5, 640x360 
0x1382CA98, 37353951163113176, 90157509, 90157515, 6, 640x360 
0x1382CA98, 37353951163437368, 90157541, 90157549, 8, 640x360 
0x1382CA98, 37353951163754736, 90157578, 90157582, 4, 640x360 
0x1382CA98, 37353951164076824, 90157613, 90157618, 5, 640x360 
0x1382CA98, 37353951164400704, 90157636, 90157638, 2, 640x360 
0x1382CA98, 37353951164724864, 90157675, 90157680, 5, 640x360 
0x1382CA98, 37353951165056168, 90157703, 90157705, 2, 640x360 
0x1382CA98, 37353951165360880, 90157739, 90157742, 3, 640x360 
0x1382CA98, 37353951165832128, 90157783, 90157790, 7, 640x360 
0x1382CA98, 37353951166154824, 90157817, 90157819, 2, 640x360 
0x1382CA98, 37353951166472072, 90157844, 90157850, 6, 640x360 
0x1382CA98, 37353951166792688, 90157878, 90157888, 10, 640x360 
0x1382CA98, 37353951167118016, 90157912, 90157921, 9, 640x360 
0x1382CA98, 37353951167439952, 90157944, 90157953, 9, 640x360 
0x1382CA98, 37353951167753080, 90157974, 90157987, 13, 640x360 
0x1382CA98, 37353951168072216, 90158006, 90158010, 4, 640x360 
0x1382CA98, 37353951168392248, 90158036, 90158038, 2, 640x360 
0x1382CA98, 37353951168712392, 90158072, 90158074, 2, 640x360 
0x1382CA98, 37353951169036432, 90158111, 90158114, 3, 640x360 
0x1382CA98, 37353951169354704, 90158142, 90158146, 4, 640x360 
0x1382CA98, 37353951169831704, 90158189, 90158193, 4, 640x360 
0x1382CA98, 37353951170161264, 90158216, 90158218, 2, 640x360 
0x1382CA98, 37353951170477976, 90158246, 90158248, 2, 640x360 
0x1382CA98, 37353951170793392, 90158280, 90158288, 8, 640x360 
0x1382CA98, 37353951171116600, 90158306, 90158308, 2, 640x360 
0x1382CA98, 37353951171443664, 90158344, 90158352, 8, 640x360 
0x1382CA98, 37353951171752088, 90158374, 90158379, 5, 640x360 
0x1382CA98, 37353951172076872, 90158410, 90158417, 7, 640x360 
0x1382CA98, 37353951172392304, 90158440, 90158444, 4, 640x360 
0x1382CA98, 37353951172712472, 90158471, 90158474, 3, 640x360 
0x1382CA98, 37353951173033144, 90158504, 90158506, 2, 640x360 
0x1382CA98, 37353951173352712, 90158536, 90158538, 2, 640x360 
0x1382CA98, 37353951173832432, 90158582, 90158585, 3, 640x360 
0x1382CA98, 37353951174156352, 90158613, 90158619, 6, 640x360 
0x1382CA98, 37353951174472752, 90158650, 90158656, 6, 640x360 
0x1382CA98, 37353951174812440, 90158679, 90158682, 3, 640x360 
0x1382CA98, 37353951175120840, 90158713, 90158720, 7, 640x360 
0x1382CA98, 37353951175439200, 90158744, 90158748, 4, 640x360 
0x1382CA98, 37353951175756664, 90158775, 90158778, 3, 640x360 
0x1382CA98, 37353951176118296, 90158818, 90158828, 10, 640x360 
0x1382CA98, 37353951176405176, 90158839, 90158841, 2, 640x360 
0x1382CA98, 37353951176711944, 90158877, 90158881, 4, 640x360 
0x1382CA98, 37353951177035648, 90158905, 90158907, 2, 640x360 
0x1382CA98, 37353951177356104, 90158936, 90158938, 2, 640x360 
0x1382CA98, 37353951177835552, 90158983, 90158989, 6, 640x360 
0x1382CA98, 37353951178154824, 90159016, 90159018, 2, 640x360 
0x1382CA98, 37353951178476592, 90159058, 90159061, 3, 640x360 
0x1382CA98, 37353951178791864, 90159079, 90159096, 17, 640x360 
0x1382CA98, 37353951179119080, 90159114, 90159121, 7, 640x360 
0x1382CA98, 37353951179455704, 90159152, 90159156, 4, 640x360 
0x1382CA98, 37353951179758384, 90159184, 90159190, 6, 640x360 
0x1382CA98, 37353951180074224, 90159216, 90159218, 2, 640x360 
0x1382CA98, 37353951180397096, 90159243, 90159256, 13, 640x360 
0x1382CA98, 37353951180722272, 90159275, 90159281, 6, 640x360 
0x1382CA98, 37353951181052688, 90159309, 90159314, 5, 640x360 
0x1382CA98, 37353951181351976, 90159342, 90159353, 11, 640x360 
0x1382CA98, 37353951181837368, 90159391, 90159412, 21, 640x360 
0x1382CA98, 37353951182165848, 90159423, 90159427, 4, 640x360 
0x1382CA98, 37353951182512192, 90159462, 90159472, 10, 640x360 
0x1382CA98, 37353951182804848, 90159489, 90159495, 6, 640x360 
0x1382CA98, 37353951183134608, 90159516, 90159518, 2, 640x360 
0x1382CA98, 37353951183453944, 90159551, 90159554, 3, 640x360 
0x1382CA98, 37353951183752136, 90159577, 90159583, 6, 640x360 
0x1382CA98, 37353951184071808, 90159609, 90159620, 11, 640x360 
0x1382CA98, 37353951184395528, 90159645, 90159654, 9, 640x360 
0x1382CA98, 37353951184711760, 90159678, 90159682, 4, 640x360 
0x1382CA98, 37353951185031848, 90159706, 90159715, 9, 640x360 
0x1382CA98, 37353951185356928, 90159737, 90159740, 3, 640x360 
0x1382CA98, 37353951185835088, 90159782, 90159784, 2, 640x360 
0x1382CA98, 37353951186161208, 90159815, 90159822, 7, 640x360 
0x1382CA98, 37353951186481888, 90159848, 90159851, 3, 640x360 
0x1382CA98, 37353951186791776, 90159876, 90159890, 14, 640x360 
0x1382CA98, 37353951187120544, 90159909, 90159919, 10, 640x360 
0x1382CA98, 37353951187440888, 90159942, 90159952, 10, 640x360 
0x1382CA98, 37353951187751528, 90159978, 90159981, 3, 640x360 
0x1382CA98, 37353951188072096, 90160015, 90160018, 3, 640x360 
0x1382CA98, 37353951188391608, 90160035, 90160037, 2, 640x360 
0x1382CA98, 37353951188711744, 90160071, 90160080, 9, 640x360 
0x1382CA98, 37353951189037432, 90160111, 90160116, 5, 640x360 
0x1382CA98, 37353951189356384, 90160138, 90160141, 3, 640x360 
0x1382CA98, 37353951189675160, 90160165, 90160167, 2, 640x360 
0x1382CA98, 37353951190157736, 90160214, 90160217, 3, 640x360 
0x1382CA98, 37353951190477312, 90160245, 90160249, 4, 640x360 
0x1382CA98, 37353951190797624, 90160278, 90160293, 15, 640x360 
0x1382CA98, 37353951191118832, 90160309, 90160319, 10, 640x360 
0x1382CA98, 37353951191453152, 90160340, 90160344, 4, 640x360 
0x1382CA98, 37353951191756208, 90160373, 90160377, 4, 640x360 
0x1382CA98, 37353951192071504, 90160405, 90160413, 8, 640x360 
0x1382CA98, 37353951192407048, 90160440, 90160442, 2, 640x360 
0x1382CA98, 37353951192711624, 90160477, 90160489, 12, 640x360 
0x1382CA98, 37353951193041672, 90160512, 90160521, 9, 640x360 
0x1382CA98, 37353951193360816, 90160546, 90160555, 9, 640x360 
0x1382CA98, 37353951193695616, 90160578, 90160588, 10, 640x360 
0x1382CA98, 37353951194151000, 90160614, 90160616, 2, 640x360 
0x1382CA98, 37353951194487360, 90160653, 90160661, 8, 640x360 
0x1382CA98, 37353951194810808, 90160691, 90160702, 11, 640x360 
0x1382CA98, 37353951195126808, 90160723, 90160726, 3, 640x360 
0x1382CA98, 37353951195440680, 90160746, 90160749, 3, 640x360 
0x1382CA98, 37353951195755144, 90160773, 90160775, 2, 640x360 
0x1382CA98, 37353951196075296, 90160810, 90160814, 4, 640x360 
0x1382CA98, 37353951196403440, 90160845, 90160848, 3, 640x360 
0x1382CA98, 37353951196716152, 90160883, 90160886, 3, 640x360 
0x1382CA98, 37353951197031424, 90160904, 90160906, 2, 640x360 
0x1382CA98, 37353951197351952, 90160939, 90160941, 2, 640x360 
0x1382CA98, 37353951197672240, 90160967, 90160971, 4, 640x360 
0x1382CA98, 37353951198155800, 90161015, 90161024, 9, 640x360 
0x1382CA98, 37353951198472128, 90161054, 90161063, 9, 640x360 
0x1382CA98, 37353951198808288, 90161090, 90161100, 10, 640x360 
0x1382CA98, 37353951199148376, 90161122, 90161126, 4, 640x360 
0x1382CA98, 37353951199461128, 90161156, 90161182, 26, 640x360 
0x1382CA98, 37353951199842576, 90161190, 90161214, 24, 640x360 
0x1382CA98, 37353951200150608, 90161222, 90161231, 9, 640x360 
0x1382CA98, 37353951200394416, 90161247, 90161257, 10, 640x360 
0x1382CA98, 37353951200718080, 90161292, 90161298, 6, 640x360 
0x1382CA98, 37353951201051760, 90161313, 90161320, 7, 640x360 
0x1382CA98, 37353951201353880, 90161364, 90161375, 11, 640x360 
0x1382CA98, 37353951201691272, 90161376, 90161388, 12, 640x360 
0x1382CA98, 37353951202154144, 90161419, 90161421, 2, 640x360 
0x1382CA98, 37353951202476224, 90161455, 90161463, 8, 640x360 
0x1382CA98, 37353951202794352, 90161489, 90161491, 2, 640x360 
0x1382CA98, 37353951203147464, 90161517, 90161520, 3, 640x360 
0x1382CA98, 37353951203457608, 90161551, 90161564, 13, 640x360 
0x1382CA98, 37353951203759816, 90161589, 90161594, 5, 640x360 
0x1382CA98, 37353951204075184, 90161626, 90161634, 8, 640x360 
0x1382CA98, 37353951204403136, 90161653, 90161656, 3, 640x360 
0x1382CA98, 37353951204712416, 90161679, 90161689, 10, 640x360 
0x1382CA98, 37353951205032352, 90161705, 90161707, 2, 640x360 
0x1382CA98, 37353951205351880, 90161747, 90161755, 8, 640x360 
0x1382CA98, 37353951205678104, 90161779, 90161794, 15, 640x360 
0x1382CA98, 37353951206152464, 90161824, 90161832, 8, 640x360 
0x1382CA98, 37353951206486608, 90161855, 90161863, 8, 640x360 
0x1382CA98, 37353951206804752, 90161899, 90161902, 3, 640x360 
0x1382CA98, 37353951207117432, 90161920, 90161922, 2, 640x360 
0x1382CA98, 37353951207450784, 90161957, 90161990, 33, 640x360 
0x1382CA98, 37353951207809952, 90161991, 90162001, 10, 640x360 
0x1382CA98, 37353951208111104, 90162022, 90162030, 8, 640x360 
0x1382CA98, 37353951208396056, 90162046, 90162055, 9, 640x360 
0x1382CA98, 37353951208712592, 90162077, 90162088, 11, 640x360 
0x1382CA98, 37353951209033320, 90162108, 90162114, 6, 640x360 
0x1382CA98, 37353951209352000, 90162133, 90162139, 6, 640x360 
0x1382CA98, 37353951209673008, 90162172, 90162174, 2, 640x360 
0x1382CA98, 37353951210155208, 90162227, 90162232, 5, 640x360 
0x1382CA98, 37353951210471688, 90162249, 90162251, 2, 640x360 
0x1382CA98, 37353951210791256, 90162280, 90162283, 3, 640x360 
0x1382CA98, 37353951211115600, 90162317, 90162319, 2, 640x360 
0x1382CA98, 37353951211452208, 90162350, 90162352, 2, 640x360 
0x1382CA98, 37353951211751080, 90162388, 90162390, 2, 640x360 
0x1382CA98, 37353951212070960, 90162414, 90162421, 7, 640x360 
0x1382CA98, 37353951212394792, 90162441, 90162445, 4, 640x360 
0x1382CA98, 37353951212711416, 90162479, 90162482, 3, 640x360 
0x1382CA98, 37353951213030984, 90162506, 90162508, 2, 640x360 
0x1382CA98, 37353951213351296, 90162533, 90162536, 3, 640x360 
0x1382CA98, 37353951213671552, 90162569, 90162571, 2, 640x360 
0x1382CA98, 37353951214154304, 90162615, 90162618, 3, 640x360 
0x1382CA98, 37353951214471968, 90162652, 90162655, 3, 640x360 
0x1382CA98, 37353951214795008, 90162689, 90162692, 3, 640x360 
0x1382CA98, 37353951215111968, 90162717, 90162720, 3, 640x360 
0x1382CA98, 37353951215437608, 90162750, 90162754, 4, 640x360 
0x1382CA98, 37353951215775928, 90162788, 90162801, 13, 640x360 
0x1382CA98, 37353951216103936, 90162821, 90162825, 4, 640x360 
0x1382CA98, 37353951216405496, 90162849, 90162852, 3, 640x360 
0x1382CA98, 37353951216714904, 90162878, 90162883, 5, 640x360 
0x1382CA98, 37353951217036408, 90162909, 90162912, 3, 640x360 
0x1382CA98, 37353951217363216, 90162947, 90162955, 8, 640x360 
0x1382CA98, 37353951217684344, 90162979, 90162981, 2, 640x360 
0x1382CA98, 37353951217991464, 90163005, 90163007, 2, 640x360 
0x1382CA98, 37353951218474720, 90163059, 90163065, 6, 640x360 
0x1382CA98, 37353951218813088, 90163089, 90163092, 3, 640x360 
0x1382CA98, 37353951219119328, 90163118, 90163125, 7, 640x360 
0x1382CA98, 37353951219472408, 90163156, 90163158, 2, 640x360 
0x1382CA98, 37353951219755120, 90163179, 90163186, 7, 640x360 
0x1382CA98, 37353951220076088, 90163214, 90163222, 8, 640x360 
0x1382CA98, 37353951220391416, 90163245, 90163251, 6, 640x360 
0x1382CA98, 37353951220711200, 90163271, 90163274, 3, 640x360 
0x1382CA98, 37353951221030600, 90163304, 90163307, 3, 640x360 
0x1382CA98, 37353951221352064, 90163342, 90163344, 2, 640x360 
0x1382CA98, 37353951221674456, 90163368, 90163373, 5, 640x360 
0x1382CA98, 37353951221991120, 90163404, 90163406, 2, 640x360 
0x1382CA98, 37353951222471040, 90163446, 90163450, 4, 640x360 
0x1382CA98, 37353951222792528, 90163477, 90163482, 5, 640x360 
0x1382CA98, 37353951223111552, 90163509, 90163512, 3, 640x360 
0x1382CA98, 37353951223430576, 90163544, 90163550, 6, 640x360 
0x1382CA98, 37353951223757264, 90163576, 90163581, 5, 640x360 
0x1382CA98, 37353951224071128, 90163607, 90163609, 2, 640x360 
0x1382CA98, 37353951224401744, 90163638, 90163640, 2, 640x360 
0x1382CA98, 37353951224715288, 90163675, 90163677, 2, 640x360 
0x1382CA98, 37353951225031568, 90163705, 90163707, 2, 640x360 
0x1382CA98, 37353951225351520, 90163733, 90163740, 7, 640x360 
0x1382CA98, 37353951225676640, 90163765, 90163767, 2, 640x360 
0x1382CA98, 37353951225991072, 90163800, 90163803, 3, 640x360 
0x1382CA98, 37353951226479104, 90163857, 90163864, 7, 640x360 
0x1382CA98, 37353951226838536, 90163901, 90163907, 6, 640x360 
0x1382CA98, 37353951227151800, 90163949, 90163957, 8, 640x360 
0x1382CA98, 37353951227591768, 90163998, 90164005, 7, 640x360 
0x1382CA98, 37353951228170128, 90164028, 90164044, 16, 640x360 
0x1382CA98, 37353951228494432, 90164060, 90164067, 7, 640x360 
0x1382CA98, 37353951228712000, 90164087, 90164091, 4, 640x360 
0x1382CA98, 37353951229048688, 90164110, 90164115, 5, 640x360 
0x1382CA98, 37353951229352032, 90164144, 90164150, 6, 640x360 
0x1382CA98, 37353951229671840, 90164179, 90164182, 3, 640x360 
0x1382CA98, 37353951229994760, 90164202, 90164204, 2, 640x360 
0x1382CA98, 37353951230470000, 90164243, 90164254, 11, 640x360 
0x1382CA98, 37353951230791776, 90164296, 90164307, 11, 640x360 
0x1382CA98, 37353951231136768, 90164326, 90164334, 8, 640x360 
0x1382CA98, 37353951231468216, 90164355, 90164358, 3, 640x360 
0x1382CA98, 37353951231767264, 90164386, 90164390, 4, 640x360 
0x1382CA98, 37353951232074816, 90164418, 90164421, 3, 640x360 
0x1382CA98, 37353951232405624, 90164446, 90164450, 4, 640x360 
0x1382CA98, 37353951232718728, 90164480, 90164492, 12, 640x360 
0x1382CA98, 37353951233146568, 90164516, 90164520, 4, 640x360 
0x1382CA98, 37353951233358040, 90164542, 90164552, 10, 640x360 
0x1382CA98, 37353951233675032, 90164573, 90164576, 3, 640x360 
0x1382CA98, 37353951234006000, 90164605, 90164620, 15, 640x360 
0x1382CA98, 37353951234485008, 90164658, 90164674, 16, 640x360 
0x1382CA98, 37353951235126864, 90164735, 90164737, 2, 640x360 
0x1382CA98, 37353951235826576, 90164793, 90164800, 7, 640x360 
0x1382CA98, 37353951236071096, 90164820, 90164823, 3, 640x360 
0x1382CA98, 37353951236465736, 90164867, 90164901, 34, 640x360 
0x1382CA98, 37353951236722816, 90164907, 90164922, 15, 640x360 
0x1382CA98, 37353951237063424, 90164931, 90164941, 10, 640x360 
0x1382CA98, 37353951237358120, 90164955, 90164957, 2, 640x360 
0x1382CA98, 37353951237685704, 90164989, 90164994, 5, 640x360 
0x1382CA98, 37353951238008096, 90165029, 90165033, 4, 640x360 
0x1382CA98, 37353951238487760, 90165068, 90165073, 5, 640x360 
0x1382CA98, 37353951238812360, 90165089, 90165099, 10, 640x360 
0x1382CA98, 37353951239136728, 90165132, 90165141, 9, 640x360 
0x1382CA98, 37353951239446568, 90165164, 90165174, 10, 640x360 
0x1382CA98, 37353951239795040, 90165218, 90165221, 3, 640x360 
0x1382CA98, 37353951240170120, 90165230, 90165241, 11, 640x360 
0x1382CA98, 37353951240401904, 90165253, 90165264, 11, 640x360 
0x1382CA98, 37353951240746952, 90165286, 90165294, 8, 640x360 
0x1382CA98, 37353951241041992, 90165313, 90165330, 17, 640x360 
0x1382CA98, 37353951241377248, 90165352, 90165355, 3, 640x360 
0x1382CA98, 37353951241671616, 90165376, 90165382, 6, 640x360 
0x1382CA98, 37353951242007880, 90165410, 90165423, 13, 640x360 
0x1382CA98, 37353951242336344, 90165442, 90165448, 6, 640x360 
0x1382CA98, 37353951242794392, 90165481, 90165483, 2, 640x360 
0x1382CA98, 37353951243114328, 90165510, 90165514, 4, 640x360 
0x1382CA98, 37353951243435232, 90165542, 90165545, 3, 640x360 
0x1382CA98, 37353951243759160, 90165573, 90165575, 2, 640x360 
0x1382CA98, 37353951244075016, 90165604, 90165606, 2, 640x360 
0x1382CA98, 37353951244391024, 90165634, 90165636, 2, 640x360 
0x1382CA98, 37353951244711048, 90165665, 90165667, 2, 640x360 
0x1382CA98, 37353951245030984, 90165696, 90165699, 3, 640x360 
0x1382CA98, 37353951245354856, 90165732, 90165735, 3, 640x360 
0x1382CA98, 37353951245671072, 90165764, 90165766, 2, 640x360 
0x1382CA98, 37353951245997024, 90165800, 90165808, 8, 640x360 
0x1382CA98, 37353951246790752, 90165874, 90165880, 6, 640x360 
0x1382CA98, 37353951247110816, 90165905, 90165907, 2, 640x360 
0x1382CA98, 37353951247430496, 90165936, 90165939, 3, 640x360 
0x1382CA98, 37353951247750176, 90165967, 90165969, 2, 640x360 
0x1382CA98, 37353951248070800, 90166002, 90166005, 3, 640x360 
0x1382CA98, 37353951248391200, 90166033, 90166035, 2, 640x360 
0x1382CA98, 37353951248711208, 90166064, 90166067, 3, 640x360 
0x1382CA98, 37353951249031120, 90166099, 90166102, 3, 640x360 
0x1382CA98, 37353951249351168, 90166130, 90166135, 5, 640x360 
0x1382CA98, 37353951249670992, 90166161, 90166163, 2, 640x360 
0x1382CA98, 37353951249991168, 90166197, 90166199, 2, 640x360 
0x1382CA98, 37353951250311376, 90166227, 90166233, 6, 640x360 
0x1382CA98, 37353951250790720, 90166277, 90166281, 4, 640x360 
0x1382CA98, 37353951251110272, 90166304, 90166307, 3, 640x360 
0x1382CA98, 37353951251429960, 90166340, 90166342, 2, 640x360 
0x1382CA98, 37353951251750160, 90166372, 90166375, 3, 640x360 
0x1382CA98, 37353951252074520, 90166404, 90166407, 3, 640x360 
0x1382CA98, 37353951252391128, 90166435, 90166437, 2, 640x360 
0x1382CA98, 37353951252710320, 90166465, 90166468, 3, 640x360 
0x1382CA98, 37353951253031272, 90166496, 90166499, 3, 640x360 
0x1382CA98, 37353951253351000, 90166532, 90166534, 2, 640x360 
0x1382CA98, 37353951253670880, 90166562, 90166566, 4, 640x360 
0x1382CA98, 37353951253991096, 90166597, 90166599, 2, 640x360 
0x1382CA98, 37353951254311352, 90166628, 90166631, 3, 640x360 
0x1382CA98, 37353951254790744, 90166674, 90166677, 3, 640x360 
0x1382CA98, 37353951255110520, 90166705, 90166708, 3, 640x360 
0x1382CA98, 37353951255430232, 90166737, 90166740, 3, 640x360 
0x1382CA98, 37353951255750696, 90166768, 90166770, 2, 640x360 
0x1382CA98, 37353951256070696, 90166803, 90166806, 3, 640x360 
0x1382CA98, 37353951256390920, 90166834, 90166837, 3, 640x360 
0x1382CA98, 37353951256710232, 90166865, 90166867, 2, 640x360 
0x1382CA98, 37353951257030840, 90166896, 90166899, 3, 640x360 
0x1382CA98, 37353951257350816, 90166928, 90166932, 4, 640x360 
0x1382CA98, 37353951257670568, 90166958, 90166962, 4, 640x360 
0x1382CA98, 37353951257991208, 90166994, 90167004, 10, 640x360 
0x1382CA98, 37353951258310664, 90167031, 90167034, 3, 640x360 
0x1382CA98, 37353951258790320, 90167074, 90167079, 5, 640x360 
0x1382CA98, 37353951259113936, 90167107, 90167114, 7, 640x360 
0x1382CA98, 37353951259433688, 90167139, 90167141, 2, 640x360 
0x1382CA98, 37353951259751304, 90167170, 90167174, 4, 640x360 
0x1382CA98, 37353951260073760, 90167206, 90167208, 2, 640x360 
0x1382CA98, 37353951260393760, 90167237, 90167239, 2, 640x360 
0x1382CA98, 37353951260710464, 90167268, 90167271, 3, 640x360 
0x1382CA98, 37353951261030688, 90167299, 90167301, 2, 640x360 
0x1382CA98, 37353951261358320, 90167331, 90167333, 2, 640x360 
0x1382CA98, 37353951261670952, 90167361, 90167364, 3, 640x360 
0x1382CA98, 37353951261990696, 90167393, 90167404, 11, 640x360 
0x1382CA98, 37353951262311376, 90167424, 90167432, 8, 640x360 
0x1382CA98, 37353951262790568, 90167475, 90167479, 4, 640x360 
0x1382CA98, 37353951263110168, 90167506, 90167509, 3, 640x360 
0x1382CA98, 37353951263429896, 90167537, 90167539, 2, 640x360 
0x1382CA98, 37353951263751680, 90167573, 90167600, 27, 640x360 
0x1382CA98, 37353951264090008, 90167615, 90167618, 3, 640x360 
0x1382CA98, 37353951264393576, 90167637, 90167640, 3, 640x360 
0x1382CA98, 37353951264713624, 90167668, 90167671, 3, 640x360 
0x1382CA98, 37353951265030792, 90167704, 90167707, 3, 640x360 
0x1382CA98, 37353951265350352, 90167730, 90167733, 3, 640x360 
0x1382CA98, 37353951265670320, 90167761, 90167764, 3, 640x360 
0x1382CA98, 37353951265990656, 90167792, 90167795, 3, 640x360 
0x1382CA98, 37353951266311128, 90167828, 90167830, 2, 640x360 
0x1382CA98, 37353951266790336, 90167874, 90167878, 4, 640x360 
0x1382CA98, 37353951267111888, 90167912, 90167915, 3, 640x360 
0x1382CA98, 37353951267430736, 90167951, 90167953, 2, 640x360 
0x1382CA98, 37353951267762784, 90167981, 90167985, 4, 640x360 
0x1382CA98, 37353951268070768, 90168010, 90168019, 9, 640x360 
0x1382CA98, 37353951268390184, 90168042, 90168054, 12, 640x360 
0x1382CA98, 37353951268716184, 90168073, 90168078, 5, 640x360 
0x1382CA98, 37353951269039744, 90168107, 90168110, 3, 640x360 
0x1382CA98, 37353951269350208, 90168144, 90168147, 3, 640x360 
0x1382CA98, 37353951269671944, 90168174, 90168176, 2, 640x360 
0x1382CA98, 37353951269990384, 90168196, 90168199, 3, 640x360 
0x1382CA98, 37353951270310408, 90168236, 90168238, 2, 640x360 
0x1382CA98, 37353951270638616, 90168265, 90168273, 8, 640x360 
0x1382CA98, 37353951271116808, 90168318, 90168321, 3, 640x360 
0x1382CA98, 37353951271431032, 90168347, 90168350, 3, 640x360 
0x1382CA98, 37353951271751080, 90168379, 90168382, 3, 640x360 
0x1382CA98, 37353951272070952, 90168405, 90168408, 3, 640x360 
0x1382CA98, 37353951272391696, 90168437, 90168439, 2, 640x360 
0x1382CA98, 37353951272710840, 90168468, 90168471, 3, 640x360 
0x1382CA98, 37353951273030960, 90168504, 90168506, 2, 640x360 
0x1382CA98, 37353951273356816, 90168532, 90168536, 4, 640x360 
0x1382CA98, 37353951273671600, 90168569, 90168571, 2, 640x360 
0x1382CA98, 37353951273999656, 90168605, 90168607, 2, 640x360 
0x1382CA98, 37353951274313648, 90168638, 90168640, 2, 640x360 
0x1382CA98, 37353951274631320, 90168670, 90168672, 2, 640x360 
0x1382CA98, 37353951275109632, 90168712, 90168715, 3, 640x360 
0x1382CA98, 37353951275429888, 90168743, 90168751, 8, 640x360 
0x1382CA98, 37353951275753488, 90168775, 90168781, 6, 640x360 
0x1382CA98, 37353951276070552, 90168806, 90168810, 4, 640x360 
0x1382CA98, 37353951276390696, 90168846, 90168851, 5, 640x360 
0x1382CA98, 37353951276711016, 90168872, 90168875, 3, 640x360 
0x1382CA98, 37353951277029904, 90168904, 90168907, 3, 640x360 
0x1382CA98, 37353951277354400, 90168942, 90168950, 8, 640x360 
0x1382CA98, 37353951277687912, 90168968, 90168972, 4, 640x360 
0x1382CA98, 37353951277989552, 90169000, 90169002, 2, 640x360 
0x1382CA98, 37353951278309368, 90169026, 90169030, 4, 640x360 
0x1382CA98, 37353951278633656, 90169057, 90169060, 3, 640x360 
0x1382CA98, 37353951279110024, 90169104, 90169107, 3, 640x360 
0x1382CA98, 37353951279429640, 90169140, 90169142, 2, 640x360 
0x1382CA98, 37353951279749528, 90169176, 90169180, 4, 640x360 
0x1382CA98, 37353951280069432, 90169208, 90169211, 3, 640x360 
0x1382CA98, 37353951280389712, 90169234, 90169236, 2, 640x360 
0x1382CA98, 37353951280721936, 90169271, 90169273, 2, 640x360 
0x1382CA98, 37353951281034392, 90169302, 90169304, 2, 640x360 
0x1382CA98, 37353951281350296, 90169333, 90169335, 2, 640x360 
0x1382CA98, 37353951281669976, 90169359, 90169362, 3, 640x360 
0x1382CA98, 37353951281992912, 90169396, 90169398, 2, 640x360 
0x1382CA98, 37353951282309912, 90169425, 90169430, 5, 640x360 
0x1382CA98, 37353951282630872, 90169467, 90169469, 2, 640x360 
0x1382CA98, 37353951283109056, 90169507, 90169510, 3, 640x360 
0x1382CA98, 37353951283454208, 90169550, 90169552, 2, 640x360 
0x1382CA98, 37353951283749376, 90169578, 90169582, 4, 640x360 
0x1382CA98, 37353951284069656, 90169608, 90169610, 2, 640x360 
0x1382CA98, 37353951284393816, 90169640, 90169642, 2, 640x360 
0x1382CA98, 37353951284715296, 90169675, 90169679, 4, 640x360 
0x1382CA98, 37353951285030272, 90169700, 90169707, 7, 640x360 
0x1382CA98, 37353951285350264, 90169736, 90169738, 2, 640x360 
0x1382CA98, 37353951285674648, 90169762, 90169764, 2, 640x360 
0x1382CA98, 37353951285990080, 90169799, 90169811, 12, 640x360 
0x1382CA98, 37353951286309768, 90169827, 90169831, 4, 640x360 
0x1382CA98, 37353951286629992, 90169858, 90169866, 8, 640x360 
0x1382CA98, 37353951287109064, 90169905, 90169914, 9, 640x360 
0x1382CA98, 37353951287430672, 90169942, 90169948, 6, 640x360 
0x1382CA98, 37353951287758840, 90169973, 90169976, 3, 640x360 
0x1382CA98, 37353951288104672, 90170011, 90170020, 9, 640x360 
0x1382CA98, 37353951288389512, 90170041, 90170045, 4, 640x360 
0x1382CA98, 37353951288709368, 90170070, 90170073, 3, 640x360 
0x1382CA98, 37353951289126840, 90170121, 90170135, 14, 640x360 
0x1382CA98, 37353951289350672, 90170148, 90170153, 5, 640x360 
0x1382CA98, 37353951289671752, 90170172, 90170185, 13, 640x360 
0x1382CA98, 37353951289991928, 90170208, 90170213, 5, 640x360 
0x1382CA98, 37353951290323344, 90170233, 90170235, 2, 640x360 
0x1382CA98, 37353951290629224, 90170259, 90170265, 6, 640x360 
0x1382CA98, 37353951291109248, 90170305, 90170308, 3, 640x360 
0x1382CA98, 37353951291435816, 90170345, 90170348, 3, 640x360 
0x1382CA98, 37353951291748984, 90170376, 90170380, 4, 640x360 
0x1382CA98, 37353951292069408, 90170414, 90170416, 2, 640x360 
0x1382CA98, 37353951292388968, 90170447, 90170449, 2, 640x360 
0x1382CA98, 37353951292709384, 90170472, 90170475, 3, 640x360 
0x1382CA98, 37353951293032768, 90170505, 90170507, 2, 640x360 
0x1382CA98, 37353951293349608, 90170538, 90170540, 2, 640x360 
0x1382CA98, 37353951293672592, 90170573, 90170575, 2, 640x360 
0x1382CA98, 37353951293993592, 90170600, 90170602, 2, 640x360 
0x1382CA98, 37353951294309760, 90170633, 90170635, 2, 640x360 
0x1382CA98, 37353951294634688, 90170665, 90170667, 2, 640x360 
0x1382CA98, 37353951294953368, 90170696, 90170698, 2, 640x360 
0x1382CA98, 37353951295447968, 90170743, 90170749, 6, 640x360 
0x1382CA98, 37353951295774584, 90170771, 90170774, 3, 640x360 
0x1382CA98, 37353951296081336, 90170810, 90170823, 13, 640x360 
0x1382CA98, 37353951296395536, 90170846, 90170848, 2, 640x360 
0x1382CA98, 37353951296713064, 90170880, 90170891, 11, 640x360 
0x1382CA98, 37353951297037440, 90170902, 90170907, 5, 640x360 
0x1382CA98, 37353951297349464, 90170938, 90170941, 3, 640x360 
0x1382CA98, 37353951297678464, 90170966, 90170970, 4, 640x360 
0x1382CA98, 37353951297989584, 90170996, 90171006, 10, 640x360 
0x1382CA98, 37353951298315656, 90171036, 90171038, 2, 640x360 
0x1382CA98, 37353951298633176, 90171060, 90171066, 6, 640x360 
0x1382CA98, 37353951298952864, 90171098, 90171105, 7, 640x360 
0x1382CA98, 37353951299431512, 90171147, 90171155, 8, 640x360 
0x1382CA98, 37353951299748592, 90171174, 90171181, 7, 640x360 
0x1382CA98, 37353951300069184, 90171215, 90171217, 2, 640x360 
0x1382CA98, 37353951300392840, 90171248, 90171256, 8, 640x360 
0x1382CA98, 37353951300711256, 90171271, 90171277, 6, 640x360 
0x1382CA98, 37353951301029984, 90171304, 90171306, 2, 640x360 
0x1382CA98, 37353951301349568, 90171337, 90171338, 1, 640x360 
0x1382CA98, 37353951301688664, 90171366, 90171369, 3, 640x360 
0x1382CA98, 37353951302005600, 90171400, 90171403, 3, 640x360 
0x1382CA98, 37353951302315696, 90171435, 90171437, 2, 640x360 
0x1382CA98, 37353951302633952, 90171468, 90171470, 2, 640x360 
0x1382CA98, 37353951302949368, 90171491, 90171493, 2, 640x360 
0x1382CA98, 37353951303433880, 90171545, 90171548, 3, 640x360 
0x1382CA98, 37353951303753784, 90171577, 90171582, 5, 640x360 
0x1382CA98, 37353951304069144, 90171616, 90171619, 3, 640x360 
0x1382CA98, 37353951304389112, 90171646, 90171649, 3, 640x360 
0x1382CA98, 37353951304712464, 90171667, 90171674, 7, 640x360 
0x1382CA98, 37353951305028656, 90171700, 90171707, 7, 640x360 
0x1382CA98, 37353951305352928, 90171736, 90171745, 9, 640x360 
0x1382CA98, 37353951305669072, 90171760, 90171765, 5, 640x360 
0x1382CA98, 37353951305989584, 90171807, 90171809, 2, 640x360 
0x1382CA98, 37353951306309568, 90171825, 90171829, 4, 640x360 
0x1382CA98, 37353951306628856, 90171860, 90171864, 4, 640x360 
0x1382CA98, 37353951306951536, 90171890, 90171892, 2, 640x360 
0x1382CA98, 37353951307432376, 90171946, 90171955, 9, 640x360 
0x1382CA98, 37353951307748120, 90171983, 90171991, 8, 640x360 
0x1382CA98, 37353951308068680, 90172015, 90172018, 3, 640x360 
0x1382CA98, 37353951308388800, 90172048, 90172050, 2, 640x360 
0x1382CA98, 37353951308723936, 90172069, 90172077, 8, 640x360 
0x1382CA98, 37353951309029232, 90172100, 90172102, 2, 640x360 
0x1382CA98, 37353951309357312, 90172138, 90172140, 2, 640x360 
0x1382CA98, 37353951309701288, 90172171, 90172173, 2, 640x360 
0x1382CA98, 37353951309995584, 90172203, 90172204, 1, 640x360 
0x1382CA98, 37353951310311664, 90172231, 90172239, 8, 640x360 
0x1382CA98, 37353951310631224, 90172264, 90172271, 7, 640x360 
0x1382CA98, 37353951310957584, 90172296, 90172302, 6, 640x360 
0x1382CA98, 37353951311435280, 90172347, 90172351, 4, 640x360 
0x1382CA98, 37353951311762360, 90172375, 90172378, 3, 640x360 
0x1382CA98, 37353951312076584, 90172403, 90172405, 2, 640x360 
0x1382CA98, 37353951312392416, 90172436, 90172442, 6, 640x360 
0x1382CA98, 37353951312711528, 90172481, 90172485, 4, 640x360 
0x1382CA98, 37353951313032704, 90172508, 90172521, 13, 640x360 
0x1382CA98, 37353951313355040, 90172542, 90172545, 3, 640x360 
0x1382CA98, 37353951313670968, 90172574, 90172576, 2, 640x360 
0x1382CA98, 37353951313988368, 90172607, 90172610, 3, 640x360 
0x1382CA98, 37353951314308568, 90172629, 90172641, 12, 640x360 
0x1382CA98, 37353951314645024, 90172670, 90172676, 6, 640x360 
0x1382CA98, 37353951314963584, 90172692, 90172697, 5, 640x360 
0x1382CA98, 37353951315434992, 90172756, 90172758, 2, 640x360 
0x1382CA98, 37353951315748560, 90172774, 90172778, 4, 640x360 
0x1382CA98, 37353951316073632, 90172806, 90172807, 1, 640x360 
0x1382CA98, 37353951316392800, 90172840, 90172848, 8, 640x360 
0x1382CA98, 37353951316712096, 90172868, 90172870, 2, 640x360 
0x1382CA98, 37353951317029792, 90172903, 90172906, 3, 640x360 
0x1382CA98, 37353951317360752, 90172945, 90172957, 12, 640x360 
0x1382CA98, 37353951317672696, 90172977, 90172988, 11, 640x360 
0x1382CA98, 37353951317989760, 90173014, 90173023, 9, 640x360 
0x1382CA98, 37353951318335824, 90173039, 90173041, 2, 640x360 
0x1382CA98, 37353951318633480, 90173060, 90173075, 15, 640x360 
0x1382CA98, 37353951318957496, 90173095, 90173098, 3, 640x360 
0x1382CA98, 37353951319431272, 90173149, 90173153, 4, 640x360 
0x1382CA98, 37353951319748512, 90173181, 90173184, 3, 640x360 
0x1382CA98, 37353951320067672, 90173210, 90173215, 5, 640x360 
0x1382CA98, 37353951320387832, 90173237, 90173247, 10, 640x360 
0x1382CA98, 37353951320707936, 90173267, 90173273, 6, 640x360 
0x1382CA98, 37353951321028136, 90173301, 90173303, 2, 640x360 
0x1382CA98, 37353951321357456, 90173335, 90173339, 4, 640x360 
0x1382CA98, 37353951321669168, 90173369, 90173371, 2, 640x360 
0x1382CA98, 37353951321991592, 90173398, 90173402, 4, 640x360 
0x1382CA98, 37353951322309240, 90173426, 90173431, 5, 640x360 
0x1382CA98, 37353951322630024, 90173458, 90173473, 15, 640x360 
0x1382CA98, 37353951322953560, 90173492, 90173501, 9, 640x360 
0x1382CA98, 37353951323276392, 90173534, 90173541, 7, 640x360 
0x1382CA98, 37353951323748784, 90173574, 90173577, 3, 640x360 
0x1382CA98, 37353951324072712, 90173605, 90173608, 3, 640x360 
0x1382CA98, 37353951324387792, 90173637, 90173640, 3, 640x360 
0x1382CA98, 37353951324708080, 90173671, 90173677, 6, 640x360 
0x1382CA98, 37353951325029376, 90173702, 90173705, 3, 640x360 
0x1382CA98, 37353951325351656, 90173735, 90173737, 2, 640x360 
0x1382CA98, 37353951325669464, 90173769, 90173771, 2, 640x360 
0x1382CA98, 37353951325988928, 90173802, 90173804, 2, 640x360 
0x1382CA98, 37353951326308584, 90173829, 90173836, 7, 640x360 
0x1382CA98, 37353951326628856, 90173861, 90173867, 6, 640x360 
0x1382CA98, 37353951326948992, 90173892, 90173907, 15, 640x360 
0x1382CA98, 37353951327284408, 90173926, 90173945, 19, 640x360 
0x1382CA98, 37353951327748584, 90173985, 90173989, 4, 640x360 
0x1382CA98, 37353951328077928, 90174019, 90174022, 3, 640x360 
0x1382CA98, 37353951328390984, 90174046, 90174064, 18, 640x360 
0x1382CA98, 37353951328710408, 90174084, 90174086, 2, 640x360 
0x1382CA98, 37353951329027928, 90174118, 90174124, 6, 640x360 
0x1382CA98, 37353951329398928, 90174154, 90174156, 2, 640x360 
0x1382CA98, 37353951329672064, 90174175, 90174180, 5, 640x360 
0x1382CA98, 37353951329999352, 90174206, 90174208, 2, 640x360 
0x1382CA98, 37353951330356616, 90174249, 90174257, 8, 640x360 
0x1382CA98, 37353951330633928, 90174270, 90174273, 3, 640x360 
0x1382CA98, 37353951330948200, 90174294, 90174303, 9, 640x360 
0x1382CA98, 37353951331278160, 90174326, 90174332, 6, 640x360 
0x1382CA98, 37353951331748840, 90174384, 90174386, 2, 640x360 
0x1382CA98, 37353951332067272, 90174415, 90174418, 3, 640x360 
0x1382CA98, 37353951332388248, 90174450, 90174452, 2, 640x360 
0x1382CA98, 37353951332707744, 90174466, 90174468, 2, 640x360 
0x1382CA98, 37353951333028120, 90174507, 90174510, 3, 640x360 
0x1382CA98, 37353951333347736, 90174536, 90174539, 3, 640x360 
0x1382CA98, 37353951333667896, 90174562, 90174572, 10, 640x360 
0x1382CA98, 37353951333991944, 90174605, 90174607, 2, 640x360 
0x1382CA98, 37353951334308000, 90174633, 90174636, 3, 640x360 
0x1382CA98, 37353951334628192, 90174657, 90174661, 4, 640x360 
0x1382CA98, 37353951334962472, 90174690, 90174695, 5, 640x360 
0x1382CA98, 37353951335282904, 90174731, 90174733, 2, 640x360 
0x1382CA98, 37353951335748000, 90174785, 90174788, 3, 640x360 
0x1382CA98, 37353951336067840, 90174808, 90174811, 3, 640x360 
0x1382CA98, 37353951336391368, 90174847, 90174849, 2, 640x360 
0x1382CA98, 37353951336716944, 90174872, 90174874, 2, 640x360 
0x1382CA98, 37353951337065544, 90174909, 90174913, 4, 640x360 
0x1382CA98, 37353951337356128, 90174933, 90174936, 3, 640x360 
0x1382CA98, 37353951337675840, 90174974, 90174976, 2, 640x360 
0x1382CA98, 37353951337988864, 90175003, 90175005, 2, 640x360 
0x1382CA98, 37353951338313528, 90175035, 90175037, 2, 640x360 
0x1382CA98, 37353951338627912, 90175069, 90175072, 3, 640x360 
0x1382CA98, 37353951338948888, 90175100, 90175102, 2, 640x360 
0x1382CA98, 37353951339272800, 90175125, 90175133, 8, 640x360 
0x1382CA98, 37353951339752248, 90175188, 90175191, 3, 640x360 
0x1382CA98, 37353951340067384, 90175211, 90175220, 9, 640x360 
0x1382CA98, 37353951340387936, 90175243, 90175247, 4, 640x360 
0x1382CA98, 37353951340710840, 90175268, 90175270, 2, 640x360 
0x1382CA98, 37353951341031704, 90175298, 90175301, 3, 640x360 
0x1382CA98, 37353951341348464, 90175334, 90175336, 2, 640x360 
0x1382CA98, 37353951341668592, 90175369, 90175371, 2, 640x360 
0x1382CA98, 37353951341988232, 90175398, 90175402, 4, 640x360 
0x1382CA98, 37353951342314288, 90175437, 90175439, 2, 640x360 
0x1382CA98, 37353951342628088, 90175467, 90175473, 6, 640x360 
0x1382CA98, 37353951342953384, 90175491, 90175494, 3, 640x360 
0x1382CA98, 37353951343281496, 90175530, 90175533, 3, 640x360 
0x1382CA98, 37353951343747896, 90175580, 90175582, 2, 640x360 
0x1382CA98, 37353951344068112, 90175609, 90175613, 4, 640x360 
0x1382CA98, 37353951344387912, 90175641, 90175643, 2, 640x360 
0x1382CA98, 37353951344711672, 90175676, 90175681, 5, 640x360 
0x1382CA98, 37353951345028232, 90175704, 90175708, 4, 640x360 
0x1382CA98, 37353951345348720, 90175735, 90175739, 4, 640x360 
0x1382CA98, 37353951345668376, 90175768, 90175770, 2, 640x360 
0x1382CA98, 37353951345991456, 90175806, 90175809, 3, 640x360 
0x1382CA98, 37353951346308504, 90175825, 90175828, 3, 640x360 
0x1382CA98, 37353951346627888, 90175857, 90175860, 3, 640x360 
0x1382CA98, 37353951346953632, 90175889, 90175891, 2, 640x360 
0x1382CA98, 37353951347275864, 90175929, 90175936, 7, 640x360 
0x1382CA98, 37353951347749952, 90175975, 90175984, 9, 640x360 
0x1382CA98, 37353951348102088, 90176008, 90176024, 16, 640x360 
0x1382CA98, 37353951348405272, 90176049, 90176057, 8, 640x360 
0x1382CA98, 37353951348712760, 90176074, 90176077, 3, 640x360 
0x1382CA98, 37353951349027304, 90176104, 90176106, 2, 640x360 
0x1382CA98, 37353951349348048, 90176131, 90176135, 4, 640x360 
0x1382CA98, 37353951349671784, 90176172, 90176173, 1, 640x360 
0x1382CA98, 37353951349991824, 90176196, 90176203, 7, 640x360 
0x1382CA98, 37353951350307632, 90176226, 90176236, 10, 640x360 
0x1382CA98, 37353951350628832, 90176257, 90176260, 3, 640x360 
0x1382CA98, 37353951350955040, 90176290, 90176294, 4, 640x360 
0x1382CA98, 37353951351277344, 90176329, 90176337, 8, 640x360 
0x1382CA98, 37353951351589000, 90176359, 90176371, 12, 640x360 
0x1382CA98, 37353951352067656, 90176405, 90176408, 3, 640x360 
0x1382CA98, 37353951352389520, 90176436, 90176439, 3, 640x360 
0x1382CA98, 37353951352711800, 90176468, 90176470, 2, 640x360 
0x1382CA98, 37353951353028288, 90176503, 90176505, 2, 640x360 
0x1382CA98, 37353951353347944, 90176541, 90176543, 2, 640x360 
0x1382CA98, 37353951353668160, 90176569, 90176574, 5, 640x360 
0x1382CA98, 37353951353992576, 90176595, 90176601, 6, 640x360 
0x1382CA98, 37353951354315208, 90176626, 90176632, 6, 640x360 
0x1382CA98, 37353951354627752, 90176658, 90176667, 9, 640x360 
0x1382CA98, 37353951354948592, 90176690, 90176693, 3, 640x360 
0x1382CA98, 37353951355276152, 90176725, 90176730, 5, 640x360 
0x1382CA98, 37353951355593080, 90176757, 90176779, 22, 640x360 
0x1382CA98, 37353951356067256, 90176810, 90176821, 11, 640x360 
0x1382CA98, 37353951356387960, 90176835, 90176838, 3, 640x360 
0x1382CA98, 37353951356711992, 90176868, 90176870, 2, 640x360 
0x1382CA98, 37353951357029760, 90176903, 90176905, 2, 640x360 
0x1382CA98, 37353951357356208, 90176938, 90176940, 2, 640x360 
0x1382CA98, 37353951357670032, 90176976, 90176981, 5, 640x360 
0x1382CA98, 37353951357991792, 90177012, 90177021, 9, 640x360 
0x1382CA98, 37353951358315744, 90177033, 90177039, 6, 640x360 
0x1382CA98, 37353951358633176, 90177062, 90177073, 11, 640x360 
0x1382CA98, 37353951358958600, 90177096, 90177106, 10, 640x360 
0x1382CA98, 37353951359274992, 90177141, 90177145, 4, 640x360 
0x1382CA98, 37353951359592944, 90177159, 90177165, 6, 640x360 
0x1382CA98, 37353951360066648, 90177215, 90177217, 2, 640x360 
0x1382CA98, 37353951360390536, 90177247, 90177249, 2, 640x360 
0x1382CA98, 37353951360706872, 90177276, 90177281, 5, 640x360 
0x1382CA98, 37353951361031680, 90177304, 90177316, 12, 640x360 
0x1382CA98, 37353951361349768, 90177337, 90177339, 2, 640x360 
0x1382CA98, 37353951361670520, 90177373, 90177374, 1, 640x360 
0x1382CA98, 37353951361987080, 90177400, 90177402, 2, 640x360 
0x1382CA98, 37353951362307192, 90177427, 90177440, 13, 640x360 
0x1382CA98, 37353951362627496, 90177460, 90177474, 14, 640x360 
0x1382CA98, 37353951362956520, 90177492, 90177496, 4, 640x360 
0x1382CA98, 37353951363278352, 90177530, 90177539, 9, 640x360 
0x1382CA98, 37353951363587568, 90177556, 90177557, 1, 640x360 
0x1382CA98, 37353951364067528, 90177606, 90177609, 3, 640x360 
0x1382CA98, 37353951364387256, 90177643, 90177657, 14, 640x360 
0x1382CA98, 37353951364732248, 90177672, 90177674, 2, 640x360 
0x1382CA98, 37353951365028264, 90177703, 90177705, 2, 640x360 
0x1382CA98, 37353951365368592, 90177737, 90177739, 2, 640x360 
0x1382CA98, 37353951365667912, 90177768, 90177770, 2, 640x360 
0x1382CA98, 37353951365990816, 90177793, 90177802, 9, 640x360 
0x1382CA98, 37353951366306896, 90177828, 90177836, 8, 640x360 
0x1382CA98, 37353951366626712, 90177857, 90177859, 2, 640x360 
0x1382CA98, 37353951366953560, 90177889, 90177894, 5, 640x360 
0x1382CA98, 37353951367289768, 90177923, 90177927, 4, 640x360 
0x1382CA98, 37353951367589040, 90177960, 90177964, 4, 640x360 
0x1382CA98, 37353951368072160, 90178006, 90178008, 2, 640x360 
0x1382CA98, 37353951368387616, 90178043, 90178052, 9, 640x360 
0x1382CA98, 37353951368707616, 90178069, 90178073, 4, 640x360 
0x1382CA98, 37353951369030712, 90178108, 90178113, 5, 640x360 
0x1382CA98, 37353951369348360, 90178136, 90178138, 2, 640x360 
0x1382CA98, 37353951369677752, 90178171, 90178174, 3, 640x360 
0x1382CA98, 37353951369992888, 90178194, 90178205, 11, 640x360 
0x1382CA98, 37353951370310448, 90178229, 90178233, 4, 640x360 
0x1382CA98, 37353951370633288, 90178268, 90178271, 3, 640x360 
0x1382CA98, 37353951370952848, 90178294, 90178304, 10, 640x360 
0x1382CA98, 37353951371274168, 90178326, 90178332, 6, 640x360 
0x1382CA98, 37353951371597856, 90178363, 90178366, 3, 640x360 
0x1382CA98, 37353951372066368, 90178411, 90178415, 4, 640x360 
0x1382CA98, 37353951372393168, 90178435, 90178438, 3, 640x360 
0x1382CA98, 37353951372710960, 90178476, 90178480, 4, 640x360 
0x1382CA98, 37353951373031832, 90178504, 90178506, 2, 640x360 
0x1382CA98, 37353951373352120, 90178542, 90178544, 2, 640x360 
0x1382CA98, 37353951373671080, 90178563, 90178565, 2, 640x360 
0x1382CA98, 37353951373990376, 90178602, 90178607, 5, 640x360 
0x1382CA98, 37353951374308928, 90178626, 90178632, 6, 640x360 
0x1382CA98, 37353951374637936, 90178659, 90178677, 18, 640x360 
0x1382CA98, 37353951374955024, 90178704, 90178707, 3, 640x360 
0x1382CA98, 37353951375288480, 90178726, 90178732, 6, 640x360 
0x1382CA98, 37353951375594992, 90178765, 90178767, 2, 640x360 
0x1382CA98, 37353951375927808, 90178789, 90178792, 3, 640x360 
0x1382CA98, 37353951376386712, 90178836, 90178843, 7, 640x360 
0x1382CA98, 37353951376707032, 90178868, 90178871, 3, 640x360 
0x1382CA98, 37353951377026992, 90178900, 90178902, 2, 640x360 
0x1382CA98, 37353951377347208, 90178936, 90178938, 2, 640x360 
0x1382CA98, 37353951377671952, 90178968, 90178970, 2, 640x360 
0x1382CA98, 37353951377991512, 90179005, 90179008, 3, 640x360 
0x1382CA98, 37353951378306656, 90179032, 90179034, 2, 640x360 
0x1382CA98, 37353951378627120, 90179060, 90179071, 11, 640x360 
0x1382CA98, 37353951378950856, 90179091, 90179094, 3, 640x360 
0x1382CA98, 37353951379283432, 90179123, 90179125, 2, 640x360 
0x1382CA98, 37353951379588024, 90179161, 90179170, 9, 640x360 
0x1382CA98, 37353951379907880, 90179194, 90179205, 11, 640x360 
0x1382CA98, 37353951380387120, 90179242, 90179245, 3, 640x360 
0x1382CA98, 37353951380711104, 90179268, 90179271, 3, 640x360 
0x1382CA98, 37353951381027056, 90179300, 90179303, 3, 640x360 
0x1382CA98, 37353951381351568, 90179339, 90179341, 2, 640x360 
0x1382CA98, 37353951381666920, 90179376, 90179382, 6, 640x360 
0x1382CA98, 37353951381987240, 90179410, 90179417, 7, 640x360 
0x1382CA98, 37353951382324200, 90179446, 90179451, 5, 640x360 
0x1382CA98, 37353951382629944, 90179483, 90179491, 8, 640x360 
0x1382CA98, 37353951382957880, 90179512, 90179522, 10, 640x360 
0x1382CA98, 37353951383283744, 90179544, 90179555, 11, 640x360 
0x1382CA98, 37353951383595168, 90179562, 90179567, 5, 640x360 
0x1382CA98, 37353951383913256, 90179601, 90179604, 3, 640x360 
0x1382CA98, 37353951384386016, 90179645, 90179655, 10, 640x360 
0x1382CA98, 37353951384707336, 90179681, 90179688, 7, 640x360 
0x1382CA98, 37353951385026376, 90179700, 90179706, 6, 640x360 
0x1382CA98, 37353951385348256, 90179750, 90179757, 7, 640x360 
0x1382CA98, 37353951385671376, 90179769, 90179771, 2, 640x360 
0x1382CA98, 37353951385990048, 90179802, 90179805, 3, 640x360 
0x1382CA98, 37353951386309904, 90179842, 90179845, 3, 640x360 
0x1382CA98, 37353951386630376, 90179870, 90179875, 5, 640x360 
0x1382CA98, 37353951386956792, 90179900, 90179903, 3, 640x360 
0x1382CA98, 37353951387266528, 90179923, 90179925, 2, 640x360 
0x1382CA98, 37353951387590600, 90179960, 90179964, 4, 640x360 
0x1382CA98, 37353951387914056, 90179992, 90179994, 2, 640x360 
0x1382CA98, 37353951388387080, 90180042, 90180045, 3, 640x360 
0x1382CA98, 37353951388706288, 90180068, 90180073, 5, 640x360 
0x1382CA98, 37353951389026744, 90180102, 90180104, 2, 640x360 
0x1382CA98, 37353951389346816, 90180134, 90180137, 3, 640x360 
0x1382CA98, 37353951389666872, 90180163, 90180169, 6, 640x360 
0x1382CA98, 37353951389993624, 90180203, 90180210, 7, 640x360 
0x1382CA98, 37353951390307016, 90180231, 90180233, 2, 640x360 
0x1382CA98, 37353951390627168, 90180262, 90180264, 2, 640x360 
0x1382CA98, 37353951390950848, 90180295, 90180300, 5, 640x360 
0x1382CA98, 37353951391272848, 90180328, 90180331, 3, 640x360 
0x1382CA98, 37353951391598248, 90180362, 90180368, 6, 640x360 
0x1382CA98, 37353951391931720, 90180414, 90180421, 7, 640x360 
0x1382CA98, 37353951392394008, 90180458, 90180465, 7, 640x360 
0x1382CA98, 37353951392722120, 90180477, 90180491, 14, 640x360 
0x1382CA98, 37353951393033200, 90180515, 90180518, 3, 640x360 
0x1382CA98, 37353951393358328, 90180538, 90180546, 8, 640x360 
0x1382CA98, 37353951393666192, 90180566, 90180571, 5, 640x360 
0x1382CA98, 37353951393986160, 90180599, 90180607, 8, 640x360 
0x1382CA98, 37353951394310056, 90180625, 90180631, 6, 640x360 
0x1382CA98, 37353951394632752, 90180660, 90180672, 12, 640x360 
0x1382CA98, 37353951394962720, 90180697, 90180699, 2, 640x360 
0x1382CA98, 37353951395278872, 90180727, 90180731, 4, 640x360 
0x1382CA98, 37353951395590504, 90180755, 90180757, 2, 640x360 
0x1382CA98, 37353951395907624, 90180797, 90180799, 2, 640x360 
0x1382CA98, 37353951396386880, 90180837, 90180839, 2, 640x360 
0x1382CA98, 37353951396710856, 90180875, 90180878, 3, 640x360 
0x1382CA98, 37353951397026864, 90180910, 90180914, 4, 640x360 
0x1382CA98, 37353951397352776, 90180937, 90180942, 5, 640x360 
0x1382CA98, 37353951397670192, 90180963, 90180965, 2, 640x360 
0x1382CA98, 37353951397989680, 90180993, 90181000, 7, 640x360 
0x1382CA98, 37353951398306576, 90181033, 90181036, 3, 640x360 
0x1382CA98, 37353951398640832, 90181074, 90181081, 7, 640x360 
0x1382CA98, 37353951398956120, 90181103, 90181111, 8, 640x360 
0x1382CA98, 37353951399271480, 90181131, 90181140, 9, 640x360 
0x1382CA98, 37353951399605424, 90181162, 90181167, 5, 640x360 
0x1382CA98, 37353951399912440, 90181194, 90181207, 13, 640x360 
0x1382CA98, 37353951400390304, 90181243, 90181249, 6, 640x360 
0x1382CA98, 37353951400706040, 90181270, 90181272, 2, 640x360 
0x1382CA98, 37353951401025664, 90181312, 90181323, 11, 640x360 
0x1382CA98, 37353951401352200, 90181335, 90181342, 7, 640x360 
0x1382CA98, 37353951401669136, 90181377, 90181390, 13, 640x360 
0x1382CA98, 37353951401985872, 90181411, 90181423, 12, 640x360 
0x1382CA98, 37353951402311224, 90181436, 90181438, 2, 640x360 
0x1382CA98, 37353951402662248, 90181469, 90181471, 2, 640x360 
0x1382CA98, 37353951402951056, 90181494, 90181499, 5, 640x360 
0x1382CA98, 37353951403280680, 90181528, 90181532, 4, 640x360 
0x1382CA98, 37353951403592784, 90181555, 90181557, 2, 640x360 
0x1382CA98, 37353951403911712, 90181597, 90181607, 10, 640x360 
0x1382CA98, 37353951404227464, 90181631, 90181634, 3, 640x360 
0x1382CA98, 37353951404707600, 90181670, 90181672, 2, 640x360 
0x1382CA98, 37353951405025456, 90181708, 90181710, 2, 640x360 
0x1382CA98, 37353951405349744, 90181747, 90181749, 2, 640x360 
0x1382CA98, 37353951405676024, 90181771, 90181773, 2, 640x360 
0x1382CA98, 37353951405989976, 90181813, 90181817, 4, 640x360 
0x1382CA98, 37353951406313248, 90181836, 90181842, 6, 640x360 
0x1382CA98, 37353951406629968, 90181865, 90181873, 8, 640x360 
0x1382CA98, 37353951406952384, 90181892, 90181896, 4, 640x360 
0x1382CA98, 37353951407276424, 90181923, 90181926, 3, 640x360 
0x1382CA98, 37353951407586464, 90181957, 90181959, 2, 640x360 
0x1382CA98, 37353951407906112, 90181989, 90181991, 2, 640x360 
0x1382CA98, 37353951408226768, 90182023, 90182025, 2, 640x360 
0x1382CA98, 37353952021332536, 90243349, 90243352, 3, 640x360 
0x1382CA98, 37353952021662248, 90243376, 90243379, 3, 640x360 
0x1382CA98, 37353952021970224, 90243404, 90243410, 6, 640x360 
0x1382CA98, 37353952022289880, 90243436, 90243439, 3, 640x360 
0x1382CA98, 37353952022627672, 90243464, 90243476, 12, 640x360 
0x1382CA98, 37353952022931816, 90243505, 90243508, 3, 640x360 
0x1382CA98, 37353952023260136, 90243534, 90243541, 7, 640x360 
0x1382CA98, 37353952023735040, 90243586, 90243589, 3, 640x360 
0x1382CA98, 37353952024054368, 90243606, 90243607, 1, 640x360 
0x1382CA98, 37353952024373128, 90243648, 90243650, 2, 640x360 
0x1382CA98, 37353952024691920, 90243673, 90243675, 2, 640x360 
0x1382CA98, 37353952025013344, 90243704, 90243709, 5, 640x360 
0x1382CA98, 37353952025333512, 90243737, 90243746, 9, 640x360 
0x1382CA98, 37353952025663160, 90243773, 90243775, 2, 640x360 
0x1382CA98, 37353952025998056, 90243804, 90243813, 9, 640x360 
0x1382CA98, 37353952026297056, 90243855, 90243859, 4, 640x360 
0x1382CA98, 37353952026633568, 90243874, 90243877, 3, 640x360 
0x1382CA98, 37353952026931936, 90243905, 90243910, 5, 640x360 
0x1382CA98, 37353952027250744, 90243936, 90243938, 2, 640x360 
0x1382CA98, 37353952027569512, 90243969, 90243972, 3, 640x360 
0x1382CA98, 37353952028053456, 90244009, 90244019, 10, 640x360 
0x1382CA98, 37353952028368976, 90244037, 90244040, 3, 640x360 
0x1382CA98, 37353952028694744, 90244077, 90244084, 7, 640x360 
0x1382CA98, 37353952029017736, 90244112, 90244118, 6, 640x360 
0x1382CA98, 37353952029334256, 90244144, 90244149, 5, 640x360 
0x1382CA98, 37353952029653152, 90244172, 90244174, 2, 640x360 
0x1382CA98, 37353952029972040, 90244197, 90244203, 6, 640x360 
0x1382CA98, 37353952030289680, 90244229, 90244241, 12, 640x360 
0x1382CA98, 37353952030626320, 90244268, 90244271, 3, 640x360 
0x1382CA98, 37353952030940840, 90244304, 90244306, 2, 640x360 
0x1382CA98, 37353952031253584, 90244330, 90244334, 4, 640x360 
0x1382CA98, 37353952031575072, 90244365, 90244368, 3, 640x360 
0x1382CA98, 37353952032048704, 90244410, 90244413, 3, 640x360 
0x1382CA98, 37353952032369392, 90244444, 90244457, 13, 640x360 
0x1382CA98, 37353952032700968, 90244470, 90244473, 3, 640x360 
0x1382CA98, 37353952033036712, 90244511, 90244516, 5, 640x360 
0x1382CA98, 37353952033329184, 90244543, 90244545, 2, 640x360 
0x1382CA98, 37353952033649680, 90244571, 90244573, 2, 640x360 
0x1382CA98, 37353952033969328, 90244597, 90244606, 9, 640x360 
0x1382CA98, 37353952034289280, 90244629, 90244636, 7, 640x360 
0x1382CA98, 37353952034613640, 90244661, 90244667, 6, 640x360 
0x1382CA98, 37353952034935976, 90244694, 90244700, 6, 640x360 
0x1382CA98, 37353952035250440, 90244731, 90244734, 3, 640x360 
0x1382CA98, 37353952035576816, 90244768, 90244770, 2, 640x360 
0x1382CA98, 37353952036060672, 90244815, 90244820, 5, 640x360 
0x1382CA98, 37353952036369520, 90244841, 90244846, 5, 640x360 
0x1382CA98, 37353952036688928, 90244872, 90244874, 2, 640x360 
0x1382CA98, 37353952037012128, 90244908, 90244910, 2, 640x360 
0x1382CA98, 37353952037331816, 90244942, 90244944, 2, 640x360 
0x1382CA98, 37353952037649568, 90244967, 90244973, 6, 640x360 
0x1382CA98, 37353952037969136, 90245002, 90245007, 5, 640x360 
0x1382CA98, 37353952038290800, 90245032, 90245041, 9, 640x360 
0x1382CA98, 37353952038616248, 90245067, 90245073, 6, 640x360 
0x1382CA98, 37353952038940008, 90245097, 90245106, 9, 640x360 
0x1382CA98, 37353952039250288, 90245130, 90245138, 8, 640x360 
0x1382CA98, 37353952039569176, 90245167, 90245174, 7, 640x360 
0x1382CA98, 37353952040048976, 90245207, 90245214, 7, 640x360 
0x1382CA98, 37353952040368904, 90245237, 90245257, 20, 640x360 
0x1382CA98, 37353952040694536, 90245288, 90245293, 5, 640x360 
0x1382CA98, 37353952041048320, 90245323, 90245325, 2, 640x360 
0x1382CA98, 37353952041336656, 90245345, 90245350, 5, 640x360 
0x1382CA98, 37353952041654064, 90245371, 90245374, 3, 640x360 
0x1382CA98, 37353952041972976, 90245407, 90245411, 4, 640x360 
0x1382CA98, 37353952042311744, 90245446, 90245452, 6, 640x360 
0x1382CA98, 37353952042640312, 90245489, 90245503, 14, 640x360 
0x1382CA98, 37353952042934392, 90245503, 90245505, 2, 640x360 
0x1382CA98, 37353952043250104, 90245536, 90245539, 3, 640x360 
0x1382CA98, 37353952043575168, 90245571, 90245577, 6, 640x360 
0x1382CA98, 37353952044051928, 90245643, 90245651, 8, 640x360 
0x1382CA98, 37353952044385312, 90245661, 90245672, 11, 640x360 
0x1382CA98, 37353952044731264, 90245710, 90245726, 16, 640x360 
0x1382CA98, 37353952045015400, 90245727, 90245734, 7, 640x360 
0x1382CA98, 37353952045338120, 90245755, 90245759, 4, 640x360 
0x1382CA98, 37353952045669032, 90245782, 90245791, 9, 640x360 
0x1382CA98, 37353952045978880, 90245804, 90245814, 10, 640x360 
0x1382CA98, 37353952046308808, 90245857, 90245862, 5, 640x360 
0x1382CA98, 37353952046645232, 90245874, 90245877, 3, 640x360 
0x1382CA98, 37353952046983376, 90245909, 90245916, 7, 640x360 
0x1382CA98, 37353952047253168, 90245937, 90245942, 5, 640x360 
0x1382CA98, 37353952047572280, 90245971, 90245974, 3, 640x360 
0x1382CA98, 37353952048053088, 90246011, 90246025, 14, 640x360 
0x1382CA98, 37353952048382968, 90246051, 90246053, 2, 640x360 
0x1382CA98, 37353952048692552, 90246076, 90246079, 3, 640x360 
0x1382CA98, 37353952049012632, 90246104, 90246113, 9, 640x360 
0x1382CA98, 37353952049329960, 90246138, 90246140, 2, 640x360 
0x1382CA98, 37353952049653760, 90246177, 90246184, 7, 640x360 
0x1382CA98, 37353952049973352, 90246213, 90246223, 10, 640x360 
0x1382CA98, 37353952050299384, 90246230, 90246244, 14, 640x360 
0x1382CA98, 37353952050635328, 90246263, 90246271, 8, 640x360 
0x1382CA98, 37353952050940280, 90246294, 90246301, 7, 640x360 
0x1382CA98, 37353952051256976, 90246327, 90246333, 6, 640x360 
0x1382CA98, 37353952051574128, 90246367, 90246370, 3, 640x360 
0x1382CA98, 37353952051892704, 90246387, 90246389, 2, 640x360 
0x1382CA98, 37353952052377904, 90246439, 90246443, 4, 640x360 
0x1382CA98, 37353952052691984, 90246481, 90246484, 3, 640x360 
0x1382CA98, 37353952053013112, 90246506, 90246508, 2, 640x360 
0x1382CA98, 37353952053331224, 90246543, 90246547, 4, 640x360 
0x1382CA98, 37353952053648824, 90246566, 90246569, 3, 640x360 
0x1382CA98, 37353952053973136, 90246604, 90246606, 2, 640x360 
0x1382CA98, 37353952054289832, 90246639, 90246642, 3, 640x360 
0x1382CA98, 37353952054623368, 90246672, 90246674, 2, 640x360 
0x1382CA98, 37353952054930352, 90246703, 90246706, 3, 640x360 
0x1382CA98, 37353952055250744, 90246737, 90246739, 2, 640x360 
0x1382CA98, 37353952055568832, 90246782, 90246784, 2, 640x360 
0x1382CA98, 37353952055889304, 90246791, 90246794, 3, 640x360 
0x1382CA98, 37353952056373864, 90246844, 90246857, 13, 640x360 
0x1382CA98, 37353952056695152, 90246870, 90246873, 3, 640x360 
0x1382CA98, 37353952057010552, 90246904, 90246910, 6, 640x360 
0x1382CA98, 37353952057331888, 90246943, 90246947, 4, 640x360 
0x1382CA98, 37353952057648760, 90246972, 90246974, 2, 640x360 
0x1382CA98, 37353952057968424, 90247003, 90247006, 3, 640x360 
0x1382CA98, 37353952058292872, 90247033, 90247036, 3, 640x360 
0x1382CA98, 37353952058634904, 90247072, 90247074, 2, 640x360 
0x1382CA98, 37353952058935848, 90247093, 90247097, 4, 640x360 
0x1382CA98, 37353952059251872, 90247125, 90247136, 11, 640x360 
0x1382CA98, 37353952059586472, 90247165, 90247175, 10, 640x360 
0x1382CA98, 37353952059894184, 90247199, 90247204, 5, 640x360 
0x1382CA98, 37353952060368056, 90247245, 90247250, 5, 640x360 
0x1382CA98, 37353952060694704, 90247270, 90247273, 3, 640x360 
0x1382CA98, 37353952061011296, 90247315, 90247324, 9, 640x360 
0x1382CA98, 37353952061334728, 90247342, 90247351, 9, 640x360 
0x1382CA98, 37353952061691560, 90247374, 90247378, 4, 640x360 
0x1382CA98, 37353952061971096, 90247420, 90247426, 6, 640x360 
0x1382CA98, 37353952062310696, 90247447, 90247469, 22, 640x360 
0x1382CA98, 37353952062641464, 90247487, 90247491, 4, 640x360 
0x1382CA98, 37353952062940856, 90247504, 90247509, 5, 640x360 
0x1382CA98, 37353952063264712, 90247543, 90247551, 8, 640x360 
0x1382CA98, 37353952063575192, 90247567, 90247570, 3, 640x360 
0x1382CA98, 37353952063896016, 90247593, 90247596, 3, 640x360 
0x1382CA98, 37353952064381576, 90247644, 90247648, 4, 640x360 
0x1382CA98, 37353952064694256, 90247682, 90247685, 3, 640x360 
0x1382CA98, 37353952065008672, 90247708, 90247710, 2, 640x360 
0x1382CA98, 37353952065345088, 90247738, 90247740, 2, 640x360 
0x1382CA98, 37353952065652768, 90247771, 90247773, 2, 640x360 
0x1382CA98, 37353952065968992, 90247805, 90247807, 2, 640x360 
0x1382CA98, 37353952066292352, 90247843, 90247849, 6, 640x360 
0x1382CA98, 37353952066636784, 90247870, 90247873, 3, 640x360 
0x1382CA98, 37353952066935584, 90247912, 90247919, 7, 640x360 
0x1382CA98, 37353952067252024, 90247929, 90247941, 12, 640x360 
0x1382CA98, 37353952067568808, 90247959, 90247975, 16, 640x360 
0x1382CA98, 37353952067891816, 90247993, 90248010, 17, 640x360 
0x1382CA98, 37353952068373856, 90248042, 90248046, 4, 640x360 
0x1382CA98, 37353952068692040, 90248075, 90248079, 4, 640x360 
0x1382CA98, 37353952069026872, 90248109, 90248114, 5, 640x360 
0x1382CA98, 37353952069339200, 90248136, 90248140, 4, 640x360 
0x1382CA98, 37353952069654552, 90248174, 90248176, 2, 640x360 
0x1382CA98, 37353952069975448, 90248204, 90248206, 2, 640x360 
0x1382CA98, 37353952070295200, 90248238, 90248241, 3, 640x360 
0x1382CA98, 37353952070617608, 90248272, 90248274, 2, 640x360 
0x1382CA98, 37353952070963184, 90248304, 90248306, 2, 640x360 
0x1382CA98, 37353952071249440, 90248333, 90248342, 9, 640x360 
0x1382CA98, 37353952071568704, 90248367, 90248374, 7, 640x360 
0x1382CA98, 37353952071889616, 90248398, 90248409, 11, 640x360 
0x1382CA98, 37353952072368000, 90248443, 90248446, 3, 640x360 
0x1382CA98, 37353952072693056, 90248476, 90248482, 6, 640x360 
0x1382CA98, 37353952073015008, 90248517, 90248521, 4, 640x360 
0x1382CA98, 37353952073331640, 90248542, 90248548, 6, 640x360 
0x1382CA98, 37353952073654848, 90248576, 90248578, 2, 640x360 
0x1382CA98, 37353952073980712, 90248610, 90248619, 9, 640x360 
0x1382CA98, 37353952074317824, 90248638, 90248642, 4, 640x360 
0x1382CA98, 37353952074636416, 90248671, 90248677, 6, 640x360 
0x1382CA98, 37353952074978736, 90248719, 90248732, 13, 640x360 
0x1382CA98, 37353952075264032, 90248751, 90248760, 9, 640x360 
0x1382CA98, 37353952075575632, 90248769, 90248773, 4, 640x360 
0x1382CA98, 37353952075892928, 90248799, 90248808, 9, 640x360 
0x1382CA98, 37353952076367448, 90248842, 90248852, 10, 640x360 
0x1382CA98, 37353952076691048, 90248886, 90248894, 8, 640x360 
0x1382CA98, 37353952077015920, 90248915, 90248917, 2, 640x360 
0x1382CA98, 37353952077331264, 90248941, 90248943, 2, 640x360 
0x1382CA98, 37353952077650528, 90248963, 90248974, 11, 640x360 
0x1382CA98, 37353952077968208, 90249001, 90249007, 6, 640x360 
0x1382CA98, 37353952078290880, 90249026, 90249032, 6, 640x360 
0x1382CA98, 37353952078631312, 90249065, 90249073, 8, 640x360 
0x1382CA98, 37353952078939008, 90249097, 90249108, 11, 640x360 
0x1382CA98, 37353952079248856, 90249128, 90249139, 11, 640x360 
0x1382CA98, 37353952079571616, 90249163, 90249168, 5, 640x360 
0x1382CA98, 37353952079888064, 90249195, 90249198, 3, 640x360 
0x1382CA98, 37353952080211768, 90249219, 90249227, 8, 640x360 
0x1382CA98, 37353952080687560, 90249285, 90249292, 7, 640x360 
0x1382CA98, 37353952081007776, 90249311, 90249314, 3, 640x360 
0x1382CA98, 37353952081328496, 90249339, 90249347, 8, 640x360 
0x1382CA98, 37353952081647784, 90249367, 90249374, 7, 640x360 
0x1382CA98, 37353952081967608, 90249398, 90249401, 3, 640x360 
0x1382CA98, 37353952082288848, 90249437, 90249440, 3, 640x360 
0x1382CA98, 37353952082612704, 90249462, 90249471, 9, 640x360 
0x1382CA98, 37353952082932080, 90249493, 90249497, 4, 640x360 
0x1382CA98, 37353952083248912, 90249534, 90249544, 10, 640x360 
0x1382CA98, 37353952083572072, 90249555, 90249564, 9, 640x360 
0x1382CA98, 37353952083892392, 90249590, 90249597, 7, 640x360 
0x1382CA98, 37353952084207888, 90249622, 90249624, 2, 640x360 
0x1382CA98, 37353952084687864, 90249675, 90249677, 2, 640x360 
0x1382CA98, 37353952085028928, 90249704, 90249706, 2, 640x360 
0x1382CA98, 37353952085331464, 90249740, 90249742, 2, 640x360 
0x1382CA98, 37353952085661104, 90249769, 90249777, 8, 640x360 
0x1382CA98, 37353952085968376, 90249795, 90249801, 6, 640x360 
0x1382CA98, 37353952086301664, 90249827, 90249831, 4, 640x360 
0x1382CA98, 37353952086616048, 90249861, 90249865, 4, 640x360 
0x1382CA98, 37353952086955424, 90249902, 90249910, 8, 640x360 
0x1382CA98, 37353952087251960, 90249936, 90249939, 3, 640x360 
0x1382CA98, 37353952087567968, 90249959, 90249961, 2, 640x360 
0x1382CA98, 37353952087887784, 90249988, 90249991, 3, 640x360 
0x1382CA98, 37353952088211616, 90250024, 90250027, 3, 640x360 
0x1382CA98, 37353952088687344, 90250079, 90250092, 13, 640x360 
0x1382CA98, 37353952089045792, 90250110, 90250116, 6, 640x360 
0x1382CA98, 37353952089335416, 90250143, 90250147, 4, 640x360 
0x1382CA98, 37353952089652128, 90250174, 90250179, 5, 640x360 
0x1382CA98, 37353952089987384, 90250220, 90250228, 8, 640x360 
0x1382CA98, 37353952090306664, 90250245, 90250254, 9, 640x360 
0x1382CA98, 37353952090662856, 90250285, 90250287, 2, 640x360 
0x1382CA98, 37353952090943008, 90250308, 90250310, 2, 640x360 
0x1382CA98, 37353952091248584, 90250340, 90250350, 10, 640x360 
0x1382CA98, 37353952091580360, 90250361, 90250366, 5, 640x360 
0x1382CA98, 37353952091892232, 90250392, 90250403, 11, 640x360 
0x1382CA98, 37353952092237088, 90250427, 90250432, 5, 640x360 
0x1382CA98, 37353952092691168, 90250471, 90250476, 5, 640x360 
0x1382CA98, 37353952093016896, 90250514, 90250517, 3, 640x360 
0x1382CA98, 37353952093336592, 90250550, 90250553, 3, 640x360 
0x1382CA98, 37353952093666736, 90250578, 90250603, 25, 640x360 
0x1382CA98, 37353952093986712, 90250618, 90250624, 6, 640x360 
0x1382CA98, 37353952094305624, 90250644, 90250666, 22, 640x360 
0x1382CA98, 37353952094644592, 90250679, 90250688, 9, 640x360 
0x1382CA98, 37353952094974432, 90250707, 90250710, 3, 640x360 
0x1382CA98, 37353952095267528, 90250739, 90250750, 11, 640x360 
0x1382CA98, 37353952095582776, 90250772, 90250779, 7, 640x360 
0x1382CA98, 37353952095909032, 90250806, 90250820, 14, 640x360 
0x1382CA98, 37353952096232560, 90250827, 90250832, 5, 640x360 
0x1382CA98, 37353952096688016, 90250877, 90250880, 3, 640x360 
0x1382CA98, 37353952097009728, 90250905, 90250913, 8, 640x360 
0x1382CA98, 37353952097327064, 90250939, 90250941, 2, 640x360 
0x1382CA98, 37353952097647464, 90250968, 90250975, 7, 640x360 
0x1382CA98, 37353952097967096, 90250992, 90250994, 2, 640x360 
0x1382CA98, 37353952098289960, 90251027, 90251030, 3, 640x360 
0x1382CA98, 37353952098614088, 90251066, 90251074, 8, 640x360 
0x1382CA98, 37353952098944200, 90251093, 90251100, 7, 640x360 
0x1382CA98, 37353952099257056, 90251135, 90251144, 9, 640x360 
0x1382CA98, 37353952099567744, 90251167, 90251170, 3, 640x360 
0x1382CA98, 37353952099887440, 90251191, 90251193, 2, 640x360 
0x1382CA98, 37353952100211416, 90251227, 90251230, 3, 640x360 
0x1382CA98, 37353952100687184, 90251268, 90251270, 2, 640x360 
0x1382CA98, 37353952101007032, 90251310, 90251313, 3, 640x360 
0x1382CA98, 37353952101334424, 90251343, 90251345, 2, 640x360 
0x1382CA98, 37353952101647888, 90251375, 90251377, 2, 640x360 
0x1382CA98, 37353952101967176, 90251396, 90251403, 7, 640x360 
0x1382CA98, 37353952102287336, 90251428, 90251436, 8, 640x360 
0x1382CA98, 37353952102607768, 90251467, 90251470, 3, 640x360 
0x1382CA98, 37353952102935232, 90251496, 90251510, 14, 640x360 
0x1382CA98, 37353952103253816, 90251545, 90251552, 7, 640x360 
0x1382CA98, 37353952103568248, 90251588, 90251594, 6, 640x360 
0x1382CA98, 37353952103948432, 90251615, 90251625, 10, 640x360 
0x1382CA98, 37353952104213136, 90251634, 90251646, 12, 640x360 
0x1382CA98, 37353952104692520, 90251674, 90251679, 5, 640x360 
0x1382CA98, 37353952105010320, 90251705, 90251706, 1, 640x360 
0x1382CA98, 37353952105327992, 90251743, 90251746, 3, 640x360 
0x1382CA98, 37353952105647320, 90251772, 90251774, 2, 640x360 
0x1382CA98, 37353952105970776, 90251795, 90251802, 7, 640x360 
0x1382CA98, 37353952106287240, 90251827, 90251835, 8, 640x360 
0x1382CA98, 37353952106608400, 90251865, 90251869, 4, 640x360 
0x1382CA98, 37353952106930336, 90251897, 90251903, 6, 640x360 
0x1382CA98, 37353952107252288, 90251922, 90251925, 3, 640x360 
0x1382CA98, 37353952107571176, 90251959, 90251962, 3, 640x360 
0x1382CA98, 37353952107894824, 90251992, 90251994, 2, 640x360 
0x1382CA98, 37353952108211320, 90252025, 90252027, 2, 640x360 
0x1382CA98, 37353952108535992, 90252057, 90252061, 4, 640x360 
0x1382CA98, 37353952109007016, 90252103, 90252109, 6, 640x360 
0x1382CA98, 37353952109326968, 90252131, 90252134, 3, 640x360 
0x1382CA98, 37353952109651360, 90252165, 90252167, 2, 640x360 
0x1382CA98, 37353952109967760, 90252195, 90252201, 6, 640x360 
0x1382CA98, 37353952110293000, 90252229, 90252240, 11, 640x360 
0x1382CA98, 37353952110622720, 90252261, 90252276, 15, 640x360 
0x1382CA98, 37353952110933896, 90252311, 90252319, 8, 640x360 
0x1382CA98, 37353952111302008, 90252344, 90252351, 7, 640x360 
0x1382CA98, 37353952111567552, 90252370, 90252383, 13, 640x360 
0x1382CA98, 37353952111889056, 90252406, 90252409, 3, 640x360 
0x1382CA98, 37353952112208944, 90252438, 90252442, 4, 640x360 
0x1382CA98, 37353952112535600, 90252459, 90252464, 5, 640x360 
0x1382CA98, 37353952113006584, 90252510, 90252512, 2, 640x360 
0x1382CA98, 37353952113327200, 90252538, 90252541, 3, 640x360 
0x1382CA98, 37353952113646864, 90252567, 90252570, 3, 640x360 
0x1382CA98, 37353952113972024, 90252599, 90252609, 10, 640x360 
0x1382CA98, 37353952114293488, 90252627, 90252630, 3, 640x360 
0x1382CA98, 37353952114615280, 90252663, 90252665, 2, 640x360 
0x1382CA98, 37353952114929208, 90252700, 90252702, 2, 640x360 
0x1382CA98, 37353952115254416, 90252730, 90252734, 4, 640x360 
0x1382CA98, 37353952115570104, 90252767, 90252769, 2, 640x360 
0x1382CA98, 37353952115887984, 90252791, 90252794, 3, 640x360 
0x1382CA98, 37353952116207912, 90252831, 90252835, 4, 640x360 
0x1382CA98, 37353952116533664, 90252863, 90252868, 5, 640x360 
0x1382CA98, 37353952117010240, 90252903, 90252909, 6, 640x360 
0x1382CA98, 37353952117341288, 90252939, 90252941, 2, 640x360 
0x1382CA98, 37353952117654776, 90252971, 90252980, 9, 640x360 
0x1382CA98, 37353952117967256, 90252996, 90253008, 12, 640x360 
0x1382CA98, 37353952118290680, 90253033, 90253042, 9, 640x360 
0x1382CA98, 37353952118624008, 90253060, 90253063, 3, 640x360 
0x1382CA98, 37353952118942424, 90253100, 90253109, 9, 640x360 
0x1382CA98, 37353952119250080, 90253131, 90253137, 6, 640x360 
0x1382CA98, 37353952119568176, 90253158, 90253160, 2, 640x360 
0x1382CA98, 37353952119887480, 90253192, 90253193, 1, 640x360 
0x1382CA98, 37353952120209552, 90253222, 90253224, 2, 640x360 
0x1382CA98, 37353952120531136, 90253255, 90253257, 2, 640x360 
0x1382CA98, 37353952121006328, 90253309, 90253311, 2, 640x360 
0x1382CA98, 37353952121326416, 90253341, 90253343, 2, 640x360 
0x1382CA98, 37353952121647200, 90253366, 90253373, 7, 640x360 
0x1382CA98, 37353952121967104, 90253410, 90253412, 2, 640x360 
0x1382CA98, 37353952122295760, 90253443, 90253446, 3, 640x360 
0x1382CA98, 37353952122612856, 90253466, 90253481, 15, 640x360 
0x1382CA98, 37353952122936904, 90253505, 90253508, 3, 640x360 
0x1382CA98, 37353952123251664, 90253529, 90253535, 6, 640x360 
0x1382CA98, 37353952123567656, 90253557, 90253560, 3, 640x360 
0x1382CA98, 37353952123887824, 90253587, 90253589, 2, 640x360 
0x1382CA98, 37353952124207232, 90253620, 90253631, 11, 640x360 
0x1382CA98, 37353952124538264, 90253665, 90253675, 10, 640x360 
0x1382CA98, 37353952125006680, 90253709, 90253711, 2, 640x360 
0x1382CA98, 37353952125326800, 90253732, 90253740, 8, 640x360 
0x1382CA98, 37353952125646992, 90253778, 90253783, 5, 640x360 
0x1382CA98, 37353952125972328, 90253809, 90253811, 2, 640x360 
0x1382CA98, 37353952126292640, 90253843, 90253845, 2, 640x360 
0x1382CA98, 37353952126625848, 90253877, 90253881, 4, 640x360 
0x1382CA98, 37353952126931320, 90253904, 90253910, 6, 640x360 
0x1382CA98, 37353952127249080, 90253936, 90253938, 2, 640x360 
0x1382CA98, 37353952127566680, 90253958, 90253961, 3, 640x360 
0x1382CA98, 37353952127887176, 90253989, 90253994, 5, 640x360 
0x1382CA98, 37353952128213320, 90254020, 90254030, 10, 640x360 
0x1382CA98, 37353952128556088, 90254058, 90254064, 6, 640x360 
0x1382CA98, 37353952129006304, 90254110, 90254117, 7, 640x360 
0x1382CA98, 37353952129328000, 90254149, 90254154, 5, 640x360 
0x1382CA98, 37353952129658712, 90254175, 90254185, 10, 640x360 
0x1382CA98, 37353952129968560, 90254198, 90254210, 12, 640x360 
0x1382CA98, 37353952130291776, 90254228, 90254241, 13, 640x360 
0x1382CA98, 37353952130614768, 90254260, 90254263, 3, 640x360 
0x1382CA98, 37353952130931608, 90254294, 90254297, 3, 640x360 
0x1382CA98, 37353952131251488, 90254325, 90254327, 2, 640x360 
0x1382CA98, 37353952131566440, 90254359, 90254361, 2, 640x360 
0x1382CA98, 37353952131886552, 90254399, 90254401, 2, 640x360 
0x1382CA98, 37353952132207120, 90254421, 90254423, 2, 640x360 
0x1382CA98, 37353952132532240, 90254460, 90254465, 5, 640x360 
0x1382CA98, 37353952133010112, 90254501, 90254504, 3, 640x360 
0x1382CA98, 37353952133326880, 90254534, 90254545, 11, 640x360 
0x1382CA98, 37353952133651744, 90254563, 90254570, 7, 640x360 
0x1382CA98, 37353952133969704, 90254596, 90254607, 11, 640x360 
0x1382CA98, 37353952134302064, 90254638, 90254649, 11, 640x360 
0x1382CA98, 37353952134620152, 90254661, 90254665, 4, 640x360 
0x1382CA98, 37353952134933976, 90254694, 90254696, 2, 640x360 
0x1382CA98, 37353952135254016, 90254733, 90254737, 4, 640x360 
0x1382CA98, 37353952135566784, 90254764, 90254771, 7, 640x360 
0x1382CA98, 37353952135886536, 90254798, 90254802, 4, 640x360 
0x1382CA98, 37353952136206640, 90254822, 90254828, 6, 640x360 
0x1382CA98, 37353952136527064, 90254853, 90254855, 2, 640x360 
0x1382CA98, 37353952136852280, 90254886, 90254895, 9, 640x360 
0x1382CA98, 37353952137328144, 90254944, 90254947, 3, 640x360 
0x1382CA98, 37353952137646496, 90254977, 90254981, 4, 640x360 
0x1382CA98, 37353952137971720, 90255015, 90255024, 9, 640x360 
0x1382CA98, 37353952138301576, 90255043, 90255045, 2, 640x360 
0x1382CA98, 37353952138615544, 90255062, 90255069, 7, 640x360 
0x1382CA98, 37353952138930880, 90255102, 90255105, 3, 640x360 
0x1382CA98, 37353952139264888, 90255127, 90255136, 9, 640x360 
0x1382CA98, 37353952139567456, 90255173, 90255180, 7, 640x360 
0x1382CA98, 37353952139896568, 90255202, 90255204, 2, 640x360 
0x1382CA98, 37353952140207072, 90255232, 90255241, 9, 640x360 
0x1382CA98, 37353952140541152, 90255258, 90255260, 2, 640x360 
0x1382CA98, 37353952141326264, 90255343, 90255345, 2, 640x360 
0x1382CA98, 37353952141650144, 90255374, 90255380, 6, 640x360 
0x1382CA98, 37353952141967376, 90255404, 90255411, 7, 640x360 
0x1382CA98, 37353952142301032, 90255448, 90255465, 17, 640x360 
0x1382CA98, 37353952142627256, 90255472, 90255491, 19, 640x360 
0x1382CA98, 37353952142940496, 90255498, 90255502, 4, 640x360 
0x1382CA98, 37353952143264344, 90255529, 90255542, 13, 640x360 
0x1382CA98, 37353952143575520, 90255564, 90255569, 5, 640x360 
0x1382CA98, 37353952143888040, 90255596, 90255608, 12, 640x360 
0x1382CA98, 37353952144214264, 90255635, 90255641, 6, 640x360 
0x1382CA98, 37353952144531480, 90255670, 90255678, 8, 640x360 
0x1382CA98, 37353952144886416, 90255707, 90255724, 17, 640x360 
0x1382CA98, 37353952145337960, 90255748, 90255754, 6, 640x360 
0x1382CA98, 37353952145655216, 90255771, 90255780, 9, 640x360 
0x1382CA98, 37353952145972280, 90255803, 90255807, 4, 640x360 
0x1382CA98, 37353952146310320, 90255846, 90255859, 13, 640x360 
0x1382CA98, 37353952146627472, 90255872, 90255875, 3, 640x360 
0x1382CA98, 37353952146968704, 90255906, 90255914, 8, 640x360 
0x1382CA98, 37353952147267360, 90255933, 90255951, 18, 640x360 
0x1382CA98, 37353952147576112, 90255971, 90255974, 3, 640x360 
0x1382CA98, 37353952147890312, 90256021, 90256033, 12, 640x360 
0x1382CA98, 37353952148220672, 90256044, 90256047, 3, 640x360 
0x1382CA98, 37353952148544008, 90256056, 90256060, 4, 640x360 
0x1382CA98, 37353952148850784, 90256097, 90256105, 8, 640x360 
0x1382CA98, 37353952149325928, 90256144, 90256147, 3, 640x360 
0x1382CA98, 37353952149654816, 90256175, 90256177, 2, 640x360 
0x1382CA98, 37353952149968056, 90256199, 90256208, 9, 640x360 
0x1382CA98, 37353952150290264, 90256237, 90256239, 2, 640x360 
0x1382CA98, 37353952150617184, 90256261, 90256267, 6, 640x360 
0x1382CA98, 37353952150944504, 90256304, 90256310, 6, 640x360 
0x1382CA98, 37353952151247176, 90256338, 90256348, 10, 640x360 
0x1382CA98, 37353952151565976, 90256356, 90256359, 3, 640x360 
0x1382CA98, 37353952151886112, 90256405, 90256407, 2, 640x360 
0x1382CA98, 37353952152207656, 90256421, 90256424, 3, 640x360 
0x1382CA98, 37353952152541304, 90256457, 90256463, 6, 640x360 
0x1382CA98, 37353952152850432, 90256489, 90256496, 7, 640x360 
0x1382CA98, 37353952153325552, 90256532, 90256537, 5, 640x360 
0x1382CA98, 37353952153652112, 90256571, 90256572, 1, 640x360 
0x1382CA98, 37353952153966192, 90256607, 90256622, 15, 640x360 
0x1382CA98, 37353952154289824, 90256633, 90256641, 8, 640x360 
0x1382CA98, 37353952154630432, 90256666, 90256669, 3, 640x360 
0x1382CA98, 37353952154977184, 90256704, 90256705, 1, 640x360 
0x1382CA98, 37353952155251688, 90256728, 90256750, 22, 640x360 
0x1382CA98, 37353952155569112, 90256757, 90256764, 7, 640x360 
0x1382CA98, 37353952155885864, 90256803, 90256809, 6, 640x360 
0x1382CA98, 37353952156208064, 90256832, 90256835, 3, 640x360 
0x1382CA98, 37353952156530848, 90256853, 90256857, 4, 640x360 
0x1382CA98, 37353952156849728, 90256886, 90256895, 9, 640x360 
0x1382CA98, 37353952157328024, 90256940, 90256946, 6, 640x360 
0x1382CA98, 37353952157650424, 90256972, 90256973, 1, 640x360 
0x1382CA98, 37353952157970656, 90256994, 90257001, 7, 640x360 
0x1382CA98, 37353952158288008, 90257035, 90257037, 2, 640x360 
0x1382CA98, 37353952158610992, 90257062, 90257073, 11, 640x360 
0x1382CA98, 37353952158927064, 90257103, 90257105, 2, 640x360 
0x1382CA98, 37353952159246440, 90257130, 90257133, 3, 640x360 
0x1382CA98, 37353952159570928, 90257160, 90257162, 2, 640x360 
0x1382CA98, 37353952159889856, 90257188, 90257193, 5, 640x360 
0x1382CA98, 37353952160207288, 90257221, 90257223, 2, 640x360 
0x1382CA98, 37353952160527048, 90257266, 90257269, 3, 640x360 
0x1382CA98, 37353952160851272, 90257285, 90257289, 4, 640x360 
0x1382CA98, 37353952161325760, 90257343, 90257346, 3, 640x360 
0x1382CA98, 37353952161650944, 90257378, 90257393, 15, 640x360 
0x1382CA98, 37353952161968408, 90257403, 90257405, 2, 640x360 
0x1382CA98, 37353952162291864, 90257436, 90257443, 7, 640x360 
0x1382CA98, 37353952162612520, 90257468, 90257470, 2, 640x360 
0x1382CA98, 37353952162964976, 90257512, 90257517, 5, 640x360 
0x1382CA98, 37353952163284208, 90257529, 90257535, 6, 640x360 
0x1382CA98, 37353952163569688, 90257561, 90257564, 3, 640x360 
0x1382CA98, 37353952163890064, 90257597, 90257599, 2, 640x360 
0x1382CA98, 37353952164219616, 90257637, 90257642, 5, 640x360 
0x1382CA98, 37353952164540480, 90257659, 90257662, 3, 640x360 
0x1382CA98, 37353952164857664, 90257693, 90257695, 2, 640x360 
0x1382CA98, 37353952165166488, 90257724, 90257726, 2, 640x360 
0x1382CA98, 37353952165653824, 90257764, 90257770, 6, 640x360 
0x1382CA98, 37353952165965320, 90257795, 90257800, 5, 640x360 
0x1382CA98, 37353952166288040, 90257832, 90257841, 9, 640x360 
0x1382CA98, 37353952166618408, 90257878, 90257883, 5, 640x360 
0x1382CA98, 37353952166931224, 90257903, 90257909, 6, 640x360 
0x1382CA98, 37353952167246128, 90257934, 90257936, 2, 640x360 
0x1382CA98, 37353952167566488, 90257961, 90257964, 3, 640x360 
0x1382CA98, 37353952167886424, 90257992, 90257994, 2, 640x360 
0x1382CA98, 37353952168206232, 90258020, 90258023, 3, 640x360 
0x1382CA98, 37353952168526880, 90258051, 90258059, 8, 640x360 
0x1382CA98, 37353952168846496, 90258082, 90258085, 3, 640x360 
0x1382CA98, 37353952169166512, 90258113, 90258116, 3, 640x360 
0x1382CA98, 37353952169645664, 90258164, 90258167, 3, 640x360 
0x1382CA98, 37353952169966104, 90258195, 90258197, 2, 640x360 
0x1382CA98, 37353952170286152, 90258226, 90258229, 3, 640x360 
0x1382CA98, 37353952170606440, 90258257, 90258259, 2, 640x360 
0x1382CA98, 37353952170925928, 90258288, 90258290, 2, 640x360 
0x1382CA98, 37353952171245824, 90258320, 90258323, 3, 640x360 
0x1382CA98, 37353952171566264, 90258356, 90258359, 3, 640x360 
0x1382CA98, 37353952171889840, 90258387, 90258389, 2, 640x360 
0x1382CA98, 37353952172205888, 90258418, 90258421, 3, 640x360 
0x1382CA98, 37353952172526688, 90258449, 90258452, 3, 640x360 
0x1382CA98, 37353952172846568, 90258485, 90258487, 2, 640x360 
0x1382CA98, 37353952173166344, 90258516, 90258521, 5, 640x360 
0x1382CA98, 37353952173645696, 90258564, 90258574, 10, 640x360 
0x1382CA98, 37353952173965816, 90258600, 90258604, 4, 640x360 
0x1382CA98, 37353952174292264, 90258629, 90258636, 7, 640x360 
0x1382CA98, 37353952174607816, 90258660, 90258666, 6, 640x360 
0x1382CA98, 37353952174926736, 90258691, 90258698, 7, 640x360 
0x1382CA98, 37353952175245480, 90258730, 90258738, 8, 640x360 
0x1382CA98, 37353952175565992, 90258765, 90258773, 8, 640x360 
0x1382CA98, 37353952175885376, 90258791, 90258795, 4, 640x360 
0x1382CA98, 37353952176205336, 90258827, 90258829, 2, 640x360 
0x1382CA98, 37353952176525920, 90258852, 90258856, 4, 640x360 
0x1382CA98, 37353952176872376, 90258908, 90258927, 19, 640x360 
0x1382CA98, 37353952177185360, 90258929, 90258933, 4, 640x360 
0x1382CA98, 37353952177644944, 90258968, 90258971, 3, 640x360 
0x1382CA98, 37353952177966184, 90258997, 90259005, 8, 640x360 
0x1382CA98, 37353952178285992, 90259038, 90259040, 2, 640x360 
0x1382CA98, 37353952178611384, 90259062, 90259065, 3, 640x360 
0x1382CA98, 37353952178930440, 90259098, 90259101, 3, 640x360 
0x1382CA98, 37353952179245064, 90259129, 90259133, 4, 640x360 
0x1382CA98, 37353952179566128, 90259164, 90259168, 4, 640x360 
0x1382CA98, 37353952179889152, 90259192, 90259196, 4, 640x360 
0x1382CA98, 37353952180207040, 90259222, 90259224, 2, 640x360 
0x1382CA98, 37353952180528520, 90259253, 90259260, 7, 640x360 
0x1382CA98, 37353952180852664, 90259298, 90259301, 3, 640x360 
0x1382CA98, 37353952181166848, 90259329, 90259334, 5, 640x360 
0x1382CA98, 37353952181645080, 90259361, 90259366, 5, 640x360 
0x1382CA98, 37353952181969632, 90259399, 90259402, 3, 640x360 
0x1382CA98, 37353952182287352, 90259429, 90259433, 4, 640x360 
0x1382CA98, 37353952182613960, 90259460, 90259462, 2, 640x360 
0x1382CA98, 37353952182942480, 90259492, 90259494, 2, 640x360 
0x1382CA98, 37353952183245704, 90259531, 90259534, 3, 640x360 
0x1382CA98, 37353952183565904, 90259554, 90259558, 4, 640x360 
0x1382CA98, 37353952183888704, 90259592, 90259594, 2, 640x360 
0x1382CA98, 37353952184208624, 90259620, 90259623, 3, 640x360 
0x1382CA98, 37353952184531040, 90259652, 90259655, 3, 640x360 
0x1382CA98, 37353952184852608, 90259689, 90259694, 5, 640x360 
0x1382CA98, 37353952185165608, 90259720, 90259722, 2, 640x360 
0x1382CA98, 37353952185645056, 90259772, 90259784, 12, 640x360 
0x1382CA98, 37353952185965096, 90259800, 90259807, 7, 640x360 
0x1382CA98, 37353952186302144, 90259832, 90259834, 2, 640x360 
0x1382CA98, 37353952186605592, 90259860, 90259861, 1, 640x360 
0x1382CA98, 37353952186928496, 90259892, 90259895, 3, 640x360 
0x1382CA98, 37353952187245104, 90259924, 90259926, 2, 640x360 
0x1382CA98, 37353952187566256, 90259957, 90259960, 3, 640x360 
0x1382CA98, 37353952187886384, 90259986, 90259988, 2, 640x360 
0x1382CA98, 37353952188205376, 90260021, 90260024, 3, 640x360 
0x1382CA98, 37353952188529752, 90260062, 90260067, 5, 640x360 
0x1382CA98, 37353952188851720, 90260084, 90260087, 3, 640x360 
0x1382CA98, 37353952189169680, 90260116, 90260119, 3, 640x360 
0x1382CA98, 37353952189486328, 90260147, 90260151, 4, 640x360 
0x1382CA98, 37353952189965744, 90260195, 90260201, 6, 640x360 
0x1382CA98, 37353952190285952, 90260227, 90260234, 7, 640x360 
0x1382CA98, 37353952190612168, 90260259, 90260262, 3, 640x360 
0x1382CA98, 37353952190932992, 90260291, 90260293, 2, 640x360 
0x1382CA98, 37353952191252216, 90260322, 90260324, 2, 640x360 
0x1382CA98, 37353952191571312, 90260354, 90260356, 2, 640x360 
0x1382CA98, 37353952191886048, 90260393, 90260402, 9, 640x360 
0x1382CA98, 37353952192206048, 90260419, 90260425, 6, 640x360 
0x1382CA98, 37353952192525800, 90260459, 90260465, 6, 640x360 
0x1382CA98, 37353952192846128, 90260493, 90260496, 3, 640x360 
0x1382CA98, 37353952193166576, 90260514, 90260517, 3, 640x360 
0x1382CA98, 37353952193486032, 90260546, 90260552, 6, 640x360 
0x1382CA98, 37353952193965024, 90260599, 90260601, 2, 640x360 
0x1382CA98, 37353952194285352, 90260634, 90260637, 3, 640x360 
0x1382CA98, 37353952194605664, 90260659, 90260661, 2, 640x360 
0x1382CA98, 37353952194928072, 90260698, 90260702, 4, 640x360 
0x1382CA98, 37353952195249048, 90260723, 90260727, 4, 640x360 
0x1382CA98, 37353952195571208, 90260759, 90260761, 2, 640x360 
0x1382CA98, 37353952195889272, 90260786, 90260790, 4, 640x360 
0x1382CA98, 37353952196208904, 90260821, 90260825, 4, 640x360 
0x1382CA98, 37353952196531752, 90260854, 90260857, 3, 640x360 
0x1382CA98, 37353952196845768, 90260885, 90260887, 2, 640x360 
0x1382CA98, 37353952197166096, 90260926, 90260929, 3, 640x360 
0x1382CA98, 37353952197488680, 90260948, 90260956, 8, 640x360 
0x1382CA98, 37353952197969752, 90260993, 90261002, 9, 640x360 
0x1382CA98, 37353952198285888, 90261027, 90261032, 5, 640x360 
0x1382CA98, 37353952198606048, 90261060, 90261062, 2, 640x360 
0x1382CA98, 37353952198952648, 90261091, 90261093, 2, 640x360 
0x1382CA98, 37353952199245576, 90261124, 90261127, 3, 640x360 
0x1382CA98, 37353952199568824, 90261155, 90261158, 3, 640x360 
0x1382CA98, 37353952199888672, 90261186, 90261194, 8, 640x360 
0x1382CA98, 37353952200205000, 90261219, 90261221, 2, 640x360 
0x1382CA98, 37353952200528880, 90261254, 90261257, 3, 640x360 
0x1382CA98, 37353952200846544, 90261287, 90261290, 3, 640x360 
0x1382CA98, 37353952201165856, 90261313, 90261317, 4, 640x360 
0x1382CA98, 37353952201486168, 90261344, 90261347, 3, 640x360 
0x1382CA98, 37353952201964824, 90261395, 90261402, 7, 640x360 
0x1382CA98, 37353952202300528, 90261434, 90261438, 4, 640x360 
0x1382CA98, 37353952202610776, 90261464, 90261471, 7, 640x360 
0x1382CA98, 37353952202929552, 90261498, 90261501, 3, 640x360 
0x1382CA98, 37353952203245200, 90261524, 90261527, 3, 640x360 
0x1382CA98, 37353952203567552, 90261561, 90261563, 2, 640x360 
0x1382CA98, 37353952203889296, 90261592, 90261594, 2, 640x360 
0x1382CA98, 37353952204210352, 90261624, 90261627, 3, 640x360 
0x1382CA98, 37353952204529128, 90261656, 90261660, 4, 640x360 
0x1382CA98, 37353952204844968, 90261686, 90261691, 5, 640x360 
0x1382CA98, 37353952205164800, 90261718, 90261720, 2, 640x360 
0x1382CA98, 37353952205485648, 90261753, 90261756, 3, 640x360 
0x1382CA98, 37353952205965168, 90261795, 90261799, 4, 640x360 
0x1382CA98, 37353952206286872, 90261824, 90261826, 2, 640x360 
0x1382CA98, 37353952206620392, 90261858, 90261861, 3, 640x360 
0x1382CA98, 37353952206925080, 90261892, 90261894, 2, 640x360 
0x1382CA98, 37353952207245384, 90261926, 90261929, 3, 640x360 
0x1382CA98, 37353952207565448, 90261957, 90261959, 2, 640x360 
0x1382CA98, 37353952207885456, 90261998, 90262006, 8, 640x360 
0x1382CA98, 37353952208207704, 90262034, 90262037, 3, 640x360 
0x1382CA98, 37353952208529424, 90262056, 90262060, 4, 640x360 
0x1382CA98, 37353952208844552, 90262082, 90262084, 2, 640x360 
0x1382CA98, 37353952209164768, 90262120, 90262126, 6, 640x360 
0x1382CA98, 37353952209487552, 90262154, 90262162, 8, 640x360 
0x1382CA98, 37353952209964400, 90262196, 90262201, 5, 640x360 
0x1382CA98, 37353952210284280, 90262231, 90262241, 10, 640x360 
0x1382CA98, 37353952210622232, 90262267, 90262271, 4, 640x360 
0x1382CA98, 37353952210933016, 90262304, 90262310, 6, 640x360 
0x1382CA98, 37353952211246336, 90262335, 90262341, 6, 640x360 
0x1382CA98, 37353952211564440, 90262368, 90262376, 8, 640x360 
0x1382CA98, 37353952211886080, 90262386, 90262392, 6, 640x360 
0x1382CA98, 37353952212208648, 90262432, 90262434, 2, 640x360 
0x1382CA98, 37353952212525968, 90262455, 90262462, 7, 640x360 
0x1382CA98, 37353952212844752, 90262487, 90262489, 2, 640x360 
0x1382CA98, 37353952213166752, 90262520, 90262522, 2, 640x360 
0x1382CA98, 37353952213486032, 90262554, 90262559, 5, 640x360 
0x1382CA98, 37353952213969664, 90262609, 90262612, 3, 640x360 
0x1382CA98, 37353952214288384, 90262638, 90262644, 6, 640x360 
0x1382CA98, 37353952214608544, 90262668, 90262670, 2, 640x360 
0x1382CA98, 37353952214924824, 90262693, 90262698, 5, 640x360 
0x1382CA98, 37353952215244048, 90262735, 90262741, 6, 640x360 
0x1382CA98, 37353952215564336, 90262758, 90262765, 7, 640x360 
0x1382CA98, 37353952215888136, 90262802, 90262805, 3, 640x360 
0x1382CA98, 37353952216211512, 90262826, 90262835, 9, 640x360 
0x1382CA98, 37353952216553424, 90262866, 90262870, 4, 640x360 
0x1382CA98, 37353952216856320, 90262891, 90262894, 3, 640x360 
0x1382CA98, 37353952217165440, 90262927, 90262929, 2, 640x360 
0x1382CA98, 37353952217485128, 90262958, 90262964, 6, 640x360 
0x1382CA98, 37353952217811320, 90262978, 90262984, 6, 640x360 
0x1382CA98, 37353952218285768, 90263034, 90263041, 7, 640x360 
0x1382CA98, 37353952218609688, 90263065, 90263077, 12, 640x360 
0x1382CA98, 37353952218929264, 90263094, 90263107, 13, 640x360 
0x1382CA98, 37353952219243840, 90263132, 90263135, 3, 640x360 
0x1382CA98, 37353952219564992, 90263158, 90263167, 9, 640x360 
0x1382CA98, 37353952219887920, 90263191, 90263193, 2, 640x360 
0x1382CA98, 37353952220204528, 90263228, 90263239, 11, 640x360 
0x1382CA98, 37353952220525264, 90263260, 90263267, 7, 640x360 
0x1382CA98, 37353952220853920, 90263291, 90263297, 6, 640x360 
0x1382CA98, 37353952221164312, 90263319, 90263321, 2, 640x360 
0x1382CA98, 37353952221489608, 90263349, 90263359, 10, 640x360 
0x1382CA98, 37353952221804688, 90263383, 90263389, 6, 640x360 
0x1382CA98, 37353952222284176, 90263429, 90263434, 5, 640x360 
0x1382CA98, 37353952222608440, 90263461, 90263464, 3, 640x360 
0x1382CA98, 37353952222924536, 90263494, 90263499, 5, 640x360 
0x1382CA98, 37353952223244520, 90263527, 90263531, 4, 640x360 
0x1382CA98, 37353952223564760, 90263564, 90263575, 11, 640x360 
0x1382CA98, 37353952223885864, 90263589, 90263595, 6, 640x360 
0x1382CA98, 37353952224212872, 90263621, 90263630, 9, 640x360 
0x1382CA98, 37353952224530888, 90263653, 90263655, 2, 640x360 
0x1382CA98, 37353952224861608, 90263689, 90263691, 2, 640x360 
0x1382CA98, 37353952225165288, 90263720, 90263722, 2, 640x360 
0x1382CA98, 37353952225487184, 90263748, 90263756, 8, 640x360 
0x1382CA98, 37353952225805520, 90263801, 90263807, 6, 640x360 
0x1382CA98, 37353952226285160, 90263850, 90263852, 2, 640x360 
0x1382CA98, 37353952226607776, 90263867, 90263875, 8, 640x360 
0x1382CA98, 37353952226931792, 90263903, 90263913, 10, 640x360 
0x1382CA98, 37353952227247136, 90263939, 90263942, 3, 640x360 
0x1382CA98, 37353952227565656, 90263983, 90263996, 13, 640x360 
0x1382CA98, 37353952227898200, 90263997, 90264004, 7, 640x360 
0x1382CA98, 37353952228212144, 90264034, 90264049, 15, 640x360 
0x1382CA98, 37353952228529568, 90264065, 90264067, 2, 640x360 
0x1382CA98, 37353952228847768, 90264096, 90264101, 5, 640x360 
0x1382CA98, 37353952229172640, 90264122, 90264124, 2, 640x360 
0x1382CA98, 37353952229490528, 90264152, 90264156, 4, 640x360 
0x1382CA98, 37353952229854984, 90264197, 90264208, 11, 640x360 
0x1382CA98, 37353952230287440, 90264235, 90264243, 8, 640x360 
0x1382CA98, 37353952230608720, 90264269, 90264272, 3, 640x360 
0x1382CA98, 37353952230930192, 90264297, 90264301, 4, 640x360 
0x1382CA98, 37353952231243720, 90264335, 90264337, 2, 640x360 
0x1382CA98, 37353952231573568, 90264370, 90264372, 2, 640x360 
0x1382CA98, 37353952231887520, 90264400, 90264403, 3, 640x360 
0x1382CA98, 37353952232207592, 90264420, 90264431, 11, 640x360 
0x1382CA98, 37353952232523880, 90264453, 90264462, 9, 640x360 
0x1382CA98, 37353952232844744, 90264487, 90264489, 2, 640x360 
0x1382CA98, 37353952233168792, 90264527, 90264530, 3, 640x360 
0x1382CA98, 37353952233484640, 90264544, 90264556, 12, 640x360 
0x1382CA98, 37353952233808040, 90264586, 90264593, 7, 640x360 
0x1382CA98, 37353952234286536, 90264630, 90264635, 5, 640x360 
0x1382CA98, 37353952234612160, 90264658, 90264661, 3, 640x360 
0x1382CA98, 37353952234926800, 90264699, 90264702, 3, 640x360 
0x1382CA98, 37353952235254776, 90264722, 90264724, 2, 640x360 
0x1382CA98, 37353952235564048, 90264759, 90264761, 2, 640x360 
0x1382CA98, 37353952235884736, 90264788, 90264790, 2, 640x360 
0x1382CA98, 37353952236204416, 90264830, 90264841, 11, 640x360 
0x1382CA98, 37353952236536520, 90264853, 90264856, 3, 640x360 
0x1382CA98, 37353952236846568, 90264889, 90264891, 2, 640x360 
0x1382CA98, 37353952237170528, 90264923, 90264925, 2, 640x360 
0x1382CA98, 37353952237489088, 90264964, 90264970, 6, 640x360 
0x1382CA98, 37353952237807768, 90264987, 90264989, 2, 640x360 
0x1382CA98, 37353952238290096, 90265034, 90265045, 11, 640x360 
0x1382CA98, 37353952238627064, 90265069, 90265077, 8, 640x360 
0x1382CA98, 37353952238934928, 90265111, 90265116, 5, 640x360 
0x1382CA98, 37353952239243880, 90265136, 90265138, 2, 640x360 
0x1382CA98, 37353952239567632, 90265160, 90265163, 3, 640x360 
0x1382CA98, 37353952239887704, 90265191, 90265193, 2, 640x360 
0x1382CA98, 37353952240211016, 90265232, 90265241, 9, 640x360 
0x1382CA98, 37353952240540296, 90265266, 90265269, 3, 640x360 
0x1382CA98, 37353952240847584, 90265286, 90265290, 4, 640x360 
0x1382CA98, 37353952241163888, 90265313, 90265320, 7, 640x360 
0x1382CA98, 37353952241487144, 90265360, 90265362, 2, 640x360 
0x1382CA98, 37353952241804288, 90265396, 90265404, 8, 640x360 
0x1382CA98, 37353952242288296, 90265442, 90265448, 6, 640x360 
0x1382CA98, 37353952242618176, 90265477, 90265492, 15, 640x360 
0x1382CA98, 37353952242972760, 90265522, 90265530, 8, 640x360 
0x1382CA98, 37353952243309376, 90265559, 90265568, 9, 640x360 
0x1382CA98, 37353952243576256, 90265600, 90265604, 4, 640x360 
0x1382CA98, 37353952243902624, 90265607, 90265621, 14, 640x360 
0x1382CA98, 37353952244217976, 90265659, 90265677, 18, 640x360 
0x1382CA98, 37353952244561360, 90265678, 90265699, 21, 640x360 
0x1382CA98, 37353952244871824, 90265709, 90265733, 24, 640x360 
0x1382CA98, 37353952245186680, 90265752, 90265767, 15, 640x360 
0x1382CA98, 37353952245496392, 90265775, 90265783, 8, 640x360 
0x1382CA98, 37353952245812296, 90265806, 90265820, 14, 640x360 
0x1382CA98, 37353952246133728, 90265844, 90265851, 7, 640x360 
0x1382CA98, 37353952246643272, 90265882, 90265900, 18, 640x360 
0x1382CA98, 37353952246947504, 90265900, 90265918, 18, 640x360 
0x1382CA98, 37353952247258584, 90265942, 90265948, 6, 640x360 
0x1382CA98, 37353952247565576, 90265972, 90266004, 32, 640x360 
0x1382CA98, 37353952247910616, 90266009, 90266024, 15, 640x360 
0x1382CA98, 37353952248211896, 90266054, 90266064, 10, 640x360 
0x1382CA98, 37353952248537760, 90266078, 90266108, 30, 640x360 
0x1382CA98, 37353952248895296, 90266108, 90266135, 27, 640x360 
0x1382CA98, 37353952249190464, 90266136, 90266145, 9, 640x360 
0x1382CA98, 37353952249515520, 90266163, 90266172, 9, 640x360 
0x1382CA98, 37353952249829024, 90266206, 90266235, 29, 640x360 
0x1382CA98, 37353952250188216, 90266236, 90266249, 13, 640x360 
0x1382CA98, 37353952250629032, 90266278, 90266299, 21, 640x360 
0x1382CA98, 37353952250971824, 90266309, 90266326, 17, 640x360 
0x1382CA98, 37353952251259440, 90266353, 90266369, 16, 640x360 
0x1382CA98, 37353952251570392, 90266374, 90266378, 4, 640x360 
0x1382CA98, 37353952251885888, 90266395, 90266402, 7, 640x360 
0x1382CA98, 37353952252219448, 90266455, 90266468, 13, 640x360 
0x1382CA98, 37353952252541296, 90266468, 90266474, 6, 640x360 
0x1382CA98, 37353952252850816, 90266487, 90266493, 6, 640x360 
0x1382CA98, 37353952253166712, 90266525, 90266537, 12, 640x360 
0x1382CA98, 37353952253488224, 90266557, 90266558, 1, 640x360 
0x1382CA98, 37353952253804192, 90266602, 90266612, 10, 640x360 
0x1382CA98, 37353952254133808, 90266624, 90266627, 3, 640x360 
0x1382CA98, 37353952254612984, 90266688, 90266691, 3, 640x360 
0x1382CA98, 37353952254948616, 90266709, 90266711, 2, 640x360 
0x1382CA98, 37353952255243800, 90266733, 90266750, 17, 640x360 
0x1382CA98, 37353952255607456, 90266765, 90266777, 12, 640x360 
0x1382CA98, 37353952255888704, 90266803, 90266817, 14, 640x360 
0x1382CA98, 37353952256235904, 90266830, 90266838, 8, 640x360 
0x1382CA98, 37353952256526656, 90266860, 90266862, 2, 640x360 
0x1382CA98, 37353952256847880, 90266896, 90266902, 6, 640x360 
0x1382CA98, 37353952257163256, 90266922, 90266924, 2, 640x360 
0x1382CA98, 37353952257484664, 90266954, 90266956, 2, 640x360 
0x1382CA98, 37353952257808208, 90266986, 90266988, 2, 640x360 
0x1382CA98, 37353952258129112, 90267013, 90267017, 4, 640x360 
0x1382CA98, 37353952258609384, 90267059, 90267062, 3, 640x360 
0x1382CA98, 37353952258942112, 90267104, 90267106, 2, 640x360 
0x1382CA98, 37353952259244328, 90267128, 90267132, 4, 640x360 
0x1382CA98, 37353952259565536, 90267155, 90267157, 2, 640x360 
0x1382CA98, 37353952259886840, 90267187, 90267193, 6, 640x360 
0x1382CA98, 37353952260204016, 90267225, 90267227, 2, 640x360 
0x1382CA98, 37353952260527648, 90267255, 90267258, 3, 640x360 
0x1382CA98, 37353952260843816, 90267287, 90267290, 3, 640x360 
0x1382CA98, 37353952261164392, 90267320, 90267323, 3, 640x360 
0x1382CA98, 37353952261487528, 90267345, 90267352, 7, 640x360 
0x1382CA98, 37353952261804184, 90267382, 90267386, 4, 640x360 
0x1382CA98, 37353952262134016, 90267416, 90267423, 7, 640x360 
0x1382CA98, 37353952262628216, 90267465, 90267477, 12, 640x360 
0x1382CA98, 37353952262938712, 90267496, 90267503, 7, 640x360 
0x1382CA98, 37353952263243224, 90267533, 90267539, 6, 640x360 
0x1382CA98, 37353952263566712, 90267566, 90267569, 3, 640x360 
0x1382CA98, 37353952263887888, 90267591, 90267600, 9, 640x360 
0x1382CA98, 37353952264203528, 90267620, 90267631, 11, 640x360 
0x1382CA98, 37353952264524416, 90267652, 90267656, 4, 640x360 
0x1382CA98, 37353952264846880, 90267694, 90267696, 2, 640x360 
0x1382CA98, 37353952265164992, 90267721, 90267733, 12, 640x360 
0x1382CA98, 37353952265484408, 90267754, 90267756, 2, 640x360 
0x1382CA98, 37353952265803936, 90267778, 90267794, 16, 640x360 
0x1382CA98, 37353952266127488, 90267817, 90267824, 7, 640x360 
0x1382CA98, 37353952266611608, 90267865, 90267869, 4, 640x360 
0x1382CA98, 37353952266934792, 90267893, 90267895, 2, 640x360 
0x1382CA98, 37353952267249488, 90267928, 90267930, 2, 640x360 
0x1382CA98, 37353952267563264, 90267959, 90267962, 3, 640x360 
0x1382CA98, 37353952267886880, 90268002, 90268005, 3, 640x360 
0x1382CA98, 37353952268203736, 90268028, 90268034, 6, 640x360 
0x1382CA98, 37353952268526480, 90268054, 90268061, 7, 640x360 
0x1382CA98, 37353952268844288, 90268085, 90268088, 3, 640x360 
0x1382CA98, 37353952269174048, 90268128, 90268134, 6, 640x360 
0x1382CA98, 37353952269484008, 90268157, 90268159, 2, 640x360 
0x1382CA98, 37353952269812536, 90268178, 90268181, 3, 640x360 
0x1382CA98, 37353952270132160, 90268216, 90268224, 8, 640x360 
0x1382CA98, 37353952270610336, 90268270, 90268272, 2, 640x360 
0x1382CA98, 37353952270923080, 90268295, 90268297, 2, 640x360 
0x1382CA98, 37353952271243280, 90268327, 90268330, 3, 640x360 
0x1382CA98, 37353952271564000, 90268366, 90268369, 3, 640x360 
0x1382CA98, 37353952271883264, 90268391, 90268393, 2, 640x360 
0x1382CA98, 37353952272203000, 90268428, 90268434, 6, 640x360 
0x1382CA98, 37353952272538184, 90268456, 90268459, 3, 640x360 
0x1382CA98, 37353952272842976, 90268496, 90268508, 12, 640x360 
0x1382CA98, 37353952273175376, 90268527, 90268530, 3, 640x360 
0x1382CA98, 37353952273483376, 90268560, 90268561, 1, 640x360 
0x1382CA98, 37353952273803704, 90268589, 90268590, 1, 640x360 
0x1382CA98, 37353952274123360, 90268623, 90268629, 6, 640x360 
0x1382CA98, 37353952274448680, 90268656, 90268658, 2, 640x360 
0x1382CA98, 37353952274934184, 90268701, 90268708, 7, 640x360 
0x1382CA98, 37353952275242848, 90268735, 90268750, 15, 640x360 
0x1382CA98, 37353952275565400, 90268769, 90268772, 3, 640x360 
0x1382CA98, 37353952275886568, 90268795, 90268800, 5, 640x360 
0x1382CA98, 37353952276206584, 90268828, 90268833, 5, 640x360 
0x1382CA98, 37353952276536672, 90268857, 90268858, 1, 640x360 
0x1382CA98, 37353952276842936, 90268898, 90268902, 4, 640x360 
0x1382CA98, 37353952277167768, 90268918, 90268921, 3, 640x360 
0x1382CA98, 37353952277483200, 90268951, 90268953, 2, 640x360 
0x1382CA98, 37353952277808824, 90268982, 90268986, 4, 640x360 
0x1382CA98, 37353952278127424, 90269012, 90269020, 8, 640x360 
0x1382CA98, 37353952278451976, 90269045, 90269059, 14, 640x360 
0x1382CA98, 37353952278931640, 90269093, 90269096, 3, 640x360 
0x1382CA98, 37353952279242312, 90269142, 90269144, 2, 640x360 
0x1382CA98, 37353952279562424, 90269165, 90269175, 10, 640x360 
0x1382CA98, 37353952279882720, 90269194, 90269196, 2, 640x360 
0x1382CA98, 37353952280206392, 90269223, 90269228, 5, 640x360 
0x1382CA98, 37353952280542520, 90269257, 90269259, 2, 640x360 
0x1382CA98, 37353952280844592, 90269298, 90269307, 9, 640x360 
0x1382CA98, 37353952281164720, 90269329, 90269334, 5, 640x360 
0x1382CA98, 37353952281487552, 90269355, 90269367, 12, 640x360 
0x1382CA98, 37353952281838168, 90269392, 90269405, 13, 640x360 
0x1382CA98, 37353952282143144, 90269422, 90269425, 3, 640x360 
0x1382CA98, 37353952282451360, 90269455, 90269457, 2, 640x360 
0x1382CA98, 37353952282925416, 90269512, 90269519, 7, 640x360 
0x1382CA98, 37353952283247400, 90269537, 90269549, 12, 640x360 
0x1382CA98, 37353952283587896, 90269577, 90269594, 17, 640x360 
0x1382CA98, 37353952283892304, 90269617, 90269636, 19, 640x360 
0x1382CA98, 37353952284220728, 90269640, 90269649, 9, 640x360 
0x1382CA98, 37353952284531448, 90269663, 90269683, 20, 640x360 
0x1382CA98, 37353952284845584, 90269703, 90269707, 4, 640x360 
0x1382CA98, 37353952285166344, 90269726, 90269728, 2, 640x360 
0x1382CA98, 37353952285482496, 90269750, 90269761, 11, 640x360 
0x1382CA98, 37353952285806312, 90269780, 90269783, 3, 640x360 
0x1382CA98, 37353952286122848, 90269811, 90269814, 3, 640x360 
0x1382CA98, 37353952286450552, 90269845, 90269849, 4, 640x360 
0x1382CA98, 37353952286927840, 90269900, 90269902, 2, 640x360 
0x1382CA98, 37353952287248640, 90269929, 90269931, 2, 640x360 
0x1382CA98, 37353952287568240, 90269959, 90269962, 3, 640x360 
0x1382CA98, 37353952287882888, 90269990, 90269992, 2, 640x360 
0x1382CA98, 37353952288209704, 90270026, 90270028, 2, 640x360 
0x1382CA98, 37353952288522656, 90270054, 90270063, 9, 640x360 
0x1382CA98, 37353952288843632, 90270088, 90270090, 2, 640x360 
0x1382CA98, 37353952289168024, 90270123, 90270129, 6, 640x360 
0x1382CA98, 37353952289487872, 90270149, 90270152, 3, 640x360 
0x1382CA98, 37353952289802880, 90270182, 90270185, 3, 640x360 
0x1382CA98, 37353952290124656, 90270213, 90270216, 3, 640x360 
0x1382CA98, 37353952290460272, 90270250, 90270252, 2, 640x360 
0x1382CA98, 37353952290924752, 90270295, 90270297, 2, 640x360 
0x1382CA98, 37353952291255088, 90270334, 90270336, 2, 640x360 
0x1382CA98, 37353952291567448, 90270359, 90270361, 2, 640x360 
0x1382CA98, 37353952291882528, 90270388, 90270390, 2, 640x360 
0x1382CA98, 37353952292204496, 90270423, 90270425, 2, 640x360 
0x1382CA98, 37353952292524376, 90270454, 90270456, 2, 640x360 
0x1382CA98, 37353952292863168, 90270487, 90270490, 3, 640x360 
0x1382CA98, 37353952293179464, 90270524, 90270526, 2, 640x360 
0x1382CA98, 37353952293532896, 90270554, 90270558, 4, 640x360 
0x1382CA98, 37353952293813384, 90270595, 90270597, 2, 640x360 
0x1382CA98, 37353952294129376, 90270612, 90270625, 13, 640x360 
0x1382CA98, 37353952294451736, 90270645, 90270651, 6, 640x360 
0x1382CA98, 37353952294933824, 90270699, 90270701, 2, 640x360 
0x1382CA98, 37353952295251032, 90270725, 90270728, 3, 640x360 
0x1382CA98, 37353952295562808, 90270761, 90270764, 3, 640x360 
0x1382CA98, 37353952295883152, 90270786, 90270792, 6, 640x360 
0x1382CA98, 37353952296206776, 90270820, 90270824, 4, 640x360 
0x1382CA98, 37353952296533312, 90270856, 90270858, 2, 640x360 
0x1382CA98, 37353952296842688, 90270887, 90270890, 3, 640x360 
0x1382CA98, 37353952297163016, 90270920, 90270929, 9, 640x360 
0x1382CA98, 37353952297483544, 90270955, 90270961, 6, 640x360 
0x1382CA98, 37353952297803768, 90270996, 90271003, 7, 640x360 
0x1382CA98, 37353952298144376, 90271041, 90271051, 10, 640x360 
0x1382CA98, 37353952298478592, 90271061, 90271070, 9, 640x360 
0x1382CA98, 37353952298779800, 90271101, 90271104, 3, 640x360 
0x1382CA98, 37353952299254312, 90271135, 90271137, 2, 640x360 
0x1382CA98, 37353952299561664, 90271168, 90271178, 10, 640x360 
0x1382CA98, 37353952299885608, 90271195, 90271198, 3, 640x360 
0x1382CA98, 37353952300202368, 90271226, 90271228, 2, 640x360 
0x1382CA98, 37353952300524576, 90271261, 90271265, 4, 640x360 
0x1382CA98, 37353952300845768, 90271291, 90271297, 6, 640x360 
0x1382CA98, 37353952301162032, 90271326, 90271330, 4, 640x360 
0x1382CA98, 37353952301482256, 90271361, 90271363, 2, 640x360 
0x1382CA98, 37353952301805848, 90271384, 90271392, 8, 640x360 
0x1382CA98, 37353952302132080, 90271417, 90271423, 6, 640x360 
0x1382CA98, 37353952302449032, 90271456, 90271458, 2, 640x360 
0x1382CA98, 37353952302772136, 90271480, 90271485, 5, 640x360 
0x1382CA98, 37353952303241536, 90271531, 90271540, 9, 640x360 
0x1382CA98, 37353952303561672, 90271560, 90271562, 2, 640x360 
0x1382CA98, 37353952303885776, 90271592, 90271595, 3, 640x360 
0x1382CA98, 37353952304206624, 90271623, 90271625, 2, 640x360 
0x1382CA98, 37353952304528464, 90271652, 90271659, 7, 640x360 
0x1382CA98, 37353952304846472, 90271691, 90271693, 2, 640x360 
0x1382CA98, 37353952305166400, 90271719, 90271727, 8, 640x360 
0x1382CA98, 37353952305489344, 90271747, 90271753, 6, 640x360 
0x1382CA98, 37353952305804976, 90271778, 90271791, 13, 640x360 
0x1382CA98, 37353952306129728, 90271820, 90271827, 7, 640x360 
0x1382CA98, 37353952306479040, 90271850, 90271852, 2, 640x360 
0x1382CA98, 37353952306767304, 90271876, 90271884, 8, 640x360 
0x1382CA98, 37353952307282640, 90271939, 90271949, 10, 640x360 
0x1382CA98, 37353952307576032, 90271973, 90271976, 3, 640x360 
0x1382CA98, 37353952307882744, 90272003, 90272018, 15, 640x360 
0x1382CA98, 37353952308211704, 90272041, 90272043, 2, 640x360 
0x1382CA98, 37353952308522408, 90272055, 90272064, 9, 640x360 
0x1382CA98, 37353952308851720, 90272101, 90272109, 8, 640x360 
0x1382CA98, 37353952309167744, 90272124, 90272132, 8, 640x360 
0x1382CA98, 37353952309487680, 90272164, 90272179, 15, 640x360 
0x1382CA98, 37353952309814904, 90272190, 90272192, 2, 640x360 
0x1382CA98, 37353952310128976, 90272218, 90272222, 4, 640x360 
0x1382CA98, 37353952310452376, 90272255, 90272258, 3, 640x360 
0x1382CA98, 37353952310763760, 90272295, 90272297, 2, 640x360 
0x1382CA98, 37353952311241560, 90272338, 90272349, 11, 640x360 
0x1382CA98, 37353952311571648, 90272363, 90272372, 9, 640x360 
0x1382CA98, 37353952311899008, 90272404, 90272406, 2, 640x360 
0x1382CA98, 37353952312203808, 90272428, 90272433, 5, 640x360 
0x1382CA98, 37353952312530856, 90272460, 90272462, 2, 640x360 
0x1382CA98, 37353952312845800, 90272492, 90272494, 2, 640x360 
0x1382CA98, 37353952313184784, 90272525, 90272527, 2, 640x360 
0x1382CA98, 37353952313498936, 90272559, 90272561, 2, 640x360 
0x1382CA98, 37353952313805464, 90272596, 90272601, 5, 640x360 
0x1382CA98, 37353952314126280, 90272622, 90272624, 2, 640x360 
0x1382CA98, 37353952314453360, 90272653, 90272655, 2, 640x360 
0x1382CA98, 37353952314766928, 90272686, 90272690, 4, 640x360 
0x1382CA98, 37353952315244176, 90272740, 90272751, 11, 640x360 
0x1382CA98, 37353952315575256, 90272771, 90272773, 2, 640x360 
0x1382CA98, 37353952315885376, 90272800, 90272810, 10, 640x360 
0x1382CA98, 37353952316211072, 90272828, 90272832, 4, 640x360 
0x1382CA98, 37353952316524496, 90272860, 90272862, 2, 640x360 
0x1382CA98, 37353952316854504, 90272894, 90272897, 3, 640x360 
0x1382CA98, 37353952317181696, 90272930, 90272934, 4, 640x360 
0x1382CA98, 37353952317486408, 90272957, 90272959, 2, 640x360 
0x1382CA98, 37353952317803800, 90272988, 90272991, 3, 640x360 
0x1382CA98, 37353952318139024, 90273027, 90273029, 2, 640x360 
0x1382CA98, 37353952318450816, 90273055, 90273057, 2, 640x360 
0x1382CA98, 37353952318767216, 90273094, 90273102, 8, 640x360 
0x1382CA98, 37353952319242296, 90273151, 90273160, 9, 640x360 
0x1382CA98, 37353952319565336, 90273168, 90273171, 3, 640x360 
0x1382CA98, 37353952319881456, 90273194, 90273197, 3, 640x360 
0x1382CA98, 37353952320205136, 90273228, 90273233, 5, 640x360 
0x1382CA98, 37353952320531040, 90273267, 90273274, 7, 640x360 
0x1382CA98, 37353952320853240, 90273295, 90273301, 6, 640x360 
0x1382CA98, 37353952321163744, 90273324, 90273326, 2, 640x360 
0x1382CA98, 37353952321492736, 90273362, 90273365, 3, 640x360 
0x1382CA98, 37353952321808648, 90273389, 90273391, 2, 640x360 
0x1382CA98, 37353952322134928, 90273422, 90273424, 2, 640x360 
0x1382CA98, 37353952322442592, 90273450, 90273453, 3, 640x360 
0x1382CA98, 37353952322765648, 90273481, 90273485, 4, 640x360 
0x1382CA98, 37353952323244992, 90273526, 90273529, 3, 640x360 
0x1382CA98, 37353952323563440, 90273560, 90273562, 2, 640x360 
0x1382CA98, 37353952323881048, 90273595, 90273606, 11, 640x360 
0x1382CA98, 37353952324202264, 90273628, 90273631, 3, 640x360 
0x1382CA98, 37353952324539144, 90273667, 90273670, 3, 640x360 
0x1382CA98, 37353952324846960, 90273691, 90273694, 3, 640x360 
0x1382CA98, 37353952325165960, 90273730, 90273743, 13, 640x360 
0x1382CA98, 37353952325482800, 90273753, 90273761, 8, 640x360 
0x1382CA98, 37353952325803920, 90273788, 90273791, 3, 640x360 
0x1382CA98, 37353952326134680, 90273832, 90273837, 5, 640x360 
0x1382CA98, 37353952326484304, 90273858, 90273860, 2, 640x360 
0x1382CA98, 37353952326766024, 90273884, 90273891, 7, 640x360 
0x1382CA98, 37353952327082880, 90273911, 90273915, 4, 640x360 
0x1382CA98, 37353952327565240, 90273961, 90273963, 2, 640x360 
0x1382CA98, 37353952327883848, 90273994, 90273998, 4, 640x360 
0x1382CA98, 37353952328204288, 90274021, 90274028, 7, 640x360 
0x1382CA98, 37353952328530208, 90274055, 90274058, 3, 640x360 
0x1382CA98, 37353952328841368, 90274087, 90274089, 2, 640x360 
0x1382CA98, 37353952329164976, 90274129, 90274134, 5, 640x360 
0x1382CA98, 37353952329481696, 90274160, 90274162, 2, 640x360 
0x1382CA98, 37353952329808552, 90274194, 90274196, 2, 640x360 
0x1382CA98, 37353952330128840, 90274214, 90274218, 4, 640x360 
0x1382CA98, 37353952330445832, 90274244, 90274245, 1, 640x360 
0x1382CA98, 37353952330767536, 90274276, 90274280, 4, 640x360 
0x1382CA98, 37353952331082824, 90274314, 90274320, 6, 640x360 
0x1382CA98, 37353952331561528, 90274356, 90274368, 12, 640x360 
0x1382CA98, 37353952331881968, 90274388, 90274392, 4, 640x360 
0x1382CA98, 37353952332201416, 90274423, 90274425, 2, 640x360 
0x1382CA98, 37353952332525744, 90274452, 90274460, 8, 640x360 
0x1382CA98, 37353952332844000, 90274485, 90274489, 4, 640x360 
0x1382CA98, 37353952333161856, 90274514, 90274526, 12, 640x360 
0x1382CA98, 37353952333490904, 90274555, 90274563, 8, 640x360 
0x1382CA98, 37353952333811520, 90274591, 90274597, 6, 640x360 
0x1382CA98, 37353952334129912, 90274621, 90274623, 2, 640x360 
0x1382CA98, 37353952334457304, 90274652, 90274655, 3, 640x360 
0x1382CA98, 37353952334773144, 90274687, 90274691, 4, 640x360 
0x1382CA98, 37353952335108704, 90274726, 90274727, 1, 640x360 
0x1382CA98, 37353952335565200, 90274760, 90274763, 3, 640x360 
0x1382CA98, 37353952335887120, 90274792, 90274800, 8, 640x360 
0x1382CA98, 37353952336201448, 90274836, 90274838, 2, 640x360 
0x1382CA98, 37353952336528600, 90274869, 90274923, 54, 640x360 
0x1382CA98, 37353952336866568, 90274932, 90274940, 8, 640x360 
0x1382CA98, 37353952337499968, 90274963, 90274974, 11, 640x360 
0x1382CA98, 37353952337806480, 90274987, 90274994, 7, 640x360 
0x1382CA98, 37353952338133920, 90275016, 90275022, 6, 640x360 
0x1382CA98, 37353952338448224, 90275052, 90275060, 8, 640x360 
0x1382CA98, 37353952338768456, 90275076, 90275081, 5, 640x360 
0x1382CA98, 37353952339086248, 90275122, 90275125, 3, 640x360 
0x1382CA98, 37353952339565416, 90275168, 90275177, 9, 640x360 
0x1382CA98, 37353952339883976, 90275197, 90275209, 12, 640x360 
0x1382CA98, 37353952340209616, 90275232, 90275248, 16, 640x360 
0x1382CA98, 37353952340536040, 90275266, 90275274, 8, 640x360 
0x1382CA98, 37353952340854600, 90275291, 90275293, 2, 640x360 
0x1382CA98, 37353952341168624, 90275324, 90275327, 3, 640x360 
0x1382CA98, 37353952341503200, 90275355, 90275358, 3, 640x360 
0x1382CA98, 37353952341801120, 90275388, 90275391, 3, 640x360 
0x1382CA98, 37353952342121752, 90275419, 90275421, 2, 640x360 
0x1382CA98, 37353952342441280, 90275451, 90275453, 2, 640x360 
0x1382CA98, 37353952342768704, 90275475, 90275478, 3, 640x360 
0x1382CA98, 37353952343095792, 90275515, 90275518, 3, 640x360 
0x1382CA98, 37353952343560384, 90275562, 90275567, 5, 640x360 
0x1382CA98, 37353952343884560, 90275591, 90275593, 2, 640x360 
0x1382CA98, 37353952344207248, 90275620, 90275623, 3, 640x360 
0x1382CA98, 37353952344524024, 90275655, 90275657, 2, 640x360 
0x1382CA98, 37353952344841776, 90275689, 90275691, 2, 640x360 
0x1382CA98, 37353952345161760, 90275715, 90275726, 11, 640x360 
0x1382CA98, 37353952345482352, 90275750, 90275757, 7, 640x360 
0x1382CA98, 37353952345805728, 90275783, 90275790, 7, 640x360 
0x1382CA98, 37353952346130176, 90275813, 90275826, 13, 640x360 
0x1382CA98, 37353952346446904, 90275850, 90275853, 3, 640x360 
0x1382CA98, 37353952346766096, 90275878, 90275882, 4, 640x360 
0x1382CA98, 37353952347081320, 90275911, 90275914, 3, 640x360 
0x1382CA98, 37353952347561776, 90275956, 90275962, 6, 640x360 
0x1382CA98, 37353952347886368, 90275989, 90275994, 5, 640x360 
0x1382CA98, 37353952348204688, 90276028, 90276033, 5, 640x360 
0x1382CA98, 37353952348524800, 90276059, 90276066, 7, 640x360 
0x1382CA98, 37353952348840648, 90276089, 90276092, 3, 640x360 
0x1382CA98, 37353952349161576, 90276128, 90276131, 3, 640x360 
0x1382CA98, 37353952349481696, 90276163, 90276174, 11, 640x360 
0x1382CA98, 37353952349802096, 90276188, 90276200, 12, 640x360 
0x1382CA98, 37353952350133800, 90276223, 90276225, 2, 640x360 
0x1382CA98, 37353952350447336, 90276252, 90276255, 3, 640x360 
0x1382CA98, 37353952350774960, 90276302, 90276308, 6, 640x360 
0x1382CA98, 37353952351101064, 90276326, 90276327, 1, 640x360 
0x1382CA98, 37353952351562344, 90276381, 90276385, 4, 640x360 
0x1382CA98, 37353952351910728, 90276397, 90276403, 6, 640x360 
0x1382CA98, 37353952352211728, 90276428, 90276433, 5, 640x360 
0x1382CA98, 37353952352532840, 90276459, 90276462, 3, 640x360 
0x1382CA98, 37353952352860136, 90276490, 90276492, 2, 640x360 
0x1382CA98, 37353952353161128, 90276512, 90276526, 14, 640x360 
0x1382CA98, 37353952353481600, 90276559, 90276561, 2, 640x360 
0x1382CA98, 37353952353802992, 90276593, 90276595, 2, 640x360 
0x1382CA98, 37353952354129248, 90276618, 90276625, 7, 640x360 
0x1382CA98, 37353952354444872, 90276643, 90276645, 2, 640x360 
0x1382CA98, 37353952354761280, 90276678, 90276682, 4, 640x360 
0x1382CA98, 37353952355080864, 90276707, 90276710, 3, 640x360 
0x1382CA98, 37353952355401552, 90276740, 90276743, 3, 640x360 
0x1382CA98, 37353952355881416, 90276795, 90276801, 6, 640x360 
0x1382CA98, 37353952356202248, 90276825, 90276831, 6, 640x360 
0x1382CA98, 37353952356520664, 90276855, 90276858, 3, 640x360 
0x1382CA98, 37353952356844928, 90276886, 90276893, 7, 640x360 
0x1382CA98, 37353952357160936, 90276918, 90276927, 9, 640x360 
0x1382CA98, 37353952357482376, 90276952, 90276955, 3, 640x360 
0x1382CA98, 37353952357801336, 90276979, 90277000, 21, 640x360 
0x1382CA98, 37353952358136800, 90277012, 90277024, 12, 640x360 
0x1382CA98, 37353952358448552, 90277043, 90277045, 2, 640x360 
0x1382CA98, 37353952358764960, 90277077, 90277080, 3, 640x360 
0x1382CA98, 37353952359081552, 90277111, 90277116, 5, 640x360 
0x1382CA98, 37353952359402456, 90277149, 90277153, 4, 640x360 
0x1382CA98, 37353952359880240, 90277194, 90277196, 2, 640x360 
0x1382CA98, 37353952360205176, 90277220, 90277222, 2, 640x360 
0x1382CA98, 37353952360531088, 90277257, 90277265, 8, 640x360 
0x1382CA98, 37353952360840152, 90277292, 90277294, 2, 640x360 
0x1382CA98, 37353952361165392, 90277319, 90277323, 4, 640x360 
0x1382CA98, 37353952361484520, 90277357, 90277364, 7, 640x360 
0x1382CA98, 37353952361804152, 90277379, 90277392, 13, 640x360 
0x1382CA98, 37353952362130312, 90277420, 90277426, 6, 640x360 
0x1382CA98, 37353952362453160, 90277452, 90277454, 2, 640x360 
0x1382CA98, 37353952362771888, 90277481, 90277490, 9, 640x360 
0x1382CA98, 37353952363081120, 90277509, 90277511, 2, 640x360 
0x1382CA98, 37353952363400904, 90277538, 90277541, 3, 640x360 
0x1382CA98, 37353952363884416, 90277594, 90277596, 2, 640x360 
0x1382CA98, 37353952364212528, 90277621, 90277624, 3, 640x360 
0x1382CA98, 37353952364525304, 90277652, 90277660, 8, 640x360 
0x1382CA98, 37353952364840600, 90277693, 90277697, 4, 640x360 
0x1382CA98, 37353952365163808, 90277732, 90277734, 2, 640x360 
0x1382CA98, 37353952365481600, 90277754, 90277757, 3, 640x360 
0x1382CA98, 37353952365801712, 90277783, 90277792, 9, 640x360 
0x1382CA98, 37353952366123680, 90277816, 90277824, 8, 640x360 
0x1382CA98, 37353952366452944, 90277861, 90277864, 3, 640x360 
0x1382CA98, 37353952366764672, 90277883, 90277891, 8, 640x360 
0x1382CA98, 37353952367081104, 90277918, 90277926, 8, 640x360 
0x1382CA98, 37353952367401592, 90277951, 90277954, 3, 640x360 
0x1382CA98, 37353952367882624, 90277991, 90278003, 12, 640x360 
0x1382CA98, 37353952368202976, 90278024, 90278027, 3, 640x360 
0x1382CA98, 37353952368547576, 90278066, 90278076, 10, 640x360 
0x1382CA98, 37353952368878816, 90278095, 90278106, 11, 640x360 
0x1382CA98, 37353952369171872, 90278131, 90278140, 9, 640x360 
0x1382CA98, 37353952369520400, 90278160, 90278164, 4, 640x360 
0x1382CA98, 37353952369807136, 90278209, 90278214, 5, 640x360 
0x1382CA98, 37353952370145456, 90278232, 90278236, 4, 640x360 
0x1382CA98, 37353952370464608, 90278255, 90278270, 15, 640x360 
0x1382CA98, 37353952370762648, 90278287, 90278306, 19, 640x360 
0x1382CA98, 37353952371084648, 90278317, 90278329, 12, 640x360 
0x1382CA98, 37353952371407968, 90278351, 90278354, 3, 640x360 
0x1382CA98, 37353952371880008, 90278388, 90278390, 2, 640x360 
0x1382CA98, 37353952372207984, 90278425, 90278426, 1, 640x360 
0x1382CA98, 37353952372540816, 90278458, 90278463, 5, 640x360 
0x1382CA98, 37353952372840216, 90278488, 90278490, 2, 640x360 
0x1382CA98, 37353952373163752, 90278517, 90278520, 3, 640x360 
0x1382CA98, 37353952373481664, 90278555, 90278559, 4, 640x360 
0x1382CA98, 37353952373817992, 90278594, 90278596, 2, 640x360 
0x1382CA98, 37353952374122584, 90278613, 90278623, 10, 640x360 
0x1382CA98, 37353952374450216, 90278656, 90278661, 5, 640x360 
0x1382CA98, 37353952374764328, 90278684, 90278691, 7, 640x360 
0x1382CA98, 37353952375084816, 90278718, 90278721, 3, 640x360 
0x1382CA98, 37353952375410160, 90278750, 90278753, 3, 640x360 
0x1382CA98, 37353952375879848, 90278788, 90278794, 6, 640x360 
0x1382CA98, 37353952376205352, 90278820, 90278822, 2, 640x360 
0x1382CA98, 37353952376527048, 90278861, 90278864, 3, 640x360 
0x1382CA98, 37353952376841184, 90278888, 90278890, 2, 640x360 
0x1382CA98, 37353952377162656, 90278915, 90278920, 5, 640x360 
0x1382CA98, 37353952377484432, 90278947, 90278951, 4, 640x360 
0x1382CA98, 37353952377801528, 90278976, 90278980, 4, 640x360 
0x1382CA98, 37353952378135832, 90279020, 90279023, 3, 640x360 
0x1382CA98, 37353952378441368, 90279045, 90279048, 3, 640x360 
0x1382CA98, 37353952378765360, 90279077, 90279081, 4, 640x360 
0x1382CA98, 37353952379082608, 90279119, 90279122, 3, 640x360 
0x1382CA98, 37353952379407976, 90279144, 90279153, 9, 640x360 
0x1382CA98, 37353952379724920, 90279190, 90279194, 4, 640x360 
0x1382CA98, 37353952380201408, 90279230, 90279235, 5, 640x360 
0x1382CA98, 37353952380523480, 90279266, 90279269, 3, 640x360 
0x1382CA98, 37353952380842096, 90279295, 90279301, 6, 640x360 
0x1382CA98, 37353952381164128, 90279321, 90279323, 2, 640x360 
0x1382CA98, 37353952381487768, 90279348, 90279354, 6, 640x360 
0x1382CA98, 37353952381806936, 90279379, 90279384, 5, 640x360 
0x1382CA98, 37353952382127328, 90279417, 90279419, 2, 640x360 
0x1382CA98, 37353952382440848, 90279445, 90279448, 3, 640x360 
0x1382CA98, 37353952382761440, 90279479, 90279481, 2, 640x360 
0x1382CA98, 37353952383080904, 90279509, 90279513, 4, 640x360 
0x1382CA98, 37353952383404752, 90279543, 90279545, 2, 640x360 
0x1382CA98, 37353952383720384, 90279586, 90279591, 5, 640x360 
0x1382CA98, 37353952384203136, 90279633, 90279635, 2, 640x360 
0x1382CA98, 37353952384519712, 90279653, 90279661, 8, 640x360 
0x1382CA98, 37353952384840072, 90279687, 90279689, 2, 640x360 
0x1382CA98, 37353952385162824, 90279720, 90279723, 3, 640x360 
0x1382CA98, 37353952385483592, 90279763, 90279777, 14, 640x360 
0x1382CA98, 37353952385805984, 90279794, 90279796, 2, 640x360 
0x1382CA98, 37353952386126840, 90279822, 90279824, 2, 640x360 
0x1382CA98, 37353952386440088, 90279853, 90279855, 2, 640x360 
0x1382CA98, 37353952386763096, 90279882, 90279885, 3, 640x360 
0x1382CA98, 37353952387085600, 90279908, 90279910, 2, 640x360 
0x1382CA98, 37353952387401072, 90279950, 90279952, 2, 640x360 
0x1382CA98, 37353952387745632, 90279986, 90279989, 3, 640x360 
0x1382CA98, 37353952388204408, 90280020, 90280022, 2, 640x360 
0x1382CA98, 37353952388532240, 90280057, 90280059, 2, 640x360 
0x1382CA98, 37353952388841888, 90280089, 90280091, 2, 640x360 
0x1382CA98, 37353952389160344, 90280124, 90280126, 2, 640x360 
0x1382CA98, 37353952389480248, 90280155, 90280160, 5, 640x360 
0x1382CA98, 37353952389800952, 90280186, 90280193, 7, 640x360 
0x1382CA98, 37353952390126048, 90280220, 90280227, 7, 640x360 
0x1382CA98, 37353952390442824, 90280245, 90280261, 16, 640x360 
0x1382CA98, 37353952390761976, 90280277, 90280281, 4, 640x360 
0x1382CA98, 37353952391079936, 90280306, 90280308, 2, 640x360 
0x1382CA98, 37353952391399792, 90280342, 90280344, 2, 640x360 
0x1382CA98, 37353952391719768, 90280379, 90280384, 5, 640x360 
0x1382CA98, 37353952392204680, 90280426, 90280433, 7, 640x360 
0x1382CA98, 37353952392521376, 90280453, 90280461, 8, 640x360 
0x1382CA98, 37353952392839936, 90280485, 90280488, 3, 640x360 
0x1382CA98, 37353952393160280, 90280515, 90280520, 5, 640x360 
0x1382CA98, 37353952393480464, 90280545, 90280552, 7, 640x360 
0x1382CA98, 37353952393800384, 90280604, 90280606, 2, 640x360 
0x1382CA98, 37353952394165992, 90280621, 90280636, 15, 640x360 
0x1382CA98, 37353952394455904, 90280654, 90280656, 2, 640x360 
0x1382CA98, 37353952394763624, 90280675, 90280678, 3, 640x360 
0x1382CA98, 37353952395081304, 90280716, 90280719, 3, 640x360 
0x1382CA98, 37353952395406688, 90280743, 90280745, 2, 640x360 
0x1382CA98, 37353952395723960, 90280782, 90280792, 10, 640x360 
0x1382CA98, 37353952396206784, 90280828, 90280839, 11, 640x360 
0x1382CA98, 37353952396526504, 90280861, 90280864, 3, 640x360 
0x1382CA98, 37353952396839880, 90280888, 90280890, 2, 640x360 
0x1382CA98, 37353952397163416, 90280918, 90280927, 9, 640x360 
0x1382CA98, 37353952397481008, 90280956, 90280958, 2, 640x360 
0x1382CA98, 37353952397803656, 90280982, 90280986, 4, 640x360 
0x1382CA98, 37353952398142336, 90281015, 90281020, 5, 640x360 
0x1382CA98, 37353952398440440, 90281041, 90281043, 2, 640x360 
0x1382CA98, 37353952398762680, 90281085, 90281089, 4, 640x360 
0x1382CA98, 37353952399169528, 90281159, 90281177, 18, 640x360 
0x1382CA98, 37353952399490936, 90281178, 90281193, 15, 640x360 
0x1382CA98, 37353952399828944, 90281204, 90281208, 4, 640x360 
0x1382CA98, 37353952400215304, 90281243, 90281246, 3, 640x360 
0x1382CA98, 37353952400543352, 90281265, 90281279, 14, 640x360 
0x1382CA98, 37353952400857376, 90281291, 90281294, 3, 640x360 
0x1382CA98, 37353952401171080, 90281315, 90281322, 7, 640x360 
0x1382CA98, 37353952401482536, 90281349, 90281359, 10, 640x360 
0x1382CA98, 37353952401804344, 90281392, 90281394, 2, 640x360 
0x1382CA98, 37353952402135904, 90281411, 90281418, 7, 640x360 
0x1382CA98, 37353952402444696, 90281449, 90281452, 3, 640x360 
0x1382CA98, 37353952402765744, 90281489, 90281491, 2, 640x360 
0x1382CA98, 37353952403079888, 90281517, 90281520, 3, 640x360 
0x1382CA98, 37353952403403480, 90281548, 90281552, 4, 640x360 
0x1382CA98, 37353952403719424, 90281582, 90281586, 4, 640x360 
0x1382CA98, 37353952404198880, 90281626, 90281629, 3, 640x360 
0x1382CA98, 37353952404525104, 90281656, 90281663, 7, 640x360 
0x1382CA98, 37353952404843464, 90281688, 90281691, 3, 640x360 
0x1382CA98, 37353952405174192, 90281721, 90281723, 2, 640x360 
0x1382CA98, 37353952405513168, 90281757, 90281759, 2, 640x360 
0x1382CA98, 37353952405806952, 90281789, 90281791, 2, 640x360 
0x1382CA98, 37353952406127568, 90281814, 90281819, 5, 640x360 
0x1382CA98, 37353952406456344, 90281859, 90281861, 2, 640x360 
0x1382CA98, 37353952406760280, 90281878, 90281881, 3, 640x360 
0x1382CA98, 37353952407081152, 90281912, 90281917, 5, 640x360 
0x1382CA98, 37353952407399424, 90281945, 90281950, 5, 640x360 
0x1382CA98, 37353952407719968, 90281972, 90281975, 3, 640x360 
0x1382CA98, 37353952408039600, 90282005, 90282012, 7, 640x360 
0x1382CA98, 37353952408524456, 90282062, 90282067, 5, 640x360 
0x1382CA98, 37353952408843688, 90282087, 90282094, 7, 640x360 
0x1382CA98, 37353952409159200, 90282121, 90282124, 3, 640x360 
0x1382CA98, 37353952409479952, 90282146, 90282154, 8, 640x360 
0x1382CA98, 37353952409804352, 90282181, 90282192, 11, 640x360 
0x1382CA98, 37353952410127752, 90282218, 90282228, 10, 640x360 
0x1382CA98, 37353952410447280, 90282244, 90282247, 3, 640x360 
0x1382CA98, 37353952410759664, 90282280, 90282292, 12, 640x360 
0x1382CA98, 37353952411080312, 90282312, 90282323, 11, 640x360 
0x1382CA98, 37353952411403216, 90282350, 90282356, 6, 640x360 
0x1382CA98, 37353952411724888, 90282386, 90282393, 7, 640x360 
0x1382CA98, 37353952412069200, 90282425, 90282433, 8, 640x360 
0x1382CA98, 37353952412519352, 90282460, 90282465, 5, 640x360 
0x1382CA98, 37353952412838904, 90282490, 90282493, 3, 640x360 
0x1382CA98, 37353952413159352, 90282526, 90282541, 15, 640x360 
0x1382CA98, 37353952413493600, 90282559, 90282562, 3, 640x360 
0x1382CA98, 37353952413799688, 90282581, 90282591, 10, 640x360 
0x1382CA98, 37353952414125584, 90282628, 90282630, 2, 640x360 
0x1382CA98, 37353952414449304, 90282644, 90282650, 6, 640x360 
0x1382CA98, 37353952414760704, 90282688, 90282693, 5, 640x360 
0x1382CA98, 37353952415078952, 90282720, 90282724, 4, 640x360 
0x1382CA98, 37353952415403392, 90282750, 90282752, 2, 640x360 
0x1382CA98, 37353952415719736, 90282780, 90282785, 5, 640x360 
0x1382CA98, 37353952416044056, 90282807, 90282813, 6, 640x360 
0x1382CA98, 37353952416518440, 90282861, 90282864, 3, 640x360 
0x1382CA98, 37353952416841184, 90282889, 90282891, 2, 640x360 
0x1382CA98, 37353952417162872, 90282916, 90282928, 12, 640x360 
0x1382CA98, 37353952417478992, 90282947, 90282956, 9, 640x360 
0x1382CA98, 37353952417802960, 90282982, 90282991, 9, 640x360 
0x1382CA98, 37353952418129856, 90283011, 90283015, 4, 640x360 
0x1382CA98, 37353952418446768, 90283045, 90283056, 11, 640x360 
0x1382CA98, 37353952418762664, 90283076, 90283080, 4, 640x360 
0x1382CA98, 37353952419079664, 90283106, 90283109, 3, 640x360 
0x1382CA98, 37353952419399136, 90283151, 90283153, 2, 640x360 
0x1382CA98, 37353952419724728, 90283172, 90283175, 3, 640x360 
0x1382CA98, 37353952420039536, 90283203, 90283216, 13, 640x360 
0x1382CA98, 37353952420519168, 90283251, 90283253, 2, 640x360 
0x1382CA98, 37353952420843352, 90283292, 90283295, 3, 640x360 
0x1382CA98, 37353952421159440, 90283316, 90283321, 5, 640x360 
0x1382CA98, 37353952421483896, 90283350, 90283357, 7, 640x360 
0x1382CA98, 37353952421799424, 90283385, 90283389, 4, 640x360 
0x1382CA98, 37353952422120464, 90283422, 90283424, 2, 640x360 
0x1382CA98, 37353952422452536, 90283450, 90283457, 7, 640x360 
0x1382CA98, 37353952422760328, 90283479, 90283490, 11, 640x360 
0x1382CA98, 37353952423079424, 90283511, 90283514, 3, 640x360 
0x1382CA98, 37353952423409688, 90283545, 90283546, 1, 640x360 
0x1382CA98, 37353952423739688, 90283574, 90283576, 2, 640x360 
0x1382CA98, 37353952424045496, 90283605, 90283613, 8, 640x360 
0x1382CA98, 37353952424523192, 90283656, 90283658, 2, 640x360 
0x1382CA98, 37353952424842376, 90283688, 90283691, 3, 640x360 
0x1382CA98, 37353952425158976, 90283721, 90283724, 3, 640x360 
0x1382CA98, 37353952425478784, 90283746, 90283753, 7, 640x360 
0x1382CA98, 37353952425799040, 90283785, 90283792, 7, 640x360 
0x1382CA98, 37353952426125328, 90283820, 90283823, 3, 640x360 
0x1382CA98, 37353952426444312, 90283852, 90283855, 3, 640x360 
0x1382CA98, 37353952426764024, 90283884, 90283892, 8, 640x360 
0x1382CA98, 37353952427079112, 90283910, 90283913, 3, 640x360 
0x1382CA98, 37353952427399848, 90283943, 90283945, 2, 640x360 
0x1382CA98, 37353952427719680, 90283976, 90283978, 2, 640x360 
0x1382CA98, 37353952428039272, 90284013, 90284016, 3, 640x360 
0x1382CA98, 37353952428519512, 90284055, 90284064, 9, 640x360 
0x1382CA98, 37353952428839328, 90284083, 90284087, 4, 640x360 
0x1382CA98, 37353952429162456, 90284129, 90284136, 7, 640x360 
0x1382CA98, 37353952429480480, 90284159, 90284161, 2, 640x360 
0x1382CA98, 37353952429799072, 90284180, 90284192, 12, 640x360 
0x1382CA98, 37353952430128512, 90284219, 90284229, 10, 640x360 
0x1382CA98, 37353952430446296, 90284252, 90284260, 8, 640x360 
0x1382CA98, 37353952430764568, 90284289, 90284292, 3, 640x360 
0x1382CA98, 37353952431082680, 90284310, 90284312, 2, 640x360 
0x1382CA98, 37353952431400800, 90284346, 90284352, 6, 640x360 
0x1382CA98, 37353952431722176, 90284384, 90284387, 3, 640x360 
0x1382CA98, 37353952432042576, 90284414, 90284419, 5, 640x360 
0x1382CA98, 37353952432522864, 90284455, 90284457, 2, 640x360 
0x1382CA98, 37353952432841040, 90284484, 90284490, 6, 640x360 
0x1382CA98, 37353952433158800, 90284514, 90284521, 7, 640x360 
0x1382CA98, 37353952433479032, 90284561, 90284563, 2, 640x360 
0x1382CA98, 37353952433799424, 90284588, 90284590, 2, 640x360 
0x1382CA98, 37353952434126936, 90284612, 90284617, 5, 640x360 
0x1382CA98, 37353952434446328, 90284654, 90284661, 7, 640x360 
0x1382CA98, 37353952434759224, 90284685, 90284687, 2, 640x360 
0x1382CA98, 37353952435082520, 90284721, 90284723, 2, 640x360 
0x1382CA98, 37353952435399264, 90284745, 90284747, 2, 640x360 
0x1382CA98, 37353952435722816, 90284774, 90284776, 2, 640x360 
0x1382CA98, 37353952436038760, 90284807, 90284809, 2, 640x360 
0x1382CA98, 37353952436366296, 90284840, 90284842, 2, 640x360 
0x1382CA98, 37353952436838040, 90284893, 90284895, 2, 640x360 
0x1382CA98, 37353952437158352, 90284920, 90284925, 5, 640x360 
0x1382CA98, 37353952437478976, 90284948, 90284960, 12, 640x360 
0x1382CA98, 37353952437798344, 90284986, 90284992, 6, 640x360 
0x1382CA98, 37353952438137744, 90285017, 90285025, 8, 640x360 
0x1382CA98, 37353952438446240, 90285050, 90285062, 12, 640x360 
0x1382CA98, 37353952438769064, 90285077, 90285080, 3, 640x360 
0x1382CA98, 37353952439082240, 90285107, 90285109, 2, 640x360 
0x1382CA98, 37353952439402240, 90285142, 90285144, 2, 640x360 
0x1382CA98, 37353952439719160, 90285172, 90285174, 2, 640x360 
0x1382CA98, 37353952440043344, 90285205, 90285207, 2, 640x360 
0x1382CA98, 37353952440359256, 90285237, 90285246, 9, 640x360 
0x1382CA98, 37353952440848304, 90285288, 90285293, 5, 640x360 
0x1382CA98, 37353952441158792, 90285324, 90285326, 2, 640x360 
0x1382CA98, 37353952441483288, 90285355, 90285361, 6, 640x360 
0x1382CA98, 37353952441799888, 90285389, 90285391, 2, 640x360 
0x1382CA98, 37353952442142680, 90285417, 90285428, 11, 640x360 
0x1382CA98, 37353952442446232, 90285451, 90285454, 3, 640x360 
0x1382CA98, 37353952442773816, 90285478, 90285480, 2, 640x360 
0x1382CA98, 37353952443082768, 90285521, 90285530, 9, 640x360 
0x1382CA98, 37353952443402624, 90285551, 90285553, 2, 640x360 
0x1382CA98, 37353952443721904, 90285579, 90285583, 4, 640x360 
0x1382CA98, 37353952444038688, 90285603, 90285611, 8, 640x360 
0x1382CA98, 37353952444367128, 90285644, 90285650, 6, 640x360 
0x1382CA98, 37353952444838048, 90285693, 90285695, 2, 640x360 
0x1382CA98, 37353952445157784, 90285721, 90285723, 2, 640x360 
0x1382CA98, 37353952445482032, 90285747, 90285752, 5, 640x360 
0x1382CA98, 37353952445798328, 90285779, 90285791, 12, 640x360 
0x1382CA98, 37353952446125904, 90285811, 90285815, 4, 640x360 
0x1382CA98, 37353952446444552, 90285853, 90285857, 4, 640x360 
0x1382CA98, 37353952446764048, 90285879, 90285889, 10, 640x360 
0x1382CA98, 37353952447083848, 90285920, 90285922, 2, 640x360 
0x1382CA98, 37353952447401752, 90285947, 90285952, 5, 640x360 
0x1382CA98, 37353952447718824, 90285978, 90285980, 2, 640x360 
0x1382CA98, 37353952448038752, 90286010, 90286014, 4, 640x360 
0x1382CA98, 37353952448367104, 90286050, 90286052, 2, 640x360 
0x1382CA98, 37353952448838088, 90286101, 90286104, 3, 640x360 
0x1382CA98, 37353952449159000, 90286132, 90286140, 8, 640x360 
0x1382CA98, 37353952449486864, 90286158, 90286161, 3, 640x360 
0x1382CA98, 37353952449870440, 90286209, 90286220, 11, 640x360 
0x1382CA98, 37353952450127912, 90286224, 90286227, 3, 640x360 
0x1382CA98, 37353952450443816, 90286261, 90286296, 35, 640x360 
0x1382CA98, 37353952450799424, 90286302, 90286308, 6, 640x360 
0x1382CA98, 37353952451080920, 90286341, 90286362, 21, 640x360 
0x1382CA98, 37353952451412240, 90286375, 90286385, 10, 640x360 
0x1382CA98, 37353952451727736, 90286389, 90286412, 23, 640x360 
0x1382CA98, 37353952452074768, 90286442, 90286444, 2, 640x360 
0x1382CA98, 37353952452368912, 90286458, 90286461, 3, 640x360 
0x1382CA98, 37353952452840136, 90286499, 90286511, 12, 640x360 
0x1382CA98, 37353952453158664, 90286533, 90286537, 4, 640x360 
0x1382CA98, 37353952453477952, 90286556, 90286559, 3, 640x360 
0x1382CA98, 37353952453801112, 90286577, 90286580, 3, 640x360 
0x1382CA98, 37353952454119288, 90286623, 90286630, 7, 640x360 
0x1382CA98, 37353952454451544, 90286651, 90286654, 3, 640x360 
0x1382CA98, 37353952454765552, 90286677, 90286682, 5, 640x360 
0x1382CA98, 37353952455077944, 90286718, 90286721, 3, 640x360 
0x1382CA98, 37353952455408064, 90286742, 90286745, 3, 640x360 
0x1382CA98, 37353952455718784, 90286783, 90286786, 3, 640x360 
0x1382CA98, 37353952456040208, 90286819, 90286834, 15, 640x360 
0x1382CA98, 37353952456372432, 90286854, 90286856, 2, 640x360 
0x1382CA98, 37353952456850232, 90286897, 90286902, 5, 640x360 
0x1382CA98, 37353952457158088, 90286925, 90286926, 1, 640x360 
0x1382CA98, 37353952457484128, 90286956, 90286958, 2, 640x360 
0x1382CA98, 37353952457803552, 90286987, 90286990, 3, 640x360 
0x1382CA98, 37353952458117936, 90287019, 90287022, 3, 640x360 
0x1382CA98, 37353952458439824, 90287051, 90287054, 3, 640x360 
0x1382CA98, 37353952458757664, 90287077, 90287079, 2, 640x360 
0x1382CA98, 37353952459099112, 90287111, 90287114, 3, 640x360 
0x1382CA98, 37353952459438880, 90287153, 90287155, 2, 640x360 
0x1382CA98, 37353952459718864, 90287172, 90287176, 4, 640x360 
0x1382CA98, 37353952460038256, 90287205, 90287207, 2, 640x360 
0x1382CA98, 37353952460358192, 90287245, 90287247, 2, 640x360 
0x1382CA98, 37353952460682232, 90287278, 90287280, 2, 640x360 
0x1382CA98, 37353952461157584, 90287314, 90287317, 3, 640x360 
0x1382CA98, 37353952461477880, 90287349, 90287354, 5, 640x360 
0x1382CA98, 37353952461798696, 90287379, 90287382, 3, 640x360 
0x1382CA98, 37353952462124560, 90287411, 90287413, 2, 640x360 
0x1382CA98, 37353952462444112, 90287443, 90287445, 2, 640x360 
0x1382CA98, 37353952462762808, 90287482, 90287491, 9, 640x360 
0x1382CA98, 37353952463078208, 90287516, 90287519, 3, 640x360 
0x1382CA98, 37353952463402800, 90287551, 90287558, 7, 640x360 
0x1382CA98, 37353952463725968, 90287579, 90287582, 3, 640x360 
0x1382CA98, 37353952464044792, 90287605, 90287613, 8, 640x360 
0x1382CA98, 37353952464363832, 90287638, 90287640, 2, 640x360 
0x1382CA98, 37353952464685960, 90287673, 90287676, 3, 640x360 
0x1382CA98, 37353952465157880, 90287715, 90287720, 5, 640x360 
0x1382CA98, 37353952465478160, 90287749, 90287751, 2, 640x360 
0x1382CA98, 37353952465798624, 90287783, 90287786, 3, 640x360 
0x1382CA98, 37353952466119248, 90287819, 90287822, 3, 640x360 
0x1382CA98, 37353952466446640, 90287870, 90287876, 6, 640x360 
0x1382CA98, 37353952466782488, 90287902, 90287904, 2, 640x360 
0x1382CA98, 37353952467119104, 90287921, 90287924, 3, 640x360 
0x1382CA98, 37353952467410072, 90287944, 90287953, 9, 640x360 
0x1382CA98, 37353952467729256, 90287983, 90287990, 7, 640x360 
0x1382CA98, 37353952468048872, 90288014, 90288023, 9, 640x360 
0x1382CA98, 37353952468360680, 90288045, 90288048, 3, 640x360 
0x1382CA98, 37353952468677960, 90288073, 90288075, 2, 640x360 
0x1382CA98, 37353952469162496, 90288127, 90288130, 3, 640x360 
0x1382CA98, 37353952469480120, 90288162, 90288170, 8, 640x360 
0x1382CA98, 37353952469806032, 90288182, 90288185, 3, 640x360 
0x1382CA98, 37353952470123072, 90288214, 90288218, 4, 640x360 
0x1382CA98, 37353952470447576, 90288252, 90288260, 8, 640x360 
0x1382CA98, 37353952470761080, 90288283, 90288291, 8, 640x360 
0x1382CA98, 37353952471081088, 90288310, 90288315, 5, 640x360 
0x1382CA98, 37353952471398096, 90288345, 90288349, 4, 640x360 
0x1382CA98, 37353952471721472, 90288376, 90288384, 8, 640x360 
0x1382CA98, 37353952472041464, 90288410, 90288412, 2, 640x360 
0x1382CA98, 37353952472361424, 90288448, 90288452, 4, 640x360 
0x1382CA98, 37353952472677624, 90288474, 90288475, 1, 640x360 
0x1382CA98, 37353952473161088, 90288528, 90288530, 2, 640x360 
0x1382CA98, 37353952473478800, 90288553, 90288561, 8, 640x360 
0x1382CA98, 37353952473799344, 90288584, 90288586, 2, 640x360 
0x1382CA98, 37353952474117208, 90288617, 90288620, 3, 640x360 
0x1382CA98, 37353952474442304, 90288645, 90288649, 4, 640x360 
0x1382CA98, 37353952474765968, 90288682, 90288687, 5, 640x360 
0x1382CA98, 37353952475083336, 90288724, 90288735, 11, 640x360 
0x1382CA98, 37353952475410608, 90288745, 90288748, 3, 640x360 
0x1382CA98, 37353952475719728, 90288777, 90288780, 3, 640x360 
0x1382CA98, 37353952476038576, 90288808, 90288810, 2, 640x360 
0x1382CA98, 37353952476358896, 90288840, 90288842, 2, 640x360 
0x1382CA98, 37353952476678032, 90288874, 90288876, 2, 640x360 
0x1382CA98, 37353952477156928, 90288916, 90288919, 3, 640x360 
0x1382CA98, 37353952477479984, 90288958, 90288960, 2, 640x360 
0x1382CA98, 37353952477797856, 90288987, 90288989, 2, 640x360 
0x1382CA98, 37353952478132640, 90289020, 90289026, 6, 640x360 
0x1382CA98, 37353952478450616, 90289058, 90289060, 2, 640x360 
0x1382CA98, 37353952478770552, 90289091, 90289093, 2, 640x360 
0x1382CA98, 37353952479077536, 90289124, 90289126, 2, 640x360 
0x1382CA98, 37353952479398240, 90289145, 90289154, 9, 640x360 
0x1382CA98, 37353952479730080, 90289190, 90289202, 12, 640x360 
0x1382CA98, 37353952480037944, 90289224, 90289230, 6, 640x360 
0x1382CA98, 37353952480357536, 90289249, 90289252, 3, 640x360 
0x1382CA98, 37353952480683896, 90289287, 90289291, 4, 640x360 
0x1382CA98, 37353952481164080, 90289335, 90289343, 8, 640x360 
0x1382CA98, 37353952481498904, 90289362, 90289373, 11, 640x360 
0x1382CA98, 37353952481809128, 90289401, 90289410, 9, 640x360 
0x1382CA98, 37353952482135056, 90289429, 90289434, 5, 640x360 
0x1382CA98, 37353952482445584, 90289458, 90289460, 2, 640x360 
0x1382CA98, 37353952482770344, 90289502, 90289505, 3, 640x360 
0x1382CA98, 37353952483115288, 90289519, 90289523, 4, 640x360 
0x1382CA98, 37353952483397976, 90289547, 90289562, 15, 640x360 
0x1382CA98, 37353952483723880, 90289588, 90289609, 21, 640x360 
0x1382CA98, 37353952484054336, 90289620, 90289622, 2, 640x360 
0x1382CA98, 37353952484362848, 90289651, 90289656, 5, 640x360 
0x1382CA98, 37353952484686920, 90289692, 90289695, 3, 640x360 
0x1382CA98, 37353952485178504, 90289733, 90289744, 11, 640x360 
0x1382CA98, 37353952485524136, 90289764, 90289777, 13, 640x360 
0x1382CA98, 37353952485800624, 90289789, 90289800, 11, 640x360 
0x1382CA98, 37353952486138640, 90289829, 90289841, 12, 640x360 
0x1382CA98, 37353952486438808, 90289856, 90289858, 2, 640x360 
0x1382CA98, 37353952486760320, 90289879, 90289890, 11, 640x360 
0x1382CA98, 37353952487081040, 90289917, 90289921, 4, 640x360 
0x1382CA98, 37353952487430704, 90289954, 90289957, 3, 640x360 
0x1382CA98, 37353952487726616, 90289978, 90289985, 7, 640x360 
0x1382CA98, 37353952488042424, 90290018, 90290022, 4, 640x360 
0x1382CA98, 37353952488357816, 90290046, 90290052, 6, 640x360 
0x1382CA98, 37353952488682768, 90290078, 90290082, 4, 640x360 
0x1382CA98, 37353952489008792, 90290110, 90290112, 2, 640x360 
0x1382CA98, 37353952489482112, 90290160, 90290164, 4, 640x360 
0x1382CA98, 37353952489803320, 90290201, 90290203, 2, 640x360 
0x1382CA98, 37353952490137120, 90290222, 90290226, 4, 640x360 
0x1382CA98, 37353952490472048, 90290255, 90290258, 3, 640x360 
0x1382CA98, 37353952490769872, 90290288, 90290294, 6, 640x360 
0x1382CA98, 37353952491078008, 90290322, 90290328, 6, 640x360 
0x1382CA98, 37353952491399640, 90290343, 90290352, 9, 640x360 
0x1382CA98, 37353952491722112, 90290382, 90290389, 7, 640x360 
0x1382CA98, 37353952492040888, 90290411, 90290414, 3, 640x360 
0x1382CA98, 37353952492358552, 90290451, 90290453, 2, 640x360 
0x1382CA98, 37353952492677624, 90290473, 90290475, 2, 640x360 
0x1382CA98, 37353952493476560, 90290547, 90290553, 6, 640x360 
0x1382CA98, 37353952493807272, 90290586, 90290588, 2, 640x360 
0x1382CA98, 37353952494117384, 90290613, 90290618, 5, 640x360 
0x1382CA98, 37353952494447608, 90290652, 90290654, 2, 640x360 
0x1382CA98, 37353952494784600, 90290685, 90290688, 3, 640x360 
0x1382CA98, 37353952495081144, 90290710, 90290715, 5, 640x360 
0x1382CA98, 37353952495398344, 90290767, 90290774, 7, 640x360 
0x1382CA98, 37353952495719472, 90290792, 90290795, 3, 640x360 
0x1382CA98, 37353952496039392, 90290811, 90290817, 6, 640x360 
0x1382CA98, 37353952496356856, 90290839, 90290842, 3, 640x360 
0x1382CA98, 37353952496677552, 90290877, 90290879, 2, 640x360 
0x1382CA98, 37353952496999168, 90290906, 90290908, 2, 640x360 
0x1382CA98, 37353952497481120, 90290956, 90290959, 3, 640x360 
0x1382CA98, 37353952497797264, 90290987, 90290989, 2, 640x360 
0x1382CA98, 37353952498133488, 90291035, 90291049, 14, 640x360 
0x1382CA98, 37353952498458424, 90291052, 90291069, 17, 640x360 
0x1382CA98, 37353952498813160, 90291092, 90291094, 2, 640x360 
0x1382CA98, 37353952499097776, 90291122, 90291124, 2, 640x360 
0x1382CA98, 37353952499407384, 90291149, 90291153, 4, 640x360 
0x1382CA98, 37353952499717784, 90291176, 90291187, 11, 640x360 
0x1382CA98, 37353952500039960, 90291209, 90291212, 3, 640x360 
0x1382CA98, 37353952500364040, 90291244, 90291248, 4, 640x360 
0x1382CA98, 37353952500688248, 90291274, 90291280, 6, 640x360 
0x1382CA98, 37353952501009888, 90291308, 90291315, 7, 640x360 
0x1382CA98, 37353952501485520, 90291357, 90291358, 1, 640x360 
0x1382CA98, 37353952501802008, 90291387, 90291394, 7, 640x360 
0x1382CA98, 37353952502127824, 90291421, 90291425, 4, 640x360 
0x1382CA98, 37353952502465584, 90291462, 90291464, 2, 640x360 
0x1382CA98, 37353952502764312, 90291484, 90291488, 4, 640x360 
0x1382CA98, 37353952503108176, 90291526, 90291528, 2, 640x360 
0x1382CA98, 37353952503397840, 90291555, 90291562, 7, 640x360 
0x1382CA98, 37353952503732744, 90291580, 90291584, 4, 640x360 
0x1382CA98, 37353952504043880, 90291621, 90291634, 13, 640x360 
0x1382CA98, 37353952504360504, 90291651, 90291654, 3, 640x360 
0x1382CA98, 37353952504682480, 90291677, 90291681, 4, 640x360 
0x1382CA98, 37353952504997632, 90291716, 90291721, 5, 640x360 
0x1382CA98, 37353952505476584, 90291748, 90291757, 9, 640x360 
0x1382CA98, 37353952505808224, 90291789, 90291801, 12, 640x360 
0x1382CA98, 37353952506125568, 90291825, 90291827, 2, 640x360 
0x1382CA98, 37353952506453200, 90291862, 90291865, 3, 640x360 
0x1382CA98, 37353952506761480, 90291879, 90291882, 3, 640x360 
0x1382CA98, 37353952507098088, 90291924, 90291928, 4, 640x360 
0x1382CA98, 37353952507402720, 90291947, 90291960, 13, 640x360 
0x1382CA98, 37353952507725904, 90291978, 90291982, 4, 640x360 
0x1382CA98, 37353952508037008, 90292016, 90292020, 4, 640x360 
0x1382CA98, 37353952508387344, 90292042, 90292051, 9, 640x360 
0x1382CA98, 37353952508678704, 90292075, 90292077, 2, 640x360 
0x1382CA98, 37353952509010936, 90292103, 90292110, 7, 640x360 
0x1382CA98, 37353952509477184, 90292165, 90292190, 25, 640x360 
0x1382CA98, 37353952509825840, 90292195, 90292205, 10, 640x360 
0x1382CA98, 37353952510133720, 90292236, 90292240, 4, 640x360 
0x1382CA98, 37353952510481072, 90292260, 90292264, 4, 640x360 
0x1382CA98, 37353952510770288, 90292305, 90292310, 5, 640x360 
0x1382CA98, 37353952511124328, 90292324, 90292334, 10, 640x360 
0x1382CA98, 37353952511400152, 90292349, 90292370, 21, 640x360 
0x1382CA98, 37353952511723504, 90292377, 90292381, 4, 640x360 
0x1382CA98, 37353952512040728, 90292413, 90292434, 21, 640x360 
0x1382CA98, 37353952512384544, 90292452, 90292460, 8, 640x360 
0x1382CA98, 37353952512684904, 90292482, 90292495, 13, 640x360 
0x1382CA98, 37353952513000672, 90292515, 90292523, 8, 640x360 
0x1382CA98, 37353952513483528, 90292562, 90292568, 6, 640x360 
0x1382CA98, 37353952513817656, 90292591, 90292593, 2, 640x360 
0x1382CA98, 37353952514131120, 90292626, 90292639, 13, 640x360 
0x1382CA98, 37353952514473056, 90292654, 90292657, 3, 640x360 
0x1382CA98, 37353952514776744, 90292691, 90292699, 8, 640x360 
0x1382CA98, 37353952515103672, 90292724, 90292726, 2, 640x360 
0x1382CA98, 37353952515411968, 90292752, 90292756, 4, 640x360 
0x1382CA98, 37353952515729320, 90292800, 90292811, 11, 640x360 
0x1382CA98, 37353952516041448, 90292811, 90292817, 6, 640x360 
0x1382CA98, 37353952516367112, 90292853, 90292857, 4, 640x360 
0x1382CA98, 37353952516678224, 90292877, 90292883, 6, 640x360 
0x1382CA98, 37353952517002176, 90292918, 90292923, 5, 640x360 
0x1382CA98, 37353952517335640, 90292951, 90292961, 10, 640x360 
0x1382CA98, 37353952517810640, 90292993, 90292995, 2, 640x360 
0x1382CA98, 37353952518131296, 90293029, 90293035, 6, 640x360 
0x1382CA98, 37353952518478408, 90293058, 90293059, 1, 640x360 
0x1382CA98, 37353952518778120, 90293102, 90293109, 7, 640x360 
0x1382CA98, 37353952519112216, 90293121, 90293128, 7, 640x360 
0x1382CA98, 37353952519402600, 90293149, 90293162, 13, 640x360 
0x1382CA98, 37353952519738024, 90293191, 90293194, 3, 640x360 
0x1382CA98, 37353952520043296, 90293237, 90293247, 10, 640x360 
0x1382CA98, 37353952520367280, 90293247, 90293251, 4, 640x360 
0x1382CA98, 37353952520693616, 90293279, 90293282, 3, 640x360 
0x1382CA98, 37353952521003064, 90293317, 90293320, 3, 640x360 
0x1382CA98, 37353952521331248, 90293355, 90293358, 3, 640x360 
0x1382CA98, 37353952521807008, 90293386, 90293401, 15, 640x360 
0x1382CA98, 37353952522144008, 90293436, 90293449, 13, 640x360 
0x1382CA98, 37353952522467912, 90293469, 90293473, 4, 640x360 
0x1382CA98, 37353952522825160, 90293504, 90293517, 13, 640x360 
0x1382CA98, 37353952523110592, 90293524, 90293530, 6, 640x360 
0x1382CA98, 37353952523413088, 90293560, 90293567, 7, 640x360 
0x1382CA98, 37353952523722480, 90293601, 90293605, 4, 640x360 
0x1382CA98, 37353952524043584, 90293619, 90293621, 2, 640x360 
0x1382CA98, 37353952524357888, 90293641, 90293644, 3, 640x360 
0x1382CA98, 37353952524684552, 90293686, 90293694, 8, 640x360 
0x1382CA98, 37353952525003104, 90293709, 90293711, 2, 640x360 
0x1382CA98, 37353952525338392, 90293741, 90293745, 4, 640x360 
0x1382CA98, 37353952525798080, 90293795, 90293802, 7, 640x360 
0x1382CA98, 37353952526124520, 90293825, 90293835, 10, 640x360 
0x1382CA98, 37353952526451040, 90293844, 90293848, 4, 640x360 
0x1382CA98, 37353952526772312, 90293892, 90293909, 17, 640x360 
0x1382CA98, 37353952527135344, 90293925, 90293937, 12, 640x360 
0x1382CA98, 37353952527397088, 90293975, 90293980, 5, 640x360 
0x1382CA98, 37353952527726520, 90293980, 90293985, 5, 640x360 
0x1382CA98, 37353952528047176, 90294014, 90294025, 11, 640x360 
0x1382CA98, 37353952528369312, 90294047, 90294053, 6, 640x360 
0x1382CA98, 37353952528680952, 90294082, 90294085, 3, 640x360 
0x1382CA98, 37353952529004352, 90294105, 90294119, 14, 640x360 
0x1382CA98, 37353952529319816, 90294143, 90294146, 3, 640x360 
0x1382CA98, 37353952529837192, 90294200, 90294210, 10, 640x360 
0x1382CA98, 37353952530161496, 90294223, 90294226, 3, 640x360 
0x1382CA98, 37353952530445576, 90294255, 90294258, 3, 640x360 
0x1382CA98, 37353952530775448, 90294280, 90294300, 20, 640x360 
0x1382CA98, 37353952531080840, 90294323, 90294325, 2, 640x360 
0x1382CA98, 37353952531400880, 90294358, 90294376, 18, 640x360 
0x1382CA98, 37353952531792584, 90294390, 90294401, 11, 640x360 
0x1382CA98, 37353952532044600, 90294420, 90294422, 2, 640x360 
0x1382CA98, 37353952532356480, 90294446, 90294452, 6, 640x360 
0x1382CA98, 37353952532682760, 90294485, 90294488, 3, 640x360 
0x1382CA98, 37353952533002544, 90294507, 90294511, 4, 640x360 
0x1382CA98, 37353952533319888, 90294538, 90294543, 5, 640x360 
0x1382CA98, 37353952533795480, 90294584, 90294591, 7, 640x360 
0x1382CA98, 37353952534132912, 90294627, 90294645, 18, 640x360 
0x1382CA98, 37353952534485928, 90294671, 90294680, 9, 640x360 
0x1382CA98, 37353952534766320, 90294693, 90294695, 2, 640x360 
0x1382CA98, 37353952535078112, 90294723, 90294725, 2, 640x360 
0x1382CA98, 37353952535396000, 90294750, 90294754, 4, 640x360 
0x1382CA98, 37353952535726784, 90294779, 90294785, 6, 640x360 
0x1382CA98, 37353952536050400, 90294822, 90294828, 6, 640x360 
0x1382CA98, 37353952536372208, 90294852, 90294859, 7, 640x360 
0x1382CA98, 37353952536689848, 90294885, 90294892, 7, 640x360 
0x1382CA98, 37353952536996512, 90294910, 90294920, 10, 640x360 
0x1382CA98, 37353952537326184, 90294947, 90294957, 10, 640x360 
0x1382CA98, 37353952537799328, 90294991, 90294994, 3, 640x360 
0x1382CA98, 37353952538140400, 90295043, 90295049, 6, 640x360 
0x1382CA98, 37353952538462728, 90295064, 90295071, 7, 640x360 
0x1382CA98, 37353952538777296, 90295105, 90295117, 12, 640x360 
0x1382CA98, 37353952539117920, 90295127, 90295142, 15, 640x360 
0x1382CA98, 37353952539400760, 90295170, 90295177, 7, 640x360 
0x1382CA98, 37353952539738016, 90295211, 90295264, 53, 640x360 
0x1382CA98, 37353952540075520, 90295267, 90295290, 23, 640x360 
0x1382CA98, 37353952540705528, 90295292, 90295299, 7, 640x360 
0x1382CA98, 37353952541001592, 90295324, 90295331, 7, 640x360 
0x1382CA98, 37353952541360248, 90295340, 90295343, 3, 640x360 
0x1382CA98, 37353952541643872, 90295389, 90295393, 4, 640x360 
0x1382CA98, 37353952542216808, 90295433, 90295458, 25, 640x360 
0x1382CA98, 37353952542509776, 90295463, 90295512, 49, 640x360 
0x1382CA98, 37353952542843768, 90295518, 90295526, 8, 640x360 
0x1382CA98, 37353952543190848, 90295564, 90295584, 20, 640x360 
0x1382CA98, 37353952543458768, 90295585, 90295595, 10, 640x360 
0x1382CA98, 37353952543851088, 90295614, 90295620, 6, 640x360 
0x1382CA98, 37353952544221328, 90295654, 90295667, 13, 640x360 
0x1382CA98, 37353952544437392, 90295667, 90295674, 7, 640x360 
0x1382CA98, 37353952544731544, 90295704, 90295717, 13, 640x360 
0x1382CA98, 37353952545027800, 90295729, 90295742, 13, 640x360 
0x1382CA98, 37353952545361496, 90295761, 90295771, 10, 640x360 
0x1382CA98, 37353952545720320, 90295801, 90295804, 3, 640x360 
0x1382CA98, 37353952546124176, 90295836, 90295844, 8, 640x360 
0x1382CA98, 37353952546489200, 90295856, 90295861, 5, 640x360 
0x1382CA98, 37353952546766304, 90295907, 90295910, 3, 640x360 
0x1382CA98, 37353952547075632, 90295920, 90295923, 3, 640x360 
0x1382CA98, 37353952547403048, 90295950, 90295962, 12, 640x360 
0x1382CA98, 37353952547733160, 90296000, 90296003, 3, 640x360 
0x1382CA98, 37353952548043400, 90296017, 90296037, 20, 640x360 
0x1382CA98, 37353952548378360, 90296061, 90296068, 7, 640x360 
0x1382CA98, 37353952548685448, 90296084, 90296098, 14, 640x360 
0x1382CA98, 37353952549008752, 90296124, 90296136, 12, 640x360 
0x1382CA98, 37353952549324464, 90296145, 90296149, 4, 640x360 
0x1382CA98, 37353952549639688, 90296203, 90296211, 8, 640x360 
0x1382CA98, 37353952550137696, 90296242, 90296244, 2, 640x360 
0x1382CA98, 37353952550513072, 90296255, 90296260, 5, 640x360 
0x1382CA98, 37353952550814408, 90296291, 90296294, 3, 640x360 
0x1382CA98, 37353952551077544, 90296313, 90296325, 12, 640x360 
0x1382CA98, 37353952551397800, 90296357, 90296368, 11, 640x360 
0x1382CA98, 37353952551720448, 90296378, 90296383, 5, 640x360 
0x1382CA98, 37353952552040056, 90296414, 90296423, 9, 640x360 
0x1382CA98, 37353952552358880, 90296455, 90296470, 15, 640x360 
0x1382CA98, 37353952552742584, 90296507, 90296511, 4, 640x360 
0x1382CA98, 37353952553010288, 90296531, 90296539, 8, 640x360 
0x1382CA98, 37353952553388976, 90296552, 90296566, 14, 640x360 
0x1382CA98, 37353952553651128, 90296578, 90296588, 10, 640x360 
0x1382CA98, 37353952554155272, 90296628, 90296643, 15, 640x360 
0x1382CA98, 37353952554473144, 90296659, 90296662, 3, 640x360 
0x1382CA98, 37353952554819960, 90296702, 90296709, 7, 640x360 
0x1382CA98, 37353952555080664, 90296726, 90296732, 6, 640x360 
0x1382CA98, 37353952555397992, 90296773, 90296783, 10, 640x360 
0x1382CA98, 37353952555726432, 90296792, 90296811, 19, 640x360 
0x1382CA98, 37353952556042728, 90296826, 90296845, 19, 640x360 
0x1382CA98, 37353952556362008, 90296860, 90296866, 6, 640x360 
0x1382CA98, 37353952556681256, 90296919, 90296928, 9, 640x360 
0x1382CA98, 37353952557034280, 90296953, 90296970, 17, 640x360 
0x1382CA98, 37353952557406280, 90296970, 90296986, 16, 640x360 
0x1382CA98, 37353952557715920, 90297003, 90297008, 5, 640x360 
0x1382CA98, 37353952558153344, 90297045, 90297071, 26, 640x360 
0x1382CA98, 37353952558510880, 90297082, 90297095, 13, 640x360 
0x1382CA98, 37353952558839944, 90297113, 90297140, 27, 640x360 
0x1382CA98, 37353952559117616, 90297141, 90297170, 29, 640x360 
0x1382CA98, 37353952559447960, 90297196, 90297202, 6, 640x360 
0x1382CA98, 37353952560079056, 90297246, 90297274, 28, 640x360 
0x1382CA98, 37353952560446336, 90297276, 90297290, 14, 640x360 
0x1382CA98, 37353952560997960, 90297313, 90297324, 11, 640x360 
0x1382CA98, 37353952561343104, 90297345, 90297354, 9, 640x360 
0x1382CA98, 37353952561642376, 90297386, 90297392, 6, 640x360 
0x1382CA98, 37353952562131824, 90297443, 90297447, 4, 640x360 
0x1382CA98, 37353952562476624, 90297467, 90297481, 14, 640x360 
0x1382CA98, 37353952562785072, 90297492, 90297511, 19, 640x360 
0x1382CA98, 37353952563134248, 90297527, 90297540, 13, 640x360 
0x1382CA98, 37353952563408816, 90297569, 90297573, 4, 640x360 
0x1382CA98, 37353952563743368, 90297588, 90297592, 4, 640x360 
0x1382CA98, 37353952564036536, 90297613, 90297632, 19, 640x360 
0x1382CA98, 37353952564397632, 90297652, 90297656, 4, 640x360 
0x1382CA98, 37353952564686528, 90297683, 90297693, 10, 640x360 
0x1382CA98, 37353952565005512, 90297710, 90297716, 6, 640x360 
0x1382CA98, 37353952565320520, 90297741, 90297745, 4, 640x360 
0x1382CA98, 37353952565647624, 90297785, 90297791, 6, 640x360 
0x1382CA98, 37353952566120136, 90297820, 90297827, 7, 640x360 
0x1382CA98, 37353952566440848, 90297854, 90297861, 7, 640x360 
0x1382CA98, 37353952566810568, 90297901, 90297903, 2, 640x360 
0x1382CA98, 37353952567076000, 90297923, 90297925, 2, 640x360 
0x1382CA98, 37353952567403944, 90297956, 90297958, 2, 640x360 
0x1382CA98, 37353952567718336, 90297977, 90297984, 7, 640x360 
0x1382CA98, 37353952568053528, 90298026, 90298030, 4, 640x360 
0x1382CA98, 37353952568356952, 90298054, 90298072, 18, 640x360 
0x1382CA98, 37353952568706992, 90298102, 90298107, 5, 640x360 
0x1382CA98, 37353952569024408, 90298132, 90298135, 3, 640x360 
0x1382CA98, 37353952569341272, 90298145, 90298153, 8, 640x360 
0x1382CA98, 37353952569663400, 90298188, 90298202, 14, 640x360 
0x1382CA98, 37353952569973696, 90298207, 90298211, 4, 640x360 
0x1382CA98, 37353952570438744, 90298269, 90298277, 8, 640x360 
0x1382CA98, 37353952570774504, 90298290, 90298294, 4, 640x360 
0x1382CA98, 37353952571081632, 90298317, 90298335, 18, 640x360 
0x1382CA98, 37353952571413384, 90298357, 90298368, 11, 640x360 
0x1382CA98, 37353952571719184, 90298378, 90298401, 23, 640x360 
0x1382CA98, 37353952572038704, 90298410, 90298413, 3, 640x360 
0x1382CA98, 37353952572374952, 90298452, 90298455, 3, 640x360 
0x1382CA98, 37353952572676224, 90298474, 90298476, 2, 640x360 
0x1382CA98, 37353952573005944, 90298512, 90298557, 45, 640x360 
0x1382CA98, 37353952573323096, 90298565, 90298574, 9, 640x360 
0x1382CA98, 37353952573725800, 90298600, 90298622, 22, 640x360 
0x1382CA98, 37353952573977208, 90298623, 90298629, 6, 640x360 
0x1382CA98, 37353952574441360, 90298670, 90298679, 9, 640x360 
0x1382CA98, 37353952574780992, 90298694, 90298708, 14, 640x360 
0x1382CA98, 37353952575115880, 90298722, 90298767, 45, 640x360 
0x1382CA98, 37353952575395032, 90298791, 90298808, 17, 640x360 
0x1382CA98, 37353952576050664, 90298839, 90298848, 9, 640x360 
0x1382CA98, 37353952576368312, 90298858, 90298862, 4, 640x360 
0x1382CA98, 37353952576676064, 90298878, 90298882, 4, 640x360 
0x1382CA98, 37353952576998464, 90298912, 90298925, 13, 640x360 
0x1382CA98, 37353952577323736, 90298943, 90298945, 2, 640x360 
0x1382CA98, 37353952577641264, 90298992, 90298993, 1, 640x360 
0x1382CA98, 37353952577986232, 90299007, 90299011, 4, 640x360 
0x1382CA98, 37353952578453392, 90299070, 90299075, 5, 640x360 
0x1382CA98, 37353952578784856, 90299090, 90299104, 14, 640x360 
0x1382CA98, 37353952579122448, 90299121, 90299124, 3, 640x360 
0x1382CA98, 37353952579462416, 90299159, 90299165, 6, 640x360 
0x1382CA98, 37353952579722192, 90299176, 90299179, 3, 640x360 
0x1382CA98, 37353952580035832, 90299208, 90299210, 2, 640x360 
0x1382CA98, 37353952580355440, 90299237, 90299240, 3, 640x360 
0x1382CA98, 37353952580676616, 90299273, 90299275, 2, 640x360 
0x1382CA98, 37353952580995880, 90299305, 90299307, 2, 640x360 
0x1382CA98, 37353952581314512, 90299329, 90299338, 9, 640x360 
0x1382CA98, 37353952581638464, 90299370, 90299377, 7, 640x360 
0x1382CA98, 37353952581962120, 90299394, 90299398, 4, 640x360 
0x1382CA98, 37353952582449744, 90299450, 90299453, 3, 640x360 
0x1382CA98, 37353952582770696, 90299480, 90299484, 4, 640x360 
0x1382CA98, 37353952583086016, 90299507, 90299510, 3, 640x360 
0x1382CA98, 37353952583398304, 90299538, 90299541, 3, 640x360 
0x1382CA98, 37353952583715496, 90299571, 90299573, 2, 640x360 
0x1382CA98, 37353952584035432, 90299613, 90299627, 14, 640x360 
0x1382CA98, 37353952584361624, 90299646, 90299659, 13, 640x360 
0x1382CA98, 37353952584688888, 90299678, 90299685, 7, 640x360 
0x1382CA98, 37353952585001960, 90299705, 90299707, 2, 640x360 
0x1382CA98, 37353952585320392, 90299733, 90299742, 9, 640x360 
0x1382CA98, 37353952585634912, 90299760, 90299762, 2, 640x360 
0x1382CA98, 37353952585959760, 90299797, 90299802, 5, 640x360 
0x1382CA98, 37353952586451760, 90299849, 90299853, 4, 640x360 
0x1382CA98, 37353952586806048, 90299884, 90299892, 8, 640x360 
0x1382CA98, 37353952587075960, 90299912, 90299922, 10, 640x360 
0x1382CA98, 37353952587418888, 90299945, 90299954, 9, 640x360 
0x1382CA98, 37353952587721752, 90299981, 90299991, 10, 640x360 
0x1382CA98, 37353952588034760, 90300010, 90300011, 1, 640x360 
0x1382CA98, 37353952588354872, 90300045, 90300049, 4, 640x360 
0x1382CA98, 37353952588689944, 90300073, 90300075, 2, 640x360 
0x1382CA98, 37353952588995504, 90300100, 90300108, 8, 640x360 
0x1382CA98, 37353952589315416, 90300134, 90300140, 6, 640x360 
0x1382CA98, 37353952589635176, 90300165, 90300172, 7, 640x360 
0x1382CA98, 37353952589957904, 90300195, 90300200, 5, 640x360 
0x1382CA98, 37353952590443608, 90300246, 90300258, 12, 640x360 
0x1382CA98, 37353952590759864, 90300277, 90300280, 3, 640x360 
0x1382CA98, 37353952591078448, 90300312, 90300315, 3, 640x360 
0x1382CA98, 37353952591395296, 90300345, 90300349, 4, 640x360 
0x1382CA98, 37353952591724920, 90300376, 90300378, 2, 640x360 
0x1382CA98, 37353952592038488, 90300403, 90300406, 3, 640x360 
0x1382CA98, 37353952592357688, 90300440, 90300442, 2, 640x360 
0x1382CA98, 37353952592674768, 90300471, 90300477, 6, 640x360 
0x1382CA98, 37353952592995272, 90300503, 90300505, 2, 640x360 
0x1382CA98, 37353952593315472, 90300539, 90300542, 3, 640x360 
0x1382CA98, 37353952593634936, 90300572, 90300574, 2, 640x360 
0x1382CA98, 37353952593957696, 90300601, 90300603, 2, 640x360 
0x1382CA98, 37353952594445080, 90300646, 90300653, 7, 640x360 
0x1382CA98, 37353952594762976, 90300681, 90300684, 3, 640x360 
0x1382CA98, 37353952595080152, 90300705, 90300708, 3, 640x360 
0x1382CA98, 37353952595394992, 90300742, 90300744, 2, 640x360 
0x1382CA98, 37353952595720200, 90300775, 90300777, 2, 640x360 
0x1382CA98, 37353952596040800, 90300804, 90300810, 6, 640x360 
0x1382CA98, 37353952596354616, 90300837, 90300843, 6, 640x360 
0x1382CA98, 37353952596674880, 90300869, 90300871, 2, 640x360 
0x1382CA98, 37353952596995424, 90300906, 90300908, 2, 640x360 
0x1382CA98, 37353952597315504, 90300932, 90300936, 4, 640x360 
0x1382CA98, 37353952597637416, 90300962, 90300971, 9, 640x360 
0x1382CA98, 37353952597954472, 90300994, 90301006, 12, 640x360 
0x1382CA98, 37353952598279344, 90301028, 90301032, 4, 640x360 
0x1382CA98, 37353952598764088, 90301079, 90301086, 7, 640x360 
0x1382CA98, 37353952599078136, 90301113, 90301116, 3, 640x360 
0x1382CA98, 37353952599404160, 90301151, 90301153, 2, 640x360 
0x1382CA98, 37353952599721000, 90301196, 90301206, 10, 640x360 
0x1382CA98, 37353952600047960, 90301218, 90301250, 32, 640x360 
0x1382CA98, 37353952600506704, 90301267, 90301272, 5, 640x360 
0x1382CA98, 37353952600700608, 90301279, 90301291, 12, 640x360 
0x1382CA98, 37353952601011488, 90301312, 90301315, 3, 640x360 
0x1382CA98, 37353952601317384, 90301348, 90301352, 4, 640x360 
0x1382CA98, 37353952601635144, 90301366, 90301376, 10, 640x360 
0x1382CA98, 37353952601955840, 90301394, 90301398, 4, 640x360 
0x1382CA98, 37353952602278784, 90301427, 90301432, 5, 640x360 
0x1382CA98, 37353952602753688, 90301483, 90301486, 3, 640x360 
0x1382CA98, 37353952603074720, 90301509, 90301511, 2, 640x360 
0x1382CA98, 37353952603398792, 90301542, 90301545, 3, 640x360 
0x1382CA98, 37353952603714304, 90301577, 90301579, 2, 640x360 
0x1382CA98, 37353952604034544, 90301608, 90301621, 13, 640x360 
0x1382CA98, 37353952604367856, 90301639, 90301641, 2, 640x360 
0x1382CA98, 37353952604678504, 90301684, 90301693, 9, 640x360 
0x1382CA98, 37353952604994144, 90301707, 90301710, 3, 640x360 
0x1382CA98, 37353952605318880, 90301750, 90301752, 2, 640x360 
0x1382CA98, 37353952605634368, 90301766, 90301775, 9, 640x360 
0x1382CA98, 37353952605956472, 90301811, 90301812, 1, 640x360 
0x1382CA98, 37353952606286040, 90301829, 90301832, 3, 640x360 
0x1382CA98, 37353952606759216, 90301881, 90301892, 11, 640x360 
0x1382CA98, 37353952607074048, 90301910, 90301912, 2, 640x360 
0x1382CA98, 37353952607398112, 90301943, 90301945, 2, 640x360 
0x1382CA98, 37353952607713720, 90301976, 90301977, 1, 640x360 
0x1382CA98, 37353952608039992, 90302010, 90302014, 4, 640x360 
0x1382CA98, 37353952608359056, 90302040, 90302042, 2, 640x360 
0x1382CA98, 37353952608679016, 90302074, 90302077, 3, 640x360 
0x1382CA98, 37353952608993880, 90302100, 90302110, 10, 640x360 
0x1382CA98, 37353952609314880, 90302144, 90302147, 3, 640x360 
0x1382CA98, 37353952609634000, 90302162, 90302167, 5, 640x360 
0x1382CA98, 37353952609957768, 90302201, 90302207, 6, 640x360 
0x1382CA98, 37353952610281144, 90302229, 90302235, 6, 640x360 
0x1382CA98, 37353952610758136, 90302278, 90302281, 3, 640x360 
0x1382CA98, 37353952611084984, 90302320, 90302322, 2, 640x360 
0x1382CA98, 37353952611404384, 90302345, 90302347, 2, 640x360 
0x1382CA98, 37353952611715984, 90302386, 90302395, 9, 640x360 
0x1382CA98, 37353952612035896, 90302407, 90302416, 9, 640x360 
0x1382CA98, 37353952612357816, 90302439, 90302442, 3, 640x360 
0x1382CA98, 37353952612677640, 90302480, 90302485, 5, 640x360 
0x1382CA98, 37353952612998256, 90302504, 90302512, 8, 640x360 
0x1382CA98, 37353952613314072, 90302540, 90302542, 2, 640x360 
0x1382CA98, 37353952613636168, 90302567, 90302575, 8, 640x360 
0x1382CA98, 37353952613957432, 90302603, 90302606, 3, 640x360 
0x1382CA98, 37353952614282336, 90302648, 90302654, 6, 640x360 
0x1382CA98, 37353952614767064, 90302692, 90302702, 10, 640x360 
0x1382CA98, 37353952615079608, 90302737, 90302743, 6, 640x360 
0x1382CA98, 37353952615399032, 90302757, 90302772, 15, 640x360 
0x1382CA98, 37353952615736552, 90302788, 90302792, 4, 640x360 
0x1382CA98, 37353952616039864, 90302825, 90302829, 4, 640x360 
0x1382CA98, 37353952616354064, 90302845, 90302848, 3, 640x360 
0x1382CA98, 37353952616675216, 90302889, 90302891, 2, 640x360 
0x1382CA98, 37353952617012168, 90302905, 90302907, 2, 640x360 
0x1382CA98, 37353952617314608, 90302938, 90302940, 2, 640x360 
0x1382CA98, 37353952617634008, 90302966, 90302973, 7, 640x360 
0x1382CA98, 37353952617958608, 90303008, 90303012, 4, 640x360 
0x1382CA98, 37353952618306240, 90303045, 90303050, 5, 640x360 
0x1382CA98, 37353952618757640, 90303076, 90303078, 2, 640x360 
0x1382CA98, 37353952619076992, 90303108, 90303110, 2, 640x360 
0x1382CA98, 37353952619395944, 90303156, 90303162, 6, 640x360 
0x1382CA98, 37353952619725592, 90303173, 90303176, 3, 640x360 
0x1382CA98, 37353952620033568, 90303205, 90303208, 3, 640x360 
0x1382CA98, 37353952620353464, 90303245, 90303250, 5, 640x360 
0x1382CA98, 37353952620683320, 90303273, 90303276, 3, 640x360 
0x1382CA98, 37353952620994040, 90303301, 90303310, 9, 640x360 
0x1382CA98, 37353952621313448, 90303334, 90303336, 2, 640x360 
0x1382CA98, 37353952621645296, 90303365, 90303375, 10, 640x360 
0x1382CA98, 37353952621958824, 90303398, 90303404, 6, 640x360 
0x1382CA98, 37353952622281496, 90303431, 90303435, 4, 640x360 
0x1382CA98, 37353952622595424, 90303467, 90303470, 3, 640x360 
0x1382CA98, 37353952623073528, 90303508, 90303510, 2, 640x360 
0x1382CA98, 37353952623394096, 90303551, 90303554, 3, 640x360 
0x1382CA98, 37353952623713960, 90303578, 90303583, 5, 640x360 
0x1382CA98, 37353952624041288, 90303607, 90303613, 6, 640x360 
0x1382CA98, 37353952624357576, 90303635, 90303643, 8, 640x360 
0x1382CA98, 37353952624677336, 90303672, 90303683, 11, 640x360 
0x1382CA98, 37353952625004016, 90303708, 90303711, 3, 640x360 
0x1382CA98, 37353952625320384, 90303730, 90303741, 11, 640x360 
0x1382CA98, 37353952625634368, 90303761, 90303765, 4, 640x360 
0x1382CA98, 37353952625954304, 90303805, 90303807, 2, 640x360 
0x1382CA98, 37353952626274264, 90303833, 90303836, 3, 640x360 
0x1382CA98, 37353952626601032, 90303859, 90303862, 3, 640x360 
0x1382CA98, 37353952627073136, 90303915, 90303925, 10, 640x360 
0x1382CA98, 37353952627393664, 90303945, 90303948, 3, 640x360 
0x1382CA98, 37353952627717368, 90303972, 90303978, 6, 640x360 
0x1382CA98, 37353952628037488, 90304007, 90304010, 3, 640x360 
0x1382CA98, 37353952628357696, 90304047, 90304052, 5, 640x360 
0x1382CA98, 37353952628676120, 90304070, 90304072, 2, 640x360 
0x1382CA98, 37353952628996160, 90304105, 90304107, 2, 640x360 
0x1382CA98, 37353952629314272, 90304134, 90304136, 2, 640x360 
0x1382CA98, 37353952629633792, 90304167, 90304170, 3, 640x360 
0x1382CA98, 37353952629954400, 90304196, 90304200, 4, 640x360 
0x1382CA98, 37353952630278232, 90304229, 90304231, 2, 640x360 
0x1382CA98, 37353952630615080, 90304267, 90304283, 16, 640x360 
0x1382CA98, 37353952631078824, 90304313, 90304318, 5, 640x360 
0x1382CA98, 37353952631393432, 90304354, 90304364, 10, 640x360 
0x1382CA98, 37353952631759912, 90304387, 90304389, 2, 640x360 
0x1382CA98, 37353952632033560, 90304425, 90304428, 3, 640x360 
0x1382CA98, 37353952632359448, 90304441, 90304443, 2, 640x360 
0x1382CA98, 37353952632673648, 90304472, 90304474, 2, 640x360 
0x1382CA98, 37353952632993200, 90304498, 90304503, 5, 640x360 
0x1382CA98, 37353952633313368, 90304538, 90304541, 3, 640x360 
0x1382CA98, 37353952633633984, 90304567, 90304576, 9, 640x360 
0x1382CA98, 37353952633958560, 90304614, 90304621, 7, 640x360 
0x1382CA98, 37353952634304256, 90304636, 90304639, 3, 640x360 
0x1382CA98, 37353952634619232, 90304663, 90304666, 3, 640x360 
0x1382CA98, 37353952635072776, 90304720, 90304723, 3, 640x360 
0x1382CA98, 37353952635392992, 90304750, 90304753, 3, 640x360 
0x1382CA98, 37353952635717064, 90304777, 90304779, 2, 640x360 
0x1382CA98, 37353952636035976, 90304812, 90304814, 2, 640x360 
0x1382CA98, 37353952636353248, 90304838, 90304843, 5, 640x360 
0x1382CA98, 37353952636687040, 90304885, 90304887, 2, 640x360 
0x1382CA98, 37353952636993152, 90304915, 90304927, 12, 640x360 
0x1382CA98, 37353952637320480, 90304940, 90304942, 2, 640x360 
0x1382CA98, 37353952637633696, 90304965, 90304981, 16, 640x360 
0x1382CA98, 37353952637961712, 90305006, 90305009, 3, 640x360 
0x1382CA98, 37353952638283960, 90305028, 90305030, 2, 640x360 
0x1382CA98, 37353952638594512, 90305068, 90305076, 8, 640x360 
0x1382CA98, 37353952639072600, 90305111, 90305114, 3, 640x360 
0x1382CA98, 37353952639393064, 90305150, 90305160, 10, 640x360 
0x1382CA98, 37353952639717064, 90305181, 90305192, 11, 640x360 
0x1382CA98, 37353952640034040, 90305204, 90305211, 7, 640x360 
0x1382CA98, 37353952640360848, 90305245, 90305247, 2, 640x360 
0x1382CA98, 37353952640676064, 90305278, 90305280, 2, 640x360 
0x1382CA98, 37353952640995672, 90305314, 90305319, 5, 640x360 
0x1382CA98, 37353952641313232, 90305331, 90305342, 11, 640x360 
0x1382CA98, 37353952641633032, 90305362, 90305366, 4, 640x360 
0x1382CA98, 37353952641957856, 90305399, 90305406, 7, 640x360 
0x1382CA98, 37353952642282792, 90305430, 90305443, 13, 640x360 
0x1382CA98, 37353952642596280, 90305462, 90305466, 4, 640x360 
0x1382CA98, 37353952643073152, 90305511, 90305514, 3, 640x360 
0x1382CA98, 37353952643395792, 90305551, 90305554, 3, 640x360 
0x1382CA98, 37353952643722264, 90305577, 90305580, 3, 640x360 
0x1382CA98, 37353952644046336, 90305619, 90305622, 3, 640x360 
0x1382CA98, 37353952644353888, 90305644, 90305646, 2, 640x360 
0x1382CA98, 37353952644675328, 90305671, 90305678, 7, 640x360 
0x1382CA98, 37353952644995256, 90305711, 90305713, 2, 640x360 
0x1382CA98, 37353952645319888, 90305739, 90305746, 7, 640x360 
0x1382CA98, 37353952645633848, 90305771, 90305773, 2, 640x360 
0x1382CA98, 37353952645960728, 90305805, 90305807, 2, 640x360 
0x1382CA98, 37353952646281688, 90305830, 90305835, 5, 640x360 
0x1382CA98, 37353952646596320, 90305868, 90305870, 2, 640x360 
0x1382CA98, 37353952647073216, 90305919, 90305922, 3, 640x360 
0x1382CA98, 37353952647430656, 90305944, 90305951, 7, 640x360 
0x1382CA98, 37353952647713512, 90305977, 90305982, 5, 640x360 
0x1382CA98, 37353952648058448, 90306021, 90306025, 4, 640x360 
0x1382CA98, 37353952648364320, 90306046, 90306054, 8, 640x360 
0x1382CA98, 37353952648673184, 90306068, 90306072, 4, 640x360 
0x1382CA98, 37353952648992920, 90306095, 90306098, 3, 640x360 
0x1382CA98, 37353952649318320, 90306131, 90306141, 10, 640x360 
0x1382CA98, 37353952649646520, 90306180, 90306185, 5, 640x360 
0x1382CA98, 37353952649980088, 90306213, 90306224, 11, 640x360 
0x1382CA98, 37353952650273792, 90306236, 90306245, 9, 640x360 
0x1382CA98, 37353952650596584, 90306275, 90306285, 10, 640x360 
0x1382CA98, 37353952650919104, 90306304, 90306320, 16, 640x360 
0x1382CA98, 37353952651392904, 90306357, 90306365, 8, 640x360 
0x1382CA98, 37353952651733400, 90306405, 90306412, 7, 640x360 
0x1382CA98, 37353952652050064, 90306431, 90306445, 14, 640x360 
0x1382CA98, 37353952652395616, 90306463, 90306483, 20, 640x360 
0x1382CA98, 37353952652700008, 90306490, 90306508, 18, 640x360 
0x1382CA98, 37353952653006664, 90306537, 90306543, 6, 640x360 
0x1382CA98, 37353952653324776, 90306595, 90306599, 4, 640x360 
0x1382CA98, 37353952653975848, 90306633, 90306639, 6, 640x360 
0x1382CA98, 37353952654302632, 90306655, 90306678, 23, 640x360 
0x1382CA98, 37353952654612456, 90306693, 90306707, 14, 640x360 
0x1382CA98, 37353952654942824, 90306707, 90306716, 9, 640x360 
0x1382CA98, 37353952655408552, 90306772, 90306782, 10, 640x360 
0x1382CA98, 37353952655728424, 90306784, 90306789, 5, 640x360 
0x1382CA98, 37353952656032792, 90306813, 90306820, 7, 640x360 
0x1382CA98, 37353952656359904, 90306857, 90306861, 4, 640x360 
0x1382CA98, 37353952656673536, 90306879, 90306881, 2, 640x360 
0x1382CA98, 37353952657001712, 90306914, 90306919, 5, 640x360 
0x1382CA98, 37353952657316192, 90306937, 90306944, 7, 640x360 
0x1382CA98, 37353952657633088, 90306967, 90306971, 4, 640x360 
0x1382CA98, 37353952657956520, 90306997, 90307005, 8, 640x360 
0x1382CA98, 37353952658272600, 90307035, 90307038, 3, 640x360 
0x1382CA98, 37353952658593680, 90307064, 90307069, 5, 640x360 
0x1382CA98, 37353952658925056, 90307095, 90307098, 3, 640x360 
0x1382CA98, 37353952659392248, 90307150, 90307154, 4, 640x360 
0x1382CA98, 37353952659712160, 90307171, 90307182, 11, 640x360 
0x1382CA98, 37353952660032120, 90307206, 90307209, 3, 640x360 
0x1382CA98, 37353952660352720, 90307245, 90307248, 3, 640x360 
0x1382CA98, 37353952660679672, 90307278, 90307281, 3, 640x360 
0x1382CA98, 37353952660994904, 90307300, 90307310, 10, 640x360 
0x1382CA98, 37353952661313152, 90307333, 90307341, 8, 640x360 
0x1382CA98, 37353952661638224, 90307367, 90307378, 11, 640x360 
0x1382CA98, 37353952661959288, 90307405, 90307411, 6, 640x360 
0x1382CA98, 37353952662285800, 90307436, 90307439, 3, 640x360 
0x1382CA98, 37353952662597752, 90307471, 90307474, 3, 640x360 
0x1382CA98, 37353952662916656, 90307498, 90307502, 4, 640x360 
0x1382CA98, 37353952663392136, 90307539, 90307546, 7, 640x360 
0x1382CA98, 37353952663712080, 90307570, 90307578, 8, 640x360 
0x1382CA98, 37353952664032992, 90307607, 90307609, 2, 640x360 
0x1382CA98, 37353952664353736, 90307640, 90307647, 7, 640x360 
0x1382CA98, 37353952664672928, 90307671, 90307673, 2, 640x360 
0x1382CA98, 37353952664995360, 90307705, 90307713, 8, 640x360 
0x1382CA98, 37353952665313120, 90307740, 90307742, 2, 640x360 
0x1382CA98, 37353952665633920, 90307766, 90307777, 11, 640x360 
0x1382CA98, 37353952665964984, 90307804, 90307807, 3, 640x360 
0x1382CA98, 37353952666282200, 90307825, 90307828, 3, 640x360 
0x1382CA98, 37353952666593648, 90307870, 90307872, 2, 640x360 
0x1382CA98, 37353952666924904, 90307893, 90307896, 3, 640x360 
0x1382CA98, 37353952667396624, 90307944, 90307947, 3, 640x360 
0x1382CA98, 37353952667723512, 90307977, 90307979, 2, 640x360 
0x1382CA98, 37353952668036464, 90308004, 90308011, 7, 640x360 
0x1382CA98, 37353952668357872, 90308039, 90308045, 6, 640x360 
0x1382CA98, 37353952668673480, 90308073, 90308075, 2, 640x360 
0x1382CA98, 37353952668995752, 90308115, 90308120, 5, 640x360 
0x1382CA98, 37353952669313768, 90308140, 90308142, 2, 640x360 
0x1382CA98, 37353952669632312, 90308169, 90308175, 6, 640x360 
0x1382CA98, 37353952669963056, 90308213, 90308221, 8, 640x360 
0x1382CA98, 37353952670299248, 90308244, 90308247, 3, 640x360 
0x1382CA98, 37353952670594200, 90308265, 90308273, 8, 640x360 
0x1382CA98, 37353952670940808, 90308318, 90308320, 2, 640x360 
0x1382CA98, 37353952671391640, 90308339, 90308343, 4, 640x360 
0x1382CA98, 37353952671711808, 90308384, 90308387, 3, 640x360 
0x1382CA98, 37353952672033064, 90308410, 90308411, 1, 640x360 
0x1382CA98, 37353952672355248, 90308447, 90308453, 6, 640x360 
0x1382CA98, 37353952672710408, 90308477, 90308478, 1, 640x360 
0x1382CA98, 37353952673007960, 90308507, 90308509, 2, 640x360 
0x1382CA98, 37353952673322960, 90308547, 90308553, 6, 640x360 
0x1382CA98, 37353952673637024, 90308570, 90308580, 10, 640x360 
0x1382CA98, 37353952673961208, 90308606, 90308608, 2, 640x360 
0x1382CA98, 37353952674283384, 90308627, 90308630, 3, 640x360 
0x1382CA98, 37353952674609272, 90308665, 90308673, 8, 640x360 
0x1382CA98, 37353952674912744, 90308702, 90308712, 10, 640x360 
0x1382CA98, 37353952675393280, 90308751, 90308758, 7, 640x360 
0x1382CA98, 37353952675718008, 90308785, 90308791, 6, 640x360 
0x1382CA98, 37353952676032448, 90308810, 90308812, 2, 640x360 
0x1382CA98, 37353952676352072, 90308850, 90308853, 3, 640x360 
0x1382CA98, 37353952676675736, 90308867, 90308874, 7, 640x360 
0x1382CA98, 37353952676992392, 90308906, 90308908, 2, 640x360 
0x1382CA98, 37353952677324472, 90308941, 90308943, 2, 640x360 
0x1382CA98, 37353952677636248, 90308971, 90308974, 3, 640x360 
0x1382CA98, 37353952677955840, 90308997, 90309005, 8, 640x360 
0x1382CA98, 37353952678272656, 90309035, 90309040, 5, 640x360 
0x1382CA98, 37353952678595776, 90309068, 90309072, 4, 640x360 
0x1382CA98, 37353952678912016, 90309100, 90309104, 4, 640x360 
0x1382CA98, 37353952679232072, 90309133, 90309137, 4, 640x360 
0x1382CA98, 37353952679711656, 90309181, 90309185, 4, 640x360 
0x1382CA98, 37353952680044352, 90309220, 90309222, 2, 640x360 
0x1382CA98, 37353952680353840, 90309236, 90309245, 9, 640x360 
0x1382CA98, 37353952680672048, 90309269, 90309271, 2, 640x360 
0x1382CA98, 37353952680993672, 90309312, 90309319, 7, 640x360 
0x1382CA98, 37353952681315128, 90309332, 90309341, 9, 640x360 
0x1382CA98, 37353952681634472, 90309370, 90309378, 8, 640x360 
0x1382CA98, 37353952681954384, 90309406, 90309417, 11, 640x360 
0x1382CA98, 37353952682275616, 90309431, 90309441, 10, 640x360 
0x1382CA98, 37353952682597264, 90309467, 90309476, 9, 640x360 
0x1382CA98, 37353952682914912, 90309494, 90309496, 2, 640x360 
0x1382CA98, 37353952683233432, 90309527, 90309529, 2, 640x360 
0x1382CA98, 37353952683711328, 90309575, 90309578, 3, 640x360 
0x1382CA98, 37353952684034056, 90309607, 90309609, 2, 640x360 
0x1382CA98, 37353952684357064, 90309639, 90309642, 3, 640x360 
0x1382CA98, 37353952684676768, 90309675, 90309681, 6, 640x360 
0x1382CA98, 37353952684991632, 90309697, 90309720, 23, 640x360 
0x1382CA98, 37353952685317592, 90309734, 90309742, 8, 640x360 
0x1382CA98, 37353952685634168, 90309770, 90309779, 9, 640x360 
0x1382CA98, 37353952685958512, 90309795, 90309798, 3, 640x360 
0x1382CA98, 37353952686275496, 90309836, 90309840, 4, 640x360 
0x1382CA98, 37353952686621472, 90309872, 90309883, 11, 640x360 
0x1382CA98, 37353952686913296, 90309896, 90309903, 7, 640x360 
0x1382CA98, 37353952687243888, 90309930, 90309946, 16, 640x360 
0x1382CA98, 37353952687714976, 90309988, 90309990, 2, 640x360 
0x1382CA98, 37353952688036464, 90310020, 90310037, 17, 640x360 
0x1382CA98, 37353952688352416, 90310062, 90310065, 3, 640x360 
0x1382CA98, 37353952688685944, 90310081, 90310092, 11, 640x360 
0x1382CA98, 37353952688995608, 90310101, 90310105, 4, 640x360 
0x1382CA98, 37353952689318032, 90310145, 90310148, 3, 640x360 
0x1382CA98, 37353952689636232, 90310172, 90310182, 10, 640x360 
0x1382CA98, 37353952689959232, 90310195, 90310201, 6, 640x360 
0x1382CA98, 37353952690278136, 90310227, 90310230, 3, 640x360 
0x1382CA98, 37353952690595912, 90310264, 90310269, 5, 640x360 
0x1382CA98, 37353952690911696, 90310302, 90310304, 2, 640x360 
0x1382CA98, 37353952691235624, 90310333, 90310336, 3, 640x360 
0x1382CA98, 37353952691715168, 90310380, 90310385, 5, 640x360 
0x1382CA98, 37353952692033512, 90310412, 90310415, 3, 640x360 
0x1382CA98, 37353952692359216, 90310438, 90310446, 8, 640x360 
0x1382CA98, 37353952692681272, 90310470, 90310478, 8, 640x360 
0x1382CA98, 37353952692995616, 90310507, 90310515, 8, 640x360 
0x1382CA98, 37353952693312072, 90310548, 90310552, 4, 640x360 
0x1382CA98, 37353952693633664, 90310581, 90310586, 5, 640x360 
0x1382CA98, 37353952693962944, 90310598, 90310601, 3, 640x360 
0x1382CA98, 37353952694286840, 90310635, 90310639, 4, 640x360 
0x1382CA98, 37353952694597384, 90310664, 90310669, 5, 640x360 
0x1382CA98, 37353952694911592, 90310697, 90310702, 5, 640x360 
0x1382CA98, 37353952695231928, 90310740, 90310743, 3, 640x360 
0x1382CA98, 37353952695716904, 90310778, 90310781, 3, 640x360 
0x1382CA98, 37353952696031784, 90310812, 90310814, 2, 640x360 
0x1382CA98, 37353952696365712, 90310840, 90310845, 5, 640x360 
0x1382CA98, 37353952696677744, 90310878, 90310880, 2, 640x360 
0x1382CA98, 37353952696993832, 90310910, 90310912, 2, 640x360 
0x1382CA98, 37353952697315832, 90310941, 90310944, 3, 640x360 
0x1382CA98, 37353952697636384, 90310969, 90310976, 7, 640x360 
0x1382CA98, 37353952697957704, 90310995, 90311001, 6, 640x360 
0x1382CA98, 37353952698277792, 90311034, 90311044, 10, 640x360 
0x1382CA98, 37353952698592840, 90311072, 90311075, 3, 640x360 
0x1382CA98, 37353952698921832, 90311102, 90311111, 9, 640x360 
0x1382CA98, 37353952699233104, 90311128, 90311130, 2, 640x360 
0x1382CA98, 37353952699716032, 90311178, 90311180, 2, 640x360 
0x1382CA98, 37353952700042256, 90311206, 90311213, 7, 640x360 
0x1382CA98, 37353952700352120, 90311240, 90311245, 5, 640x360 
0x1382CA98, 37353952700671984, 90311266, 90311271, 5, 640x360 
0x1382CA98, 37353952700991320, 90311306, 90311315, 9, 640x360 
0x1382CA98, 37353952701311472, 90311330, 90311337, 7, 640x360 
0x1382CA98, 37353952701632616, 90311362, 90311367, 5, 640x360 
0x1382CA98, 37353952701956104, 90311394, 90311396, 2, 640x360 
0x1382CA98, 37353952702286208, 90311428, 90311432, 4, 640x360 
0x1382CA98, 37353952702610992, 90311461, 90311464, 3, 640x360 
0x1382CA98, 37353952702911320, 90311495, 90311497, 2, 640x360 
0x1382CA98, 37353952703232040, 90311524, 90311526, 2, 640x360 
0x1382CA98, 37353952703711288, 90311577, 90311580, 3, 640x360 
0x1382CA98, 37353952704032800, 90311612, 90311616, 4, 640x360 
0x1382CA98, 37353952704351376, 90311636, 90311644, 8, 640x360 
0x1382CA98, 37353952704676016, 90311678, 90311680, 2, 640x360 
0x1382CA98, 37353952704999232, 90311710, 90311712, 2, 640x360 
0x1382CA98, 37353952705344784, 90311737, 90311740, 3, 640x360 
0x1382CA98, 37353952705676960, 90311795, 90311800, 5, 640x360 
0x1382CA98, 37353952706040424, 90311821, 90311825, 4, 640x360 
0x1382CA98, 37353952706276440, 90311850, 90311858, 8, 640x360 
0x1382CA98, 37353952706616664, 90311871, 90311892, 21, 640x360 
0x1382CA98, 37353952706963816, 90311921, 90311923, 2, 640x360 
0x1382CA98, 37353952707252704, 90311935, 90311941, 6, 640x360 
0x1382CA98, 37353952707556272, 90311964, 90311971, 7, 640x360 
0x1382CA98, 37353952708035144, 90312013, 90312018, 5, 640x360 
0x1382CA98, 37353952708362728, 90312040, 90312045, 5, 640x360 
0x1382CA98, 37353952708671864, 90312072, 90312077, 5, 640x360 
0x1382CA98, 37353952708991424, 90312106, 90312108, 2, 640x360 
0x1382CA98, 37353952709316120, 90312143, 90312145, 2, 640x360 
0x1382CA98, 37353952709633952, 90312178, 90312181, 3, 640x360 
0x1382CA98, 37353952709954416, 90312205, 90312207, 2, 640x360 
0x1382CA98, 37353952710271856, 90312225, 90312227, 2, 640x360 
0x1382CA98, 37353952710595416, 90312263, 90312265, 2, 640x360 
0x1382CA98, 37353952710918144, 90312299, 90312304, 5, 640x360 
0x1382CA98, 37353952711233240, 90312332, 90312336, 4, 640x360 
0x1382CA98, 37353952711552664, 90312367, 90312371, 4, 640x360 
0x1382CA98, 37353952712032160, 90312410, 90312412, 2, 640x360 
0x1382CA98, 37353952712372960, 90312443, 90312445, 2, 640x360 
0x1382CA98, 37353952712675664, 90312473, 90312480, 7, 640x360 
0x1382CA98, 37353952712995864, 90312506, 90312508, 2, 640x360 
0x1382CA98, 37353952713314040, 90312534, 90312537, 3, 640x360 
0x1382CA98, 37353952713635704, 90312569, 90312572, 3, 640x360 
0x1382CA98, 37353952713958760, 90312596, 90312602, 6, 640x360 
0x1382CA98, 37353952714282064, 90312639, 90312642, 3, 640x360 
0x1382CA98, 37353952714609776, 90312663, 90312676, 13, 640x360 
0x1382CA98, 37353952714911568, 90312702, 90312704, 2, 640x360 
0x1382CA98, 37353952715231552, 90312738, 90312740, 2, 640x360 
0x1382CA98, 37353952715551584, 90312766, 90312776, 10, 640x360 
0x1382CA98, 37353952716035704, 90312811, 90312812, 1, 640x360 
0x1382CA98, 37353952716351216, 90312838, 90312840, 2, 640x360 
0x1382CA98, 37353952716671824, 90312870, 90312872, 2, 640x360 
0x1382CA98, 37353952716992144, 90312896, 90312899, 3, 640x360 
0x1382CA98, 37353952717312056, 90312929, 90312932, 3, 640x360 
0x1382CA98, 37353952717632456, 90312960, 90312963, 3, 640x360 
0x1382CA98, 37353952717952016, 90312996, 90313000, 4, 640x360 
0x1382CA98, 37353952718272024, 90313027, 90313030, 3, 640x360 
0x1382CA98, 37353952718592184, 90313058, 90313061, 3, 640x360 
0x1382CA98, 37353952718917392, 90313094, 90313096, 2, 640x360 
0x1382CA98, 37353952719232216, 90313125, 90313132, 7, 640x360 
0x1382CA98, 37353952719728760, 90313176, 90313182, 6, 640x360 
0x1382CA98, 37353952720034928, 90313208, 90313211, 3, 640x360 
0x1382CA98, 37353952720360448, 90313241, 90313244, 3, 640x360 
0x1382CA98, 37353952720679016, 90313271, 90313274, 3, 640x360 
0x1382CA98, 37353952720995456, 90313308, 90313310, 2, 640x360 
0x1382CA98, 37353952721318192, 90313340, 90313341, 1, 640x360 
0x1382CA98, 37353952721631160, 90313381, 90313386, 5, 640x360 
0x1382CA98, 37353952721960144, 90313395, 90313400, 5, 640x360 
0x1382CA98, 37353952722271464, 90313428, 90313432, 4, 640x360 
0x1382CA98, 37353952722591952, 90313461, 90313464, 3, 640x360 
0x1382CA98, 37353952722915824, 90313495, 90313498, 3, 640x360 
0x1382CA98, 37353952723234832, 90313527, 90313528, 1, 640x360 
0x1382CA98, 37353952723555096, 90313556, 90313559, 3, 640x360 
0x1382CA98, 37353952724031424, 90313605, 90313608, 3, 640x360 
0x1382CA98, 37353952724357096, 90313638, 90313642, 4, 640x360 
0x1382CA98, 37353952724672448, 90313678, 90313681, 3, 640x360 
0x1382CA98, 37353952724992744, 90313701, 90313710, 9, 640x360 
0x1382CA98, 37353952725315568, 90313733, 90313739, 6, 640x360 
0x1382CA98, 37353952725631776, 90313760, 90313763, 3, 640x360 
0x1382CA98, 37353952725953016, 90313794, 90313797, 3, 640x360 
0x1382CA98, 37353952726286400, 90313828, 90313832, 4, 640x360 
0x1382CA98, 37353952726591568, 90313859, 90313862, 3, 640x360 
0x1382CA98, 37353952726911656, 90313894, 90313900, 6, 640x360 
0x1382CA98, 37353952727233872, 90313924, 90313926, 2, 640x360 
0x1382CA98, 37353952727555776, 90313961, 90313965, 4, 640x360 
0x1382CA98, 37353952728030736, 90314012, 90314015, 3, 640x360 
0x1382CA98, 37353952728363024, 90314039, 90314042, 3, 640x360 
0x1382CA98, 37353952728673352, 90314077, 90314082, 5, 640x360 
0x1382CA98, 37353952728996808, 90314105, 90314110, 5, 640x360 
0x1382CA98, 37353952729336840, 90314141, 90314143, 2, 640x360 
0x1382CA98, 37353952729638552, 90314166, 90314176, 10, 640x360 
0x1382CA98, 37353952729962600, 90314199, 90314211, 12, 640x360 
0x1382CA98, 37353952730275208, 90314233, 90314236, 3, 640x360 
0x1382CA98, 37353952730614376, 90314271, 90314273, 2, 640x360 
0x1382CA98, 37353952730914032, 90314293, 90314295, 2, 640x360 
0x1382CA98, 37353952731231304, 90314329, 90314334, 5, 640x360 
0x1382CA98, 37353952731550672, 90314357, 90314360, 3, 640x360 
0x1382CA98, 37353952731870912, 90314393, 90314394, 1, 640x360 
0x1382CA98, 37353952732350960, 90314445, 90314452, 7, 640x360 
0x1382CA98, 37353952732670280, 90314476, 90314479, 3, 640x360 
0x1382CA98, 37353952732993392, 90314515, 90314534, 19, 640x360 
0x1382CA98, 37353952733315984, 90314563, 90314575, 12, 640x360 
0x1382CA98, 37353952733650872, 90314588, 90314593, 5, 640x360 
0x1382CA98, 37353952733972952, 90314605, 90314609, 4, 640x360 
0x1382CA98, 37353952734304128, 90314637, 90314645, 8, 640x360 
0x1382CA98, 37353952734597008, 90314676, 90314679, 3, 640x360 
0x1382CA98, 37353952734942064, 90314707, 90314708, 1, 640x360 
0x1382CA98, 37353952735231472, 90314726, 90314732, 6, 640x360 
0x1382CA98, 37353952735560552, 90314762, 90314765, 3, 640x360 
0x1382CA98, 37353952735872896, 90314790, 90314800, 10, 640x360 
0x1382CA98, 37353952736352640, 90314838, 90314840, 2, 640x360 
0x1382CA98, 37353952736670688, 90314873, 90314875, 2, 640x360 
0x1382CA98, 37353952736994536, 90314900, 90314906, 6, 640x360 
0x1382CA98, 37353952737326024, 90314946, 90314949, 3, 640x360 
0x1382CA98, 37353952737634856, 90314964, 90314976, 12, 640x360 
0x1382CA98, 37353952737955320, 90314995, 90315000, 5, 640x360 
0x1382CA98, 37353952738278024, 90315026, 90315028, 2, 640x360 
0x1382CA98, 37353952738590632, 90315065, 90315074, 9, 640x360 
0x1382CA98, 37353952738910984, 90315094, 90315106, 12, 640x360 
0x1382CA98, 37353952739230600, 90315137, 90315143, 6, 640x360 
0x1382CA98, 37353952739551480, 90315164, 90315169, 5, 640x360 
0x1382CA98, 37353952739874600, 90315197, 90315202, 5, 640x360 
0x1382CA98, 37353952740354536, 90315245, 90315247, 2, 640x360 
0x1382CA98, 37353952740675088, 90315277, 90315279, 2, 640x360 
0x1382CA98, 37353952740990240, 90315307, 90315309, 2, 640x360 
0x1382CA98, 37353952741310328, 90315329, 90315332, 3, 640x360 
0x1382CA98, 37353952741630912, 90315360, 90315362, 2, 640x360 
0x1382CA98, 37353952741955808, 90315396, 90315403, 7, 640x360 
0x1382CA98, 37353952742280624, 90315429, 90315434, 5, 640x360 
0x1382CA98, 37353952742594016, 90315460, 90315462, 2, 640x360 
0x1382CA98, 37353952742915048, 90315494, 90315498, 4, 640x360 
0x1382CA98, 37353952743234792, 90315527, 90315530, 3, 640x360 
0x1382CA98, 37353952743555288, 90315565, 90315575, 10, 640x360 
0x1382CA98, 37353952743874576, 90315599, 90315609, 10, 640x360 
0x1382CA98, 37353952744372192, 90315650, 90315659, 9, 640x360 
0x1382CA98, 37353952744675184, 90315676, 90315678, 2, 640x360 
0x1382CA98, 37353952744991416, 90315705, 90315707, 2, 640x360 
0x1382CA98, 37353952745310296, 90315734, 90315736, 2, 640x360 
0x1382CA98, 37353952745634896, 90315765, 90315774, 9, 640x360 
0x1382CA98, 37353952745950656, 90315796, 90315801, 5, 640x360 
0x1382CA98, 37353952746270752, 90315829, 90315834, 5, 640x360 
0x1382CA98, 37353952746594224, 90315870, 90315893, 23, 640x360 
0x1382CA98, 37353952746968160, 90315916, 90315921, 5, 640x360 
0x1382CA98, 37353952747231328, 90315931, 90315940, 9, 640x360 
0x1382CA98, 37353952747552056, 90315969, 90315972, 3, 640x360 
0x1382CA98, 37353952747871120, 90315992, 90315995, 3, 640x360 
0x1382CA98, 37353952748354816, 90316053, 90316063, 10, 640x360 
0x1382CA98, 37353952748670568, 90316073, 90316082, 9, 640x360 
0x1382CA98, 37353952748995776, 90316106, 90316121, 15, 640x360 
0x1382CA98, 37353952749325680, 90316140, 90316142, 2, 640x360 
0x1382CA98, 37353952749648424, 90316174, 90316176, 2, 640x360 
0x1382CA98, 37353952749972328, 90316201, 90316204, 3, 640x360 
0x1382CA98, 37353952750274536, 90316227, 90316230, 3, 640x360 
0x1382CA98, 37353952750597176, 90316260, 90316261, 1, 640x360 
0x1382CA98, 37353952750914848, 90316301, 90316303, 2, 640x360 
0x1382CA98, 37353952751234776, 90316328, 90316331, 3, 640x360 
0x1382CA98, 37353952751555632, 90316360, 90316362, 2, 640x360 
0x1382CA98, 37353952751875440, 90316392, 90316394, 2, 640x360 
0x1382CA98, 37353952752351288, 90316439, 90316441, 2, 640x360 
0x1382CA98, 37353952752671472, 90316466, 90316471, 5, 640x360 
0x1382CA98, 37353952752990864, 90316506, 90316510, 4, 640x360 
0x1382CA98, 37353952753311232, 90316533, 90316542, 9, 640x360 
0x1382CA98, 37353952753630280, 90316578, 90316584, 6, 640x360 
0x1382CA98, 37353952753960480, 90316598, 90316609, 11, 640x360 
0x1382CA98, 37353952754274912, 90316635, 90316638, 3, 640x360 
0x1382CA98, 37353952754596088, 90316675, 90316684, 9, 640x360 
0x1382CA98, 37353952754920000, 90316695, 90316702, 7, 640x360 
0x1382CA98, 37353952755230080, 90316724, 90316726, 2, 640x360 
0x1382CA98, 37353952755550008, 90316754, 90316759, 5, 640x360 
0x1382CA98, 37353952755876512, 90316793, 90316795, 2, 640x360 
0x1382CA98, 37353952756361864, 90316846, 90316851, 5, 640x360 
0x1382CA98, 37353952756696768, 90316872, 90316875, 3, 640x360 
0x1382CA98, 37353952756993800, 90316905, 90316924, 19, 640x360 
0x1382CA98, 37353952757319600, 90316942, 90316944, 2, 640x360 
0x1382CA98, 37353952757633496, 90316963, 90316979, 16, 640x360 
0x1382CA98, 37353952757955368, 90317005, 90317019, 14, 640x360 
0x1382CA98, 37353952758287136, 90317028, 90317031, 3, 640x360 
0x1382CA98, 37353952758604144, 90317058, 90317060, 2, 640x360 
0x1382CA98, 37353952758914336, 90317090, 90317095, 5, 640x360 
0x1382CA98, 37353952759230112, 90317131, 90317136, 5, 640x360 
0x1382CA98, 37353952759550160, 90317167, 90317171, 4, 640x360 
0x1382CA98, 37353952759870096, 90317188, 90317194, 6, 640x360 
0x1382CA98, 37353952760190624, 90317227, 90317229, 2, 640x360 
0x1382CA98, 37353952760669896, 90317273, 90317278, 5, 640x360 
0x1382CA98, 37353952760989832, 90317311, 90317315, 4, 640x360 
0x1382CA98, 37353952761310368, 90317340, 90317349, 9, 640x360 
0x1382CA98, 37353952761635640, 90317374, 90317376, 2, 640x360 
0x1382CA98, 37353952761969168, 90317401, 90317409, 8, 640x360 
0x1382CA98, 37353952762275184, 90317430, 90317436, 6, 640x360 
0x1382CA98, 37353952762615304, 90317459, 90317461, 2, 640x360 
0x1382CA98, 37353952762909736, 90317491, 90317495, 4, 640x360 
0x1382CA98, 37353952763230392, 90317536, 90317540, 4, 640x360 
0x1382CA98, 37353952763550008, 90317556, 90317565, 9, 640x360 
0x1382CA98, 37353952763872088, 90317589, 90317594, 5, 640x360 
0x1382CA98, 37353952764189888, 90317621, 90317628, 7, 640x360 
0x1382CA98, 37353952764677736, 90317673, 90317675, 2, 640x360 
0x1382CA98, 37353952765013232, 90317707, 90317729, 22, 640x360 
0x1382CA98, 37353952765323616, 90317744, 90317753, 9, 640x360 
0x1382CA98, 37353952765656008, 90317772, 90317775, 3, 640x360 
0x1382CA98, 37353952765954832, 90317821, 90317829, 8, 640x360 
0x1382CA98, 37353952766279272, 90317839, 90317849, 10, 640x360 
0x1382CA98, 37353952766594496, 90317885, 90317888, 3, 640x360 
0x1382CA98, 37353952766910608, 90317920, 90317926, 6, 640x360 
0x1382CA98, 37353952767230632, 90317940, 90317945, 5, 640x360 
0x1382CA98, 37353952767556656, 90317970, 90317977, 7, 640x360 
0x1382CA98, 37353952767886568, 90318001, 90318009, 8, 640x360 
0x1382CA98, 37353952768205480, 90318022, 90318027, 5, 640x360 
0x1382CA98, 37353952768674800, 90318077, 90318078, 1, 640x360 
0x1382CA98, 37353952768996336, 90318106, 90318108, 2, 640x360 
0x1382CA98, 37353952769317680, 90318132, 90318139, 7, 640x360 
0x1382CA98, 37353952769636344, 90318164, 90318176, 12, 640x360 
0x1382CA98, 37353952769954424, 90318195, 90318199, 4, 640x360 
0x1382CA98, 37353952770276248, 90318227, 90318229, 2, 640x360 
0x1382CA98, 37353952770592808, 90318269, 90318272, 3, 640x360 
0x1382CA98, 37353952770914432, 90318296, 90318302, 6, 640x360 
0x1382CA98, 37353952771229800, 90318332, 90318336, 4, 640x360 
0x1382CA98, 37353952771549728, 90318358, 90318360, 2, 640x360 
0x1382CA98, 37353952771870792, 90318402, 90318404, 2, 640x360 
0x1382CA98, 37353952772189968, 90318433, 90318436, 3, 640x360 
0x1382CA98, 37353952772669192, 90318472, 90318475, 3, 640x360 
0x1382CA98, 37353952772992856, 90318497, 90318507, 10, 640x360 
0x1382CA98, 37353952773316088, 90318545, 90318551, 6, 640x360 
0x1382CA98, 37353952773654528, 90318580, 90318583, 3, 640x360 
0x1382CA98, 37353952773965888, 90318597, 90318611, 14, 640x360 
0x1382CA98, 37353952774275896, 90318629, 90318632, 3, 640x360 
0x1382CA98, 37353952774589912, 90318668, 90318676, 8, 640x360 
0x1382CA98, 37353952774913152, 90318695, 90318699, 4, 640x360 
0x1382CA98, 37353952775231576, 90318728, 90318732, 4, 640x360 
0x1382CA98, 37353952775553896, 90318770, 90318779, 9, 640x360 
0x1382CA98, 37353952775874440, 90318795, 90318796, 1, 640x360 
0x1382CA98, 37353952776190496, 90318828, 90318830, 2, 640x360 
0x1382CA98, 37353952776672776, 90318866, 90318873, 7, 640x360 
0x1382CA98, 37353952776995456, 90318912, 90318915, 3, 640x360 
0x1382CA98, 37353952777309504, 90318943, 90318945, 2, 640x360 
0x1382CA98, 37353952777633608, 90318979, 90318982, 3, 640x360 
0x1382CA98, 37353952777955568, 90319002, 90319011, 9, 640x360 
0x1382CA98, 37353952778275136, 90319036, 90319045, 9, 640x360 
0x1382CA98, 37353952778592656, 90319071, 90319080, 9, 640x360 
0x1382CA98, 37353952778914296, 90319105, 90319107, 2, 640x360 
0x1382CA98, 37353952779233576, 90319132, 90319135, 3, 640x360 
0x1382CA98, 37353952779553072, 90319158, 90319160, 2, 640x360 
0x1382CA98, 37353952779870936, 90319193, 90319194, 1, 640x360 
0x1382CA98, 37353952780194528, 90319233, 90319242, 9, 640x360 
0x1382CA98, 37353952780670560, 90319279, 90319282, 3, 640x360 
0x1382CA98, 37353952780993456, 90319305, 90319314, 9, 640x360 
0x1382CA98, 37353952781319128, 90319340, 90319342, 2, 640x360 
0x1382CA98, 37353952781633952, 90319372, 90319388, 16, 640x360 
0x1382CA98, 37353952781995848, 90319408, 90319410, 2, 640x360 
0x1382CA98, 37353952782275064, 90319430, 90319434, 4, 640x360 
0x1382CA98, 37353952782589608, 90319462, 90319465, 3, 640x360 
0x1382CA98, 37353952782909824, 90319496, 90319498, 2, 640x360 
0x1382CA98, 37353952783229496, 90319525, 90319527, 2, 640x360 
0x1382CA98, 37353952783553016, 90319558, 90319560, 2, 640x360 
0x1382CA98, 37353952783869456, 90319591, 90319593, 2, 640x360 
0x1382CA98, 37353952784190840, 90319622, 90319624, 2, 640x360 
0x1382CA98, 37353952784671000, 90319674, 90319679, 5, 640x360 
0x1382CA98, 37353952784989368, 90319705, 90319708, 3, 640x360 
0x1382CA98, 37353952785310136, 90319745, 90319746, 1, 640x360 
0x1382CA98, 37353952785634008, 90319769, 90319772, 3, 640x360 
0x1382CA98, 37353952785949272, 90319801, 90319804, 3, 640x360 
0x1382CA98, 37353952786271384, 90319830, 90319834, 4, 640x360 
0x1382CA98, 37353952786589984, 90319870, 90319873, 3, 640x360 
0x1382CA98, 37353952786920472, 90319895, 90319898, 3, 640x360 
0x1382CA98, 37353952787231648, 90319931, 90319942, 11, 640x360 
0x1382CA98, 37353952787550584, 90319966, 90319976, 10, 640x360 
0x1382CA98, 37353952787870448, 90320000, 90320005, 5, 640x360 
0x1382CA98, 37353952788194632, 90320032, 90320043, 11, 640x360 
0x1382CA98, 37353952788515320, 90320067, 90320076, 9, 640x360 
0x1382CA98, 37353952788992240, 90320111, 90320113, 2, 640x360 
0x1382CA98, 37353952789319064, 90320138, 90320147, 9, 640x360 
0x1382CA98, 37353952789630392, 90320183, 90320185, 2, 640x360 
0x1382CA98, 37353952789953944, 90320204, 90320207, 3, 640x360 
0x1382CA98, 37353952790292792, 90320246, 90320248, 2, 640x360 
0x1382CA98, 37353952790589656, 90320273, 90320276, 3, 640x360 
0x1382CA98, 37353952790908976, 90320304, 90320307, 3, 640x360 
0x1382CA98, 37353952791231104, 90320332, 90320337, 5, 640x360 
0x1382CA98, 37353952791553072, 90320358, 90320361, 3, 640x360 
0x1382CA98, 37353952791869440, 90320390, 90320396, 6, 640x360 
0x1382CA98, 37353952792189904, 90320424, 90320426, 2, 640x360 
0x1382CA98, 37353952792514600, 90320457, 90320460, 3, 640x360 
0x1382CA98, 37353952792999600, 90320512, 90320515, 3, 640x360 
0x1382CA98, 37353952793315096, 90320541, 90320543, 2, 640x360 
0x1382CA98, 37353952793655848, 90320574, 90320576, 2, 640x360 
0x1382CA98, 37353952793968520, 90320606, 90320608, 2, 640x360 
0x1382CA98, 37353952794274768, 90320633, 90320637, 4, 640x360 
0x1382CA98, 37353952794600752, 90320667, 90320677, 10, 640x360 
0x1382CA98, 37353952794908744, 90320695, 90320698, 3, 640x360 
0x1382CA98, 37353952795229200, 90320732, 90320742, 10, 640x360 
0x1382CA98, 37353952795549976, 90320763, 90320769, 6, 640x360 
0x1382CA98, 37353952795873816, 90320788, 90320792, 4, 640x360 
0x1382CA98, 37353952796193816, 90320824, 90320826, 2, 640x360 
0x1382CA98, 37353952796513312, 90320856, 90320859, 3, 640x360 
0x1382CA98, 37353952796990816, 90320905, 90320908, 3, 640x360 
0x1382CA98, 37353952797309312, 90320934, 90320941, 7, 640x360 
0x1382CA98, 37353952797629608, 90320965, 90320971, 6, 640x360 
0x1382CA98, 37353952797949512, 90320996, 90321001, 5, 640x360 
0x1382CA98, 37353952798276464, 90321038, 90321044, 6, 640x360 
0x1382CA98, 37353952798590176, 90321063, 90321067, 4, 640x360 
0x1382CA98, 37353952798909672, 90321101, 90321109, 8, 640x360 
0x1382CA98, 37353952799228824, 90321125, 90321135, 10, 640x360 
0x1382CA98, 37353952799552152, 90321163, 90321169, 6, 640x360 
0x1382CA98, 37353952799869048, 90321201, 90321208, 7, 640x360 
0x1382CA98, 37353952800191784, 90321223, 90321229, 6, 640x360 
0x1382CA98, 37353952800512632, 90321265, 90321270, 5, 640x360 
0x1382CA98, 37353952800988328, 90321308, 90321310, 2, 640x360 
0x1382CA98, 37353952801327320, 90321346, 90321348, 2, 640x360 
0x1382CA98, 37353952801637936, 90321375, 90321382, 7, 640x360 
0x1382CA98, 37353952801954680, 90321413, 90321417, 4, 640x360 
0x1382CA98, 37353952802270728, 90321439, 90321441, 2, 640x360 
0x1382CA98, 37353952802589568, 90321463, 90321468, 5, 640x360 
0x1382CA98, 37353952802908672, 90321493, 90321495, 2, 640x360 
0x1382CA98, 37353952803228584, 90321529, 90321544, 15, 640x360 
0x1382CA98, 37353952803557384, 90321572, 90321579, 7, 640x360 
0x1382CA98, 37353952803881520, 90321600, 90321604, 4, 640x360 
0x1382CA98, 37353952804204080, 90321645, 90321657, 12, 640x360 
0x1382CA98, 37353952804525576, 90321671, 90321674, 3, 640x360 
0x1382CA98, 37353952804991232, 90321715, 90321720, 5, 640x360 
0x1382CA98, 37353952805308640, 90321738, 90321741, 3, 640x360 
0x1382CA98, 37353952805637784, 90321769, 90321772, 3, 640x360 
0x1382CA98, 37353952805964848, 90321812, 90321814, 2, 640x360 
0x1382CA98, 37353952806290072, 90321835, 90321845, 10, 640x360 
0x1382CA98, 37353952806593048, 90321871, 90321878, 7, 640x360 
0x1382CA98, 37353952806912800, 90321904, 90321906, 2, 640x360 
0x1382CA98, 37353952807228616, 90321935, 90321938, 3, 640x360 
0x1382CA98, 37353952807548976, 90321963, 90321966, 3, 640x360 
0x1382CA98, 37353952807868888, 90321990, 90321992, 2, 640x360 
0x1382CA98, 37353952808189648, 90322029, 90322032, 3, 640x360 
0x1382CA98, 37353952808514592, 90322057, 90322059, 2, 640x360 
0x1382CA98, 37353952808996464, 90322106, 90322109, 3, 640x360 
0x1382CA98, 37353952809309528, 90322141, 90322144, 3, 640x360 
0x1382CA98, 37353952809639272, 90322164, 90322170, 6, 640x360 
0x1382CA98, 37353952809953896, 90322197, 90322205, 8, 640x360 
0x1382CA98, 37353952810289800, 90322230, 90322233, 3, 640x360 
0x1382CA98, 37353952810593680, 90322271, 90322277, 6, 640x360 
0x1382CA98, 37353952810913112, 90322303, 90322309, 6, 640x360 
0x1382CA98, 37353952811231080, 90322338, 90322344, 6, 640x360 
0x1382CA98, 37353952811549400, 90322373, 90322375, 2, 640x360 
0x1382CA98, 37353952811870640, 90322398, 90322403, 5, 640x360 
0x1382CA98, 37353952812189256, 90322436, 90322440, 4, 640x360 
0x1382CA98, 37353952812513704, 90322456, 90322463, 7, 640x360 
0x1382CA98, 37353952812854608, 90322494, 90322495, 1, 640x360 
0x1382CA98, 37353952813319080, 90322536, 90322543, 7, 640x360 
0x1382CA98, 37353952813628464, 90322570, 90322580, 10, 640x360 
0x1382CA98, 37353952813968536, 90322596, 90322600, 4, 640x360 
0x1382CA98, 37353952814277584, 90322629, 90322632, 3, 640x360 
0x1382CA98, 37353952814595736, 90322661, 90322663, 2, 640x360 
0x1382CA98, 37353952814908320, 90322703, 90322710, 7, 640x360 
0x1382CA98, 37353952815229064, 90322727, 90322729, 2, 640x360 
0x1382CA98, 37353952815549024, 90322763, 90322766, 3, 640x360 
0x1382CA98, 37353952815871048, 90322798, 90322809, 11, 640x360 
0x1382CA98, 37353952816189856, 90322823, 90322832, 9, 640x360 
0x1382CA98, 37353952816508736, 90322855, 90322863, 8, 640x360 
0x1382CA98, 37353952817308600, 90322931, 90322937, 6, 640x360 
0x1382CA98, 37353952817636112, 90322963, 90322993, 30, 640x360 
0x1382CA98, 37353952817955448, 90323007, 90323010, 3, 640x360 
0x1382CA98, 37353952818299472, 90323037, 90323046, 9, 640x360 
0x1382CA98, 37353952818600776, 90323071, 90323074, 3, 640x360 
0x1382CA98, 37353952818908216, 90323106, 90323117, 11, 640x360 
0x1382CA98, 37353952819266336, 90323130, 90323139, 9, 640x360 
0x1382CA98, 37353952819552632, 90323156, 90323161, 5, 640x360 
0x1382CA98, 37353952819869000, 90323190, 90323193, 3, 640x360 
0x1382CA98, 37353952820188480, 90323235, 90323238, 3, 640x360 
0x1382CA98, 37353952820518760, 90323256, 90323259, 3, 640x360 
0x1382CA98, 37353952820834320, 90323288, 90323307, 19, 640x360 
0x1382CA98, 37353952821307856, 90323334, 90323338, 4, 640x360 
0x1382CA98, 37353952821631344, 90323368, 90323377, 9, 640x360 
0x1382CA98, 37353952821955816, 90323395, 90323400, 5, 640x360 
0x1382CA98, 37353952822269384, 90323428, 90323432, 4, 640x360 
0x1382CA98, 37353952822594176, 90323464, 90323471, 7, 640x360 
0x1382CA98, 37353952822934928, 90323519, 90323529, 10, 640x360 
0x1382CA98, 37353952823273648, 90323537, 90323539, 2, 640x360 
0x1382CA98, 37353952823560272, 90323566, 90323578, 12, 640x360 
0x1382CA98, 37353952823871304, 90323594, 90323598, 4, 640x360 
0x1382CA98, 37353952824196448, 90323628, 90323630, 2, 640x360 
0x1382CA98, 37353952824515448, 90323656, 90323660, 4, 640x360 
0x1382CA98, 37353952824834872, 90323690, 90323692, 2, 640x360 
0x1382CA98, 37353952825308432, 90323740, 90323744, 4, 640x360 
0x1382CA98, 37353952825628848, 90323769, 90323782, 13, 640x360 
0x1382CA98, 37353952825959480, 90323807, 90323808, 1, 640x360 
0x1382CA98, 37353952826276360, 90323826, 90323829, 3, 640x360 
0x1382CA98, 37353952826601552, 90323863, 90323865, 2, 640x360 
0x1382CA98, 37353952826908448, 90323899, 90323903, 4, 640x360 
0x1382CA98, 37353952827241640, 90323934, 90323937, 3, 640x360 
0x1382CA98, 37353952827548256, 90323956, 90323962, 6, 640x360 
0x1382CA98, 37353952827872136, 90323990, 90323996, 6, 640x360 
0x1382CA98, 37353952828188224, 90324022, 90324030, 8, 640x360 
0x1382CA98, 37353952828516928, 90324057, 90324063, 6, 640x360 
0x1382CA98, 37353952828831304, 90324084, 90324088, 4, 640x360 
0x1382CA98, 37353952829312808, 90324141, 90324143, 2, 640x360 
0x1382CA98, 37353952829632688, 90324179, 90324187, 8, 640x360 
0x1382CA98, 37353952829967816, 90324198, 90324211, 13, 640x360 
0x1382CA98, 37353952830276440, 90324235, 90324243, 8, 640x360 
0x1382CA98, 37353952830621152, 90324274, 90324276, 2, 640x360 
0x1382CA98, 37353952830907784, 90324293, 90324295, 2, 640x360 
0x1382CA98, 37353952831232624, 90324326, 90324328, 2, 640x360 
0x1382CA98, 37353952831548768, 90324356, 90324359, 3, 640x360 
0x1382CA98, 37353952831868256, 90324392, 90324393, 1, 640x360 
0x1382CA98, 37353952832204360, 90324424, 90324426, 2, 640x360 
0x1382CA98, 37353952832517808, 90324464, 90324469, 5, 640x360 
0x1382CA98, 37353952832834720, 90324488, 90324491, 3, 640x360 
0x1382CA98, 37353952833312360, 90324544, 90324546, 2, 640x360 
0x1382CA98, 37353952833634320, 90324565, 90324575, 10, 640x360 
0x1382CA98, 37353952833966120, 90324602, 90324610, 8, 640x360 
0x1382CA98, 37353952834274072, 90324634, 90324637, 3, 640x360 
0x1382CA98, 37353952834614560, 90324670, 90324673, 3, 640x360 
0x1382CA98, 37353952834907664, 90324695, 90324698, 3, 640x360 
0x1382CA98, 37353952835228312, 90324725, 90324728, 3, 640x360 
0x1382CA98, 37353952835548008, 90324755, 90324758, 3, 640x360 
0x1382CA98, 37353952835867992, 90324789, 90324792, 3, 640x360 
0x1382CA98, 37353952836190792, 90324833, 90324844, 11, 640x360 
0x1382CA98, 37353952836526104, 90324868, 90324872, 4, 640x360 
0x1382CA98, 37353952836831080, 90324891, 90324893, 2, 640x360 
0x1382CA98, 37353952837307776, 90324932, 90324941, 9, 640x360 
0x1382CA98, 37353952837630968, 90324969, 90324975, 6, 640x360 
0x1382CA98, 37353952837951408, 90325002, 90325004, 2, 640x360 
0x1382CA98, 37353952838268400, 90325035, 90325038, 3, 640x360 
0x1382CA98, 37353952838588256, 90325065, 90325067, 2, 640x360 
0x1382CA98, 37353952838908616, 90325091, 90325093, 2, 640x360 
0x1382CA98, 37353952839233160, 90325137, 90325141, 4, 640x360 
0x1382CA98, 37353952839558200, 90325170, 90325172, 2, 640x360 
0x1382CA98, 37353952839871776, 90325190, 90325193, 3, 640x360 
0x1382CA98, 37353952840188200, 90325221, 90325231, 10, 640x360 
0x1382CA98, 37353952840511472, 90325267, 90325272, 5, 640x360 
0x1382CA98, 37353952840830112, 90325288, 90325291, 3, 640x360 
0x1382CA98, 37353952841149064, 90325327, 90325332, 5, 640x360 
0x1382CA98, 37353952841628792, 90325361, 90325363, 2, 640x360 
0x1382CA98, 37353952841952288, 90325394, 90325397, 3, 640x360 
0x1382CA98, 37353952842269440, 90325430, 90325433, 3, 640x360 
0x1382CA98, 37353952842592016, 90325460, 90325462, 2, 640x360 
0x1382CA98, 37353952842912952, 90325494, 90325496, 2, 640x360 
0x1382CA98, 37353952843234984, 90325537, 90325541, 4, 640x360 
0x1382CA98, 37353952843548040, 90325559, 90325564, 5, 640x360 
0x1382CA98, 37353952843867648, 90325595, 90325597, 2, 640x360 
0x1382CA98, 37353952844191920, 90325631, 90325635, 4, 640x360 
0x1382CA98, 37353952844508296, 90325658, 90325660, 2, 640x360 
0x1382CA98, 37353952844828432, 90325689, 90325692, 3, 640x360 
0x1382CA98, 37353952845152248, 90325716, 90325720, 4, 640x360 
0x1382CA98, 37353952845628120, 90325774, 90325785, 11, 640x360 
0x1382CA98, 37353952845950760, 90325805, 90325821, 16, 640x360 
0x1382CA98, 37353952846279088, 90325840, 90325843, 3, 640x360 
0x1382CA98, 37353952846594256, 90325885, 90325890, 5, 640x360 
0x1382CA98, 37353952846935200, 90325907, 90325910, 3, 640x360 
0x1382CA98, 37353952847231664, 90325937, 90325951, 14, 640x360 
0x1382CA98, 37353952847572952, 90325973, 90325976, 3, 640x360 
0x1382CA98, 37353952847868168, 90326006, 90326014, 8, 640x360 
0x1382CA98, 37353952848192832, 90326036, 90326038, 2, 640x360 
0x1382CA98, 37353952848507648, 90326064, 90326069, 5, 640x360 
0x1382CA98, 37353952848835760, 90326105, 90326111, 6, 640x360 
0x1382CA98, 37353952849148048, 90326127, 90326136, 9, 640x360 
0x1382CA98, 37353952849630208, 90326169, 90326178, 9, 640x360 
0x1382CA98, 37353952849950368, 90326195, 90326202, 7, 640x360 
0x1382CA98, 37353952850272000, 90326229, 90326243, 14, 640x360 
0x1382CA98, 37353952850587592, 90326261, 90326264, 3, 640x360 
0x1382CA98, 37353952850911064, 90326296, 90326299, 3, 640x360 
0x1382CA98, 37353952851230992, 90326335, 90326338, 3, 640x360 
0x1382CA98, 37353952851551504, 90326358, 90326366, 8, 640x360 
0x1382CA98, 37353952851871440, 90326402, 90326410, 8, 640x360 
0x1382CA98, 37353952852193208, 90326422, 90326432, 10, 640x360 
0x1382CA98, 37353952852513896, 90326454, 90326457, 3, 640x360 
0x1382CA98, 37353952852827504, 90326491, 90326493, 2, 640x360 
0x1382CA98, 37353952853152472, 90326517, 90326523, 6, 640x360 
0x1382CA98, 37353952853648296, 90326581, 90326612, 31, 640x360 
0x1382CA98, 37353952853969024, 90326629, 90326642, 13, 640x360 
0x1382CA98, 37353952854346016, 90326645, 90326650, 5, 640x360 
0x1382CA98, 37353952854611672, 90326684, 90326694, 10, 640x360 
0x1382CA98, 37353952854913448, 90326706, 90326719, 13, 640x360 
0x1382CA98, 37353952855243064, 90326737, 90326740, 3, 640x360 
0x1382CA98, 37353952855548600, 90326771, 90326785, 14, 640x360 
0x1382CA98, 37353952855873720, 90326806, 90326811, 5, 640x360 
0x1382CA98, 37353952856211328, 90326840, 90326853, 13, 640x360 
0x1382CA98, 37353952856528928, 90326880, 90326885, 5, 640x360 
0x1382CA98, 37353952856859624, 90326902, 90326911, 9, 640x360 
0x1382CA98, 37353952857207456, 90326932, 90326936, 4, 640x360 
0x1382CA98, 37353952857627248, 90326980, 90326990, 10, 640x360 
0x1382CA98, 37353952857982000, 90327022, 90327029, 7, 640x360 
0x1382CA98, 37353952858277272, 90327065, 90327071, 6, 640x360 
0x1382CA98, 37353952858652728, 90327087, 90327092, 5, 640x360 
0x1382CA98, 37353952858942576, 90327125, 90327142, 17, 640x360 
0x1382CA98, 37353952859249560, 90327143, 90327150, 7, 640x360 
0x1382CA98, 37353952859581072, 90327173, 90327180, 7, 640x360 
0x1382CA98, 37353952859880568, 90327213, 90327224, 11, 640x360 
0x1382CA98, 37353952860199152, 90327262, 90327290, 28, 640x360 
0x1382CA98, 37353952860873696, 90327300, 90327311, 11, 640x360 
0x1382CA98, 37353952861163792, 90327327, 90327329, 2, 640x360 
0x1382CA98, 37353952861633344, 90327378, 90327380, 2, 640x360 
0x1382CA98, 37353952861956776, 90327395, 90327398, 3, 640x360 
0x1382CA98, 37353952862267680, 90327430, 90327436, 6, 640x360 
0x1382CA98, 37353952862587392, 90327463, 90327466, 3, 640x360 
0x1382CA98, 37353952862906896, 90327502, 90327504, 2, 640x360 
0x1382CA98, 37353952863232184, 90327526, 90327528, 2, 640x360 
0x1382CA98, 37353952863553512, 90327555, 90327557, 2, 640x360 
0x1382CA98, 37353952863867584, 90327588, 90327591, 3, 640x360 
0x1382CA98, 37353952864188032, 90327620, 90327628, 8, 640x360 
0x1382CA98, 37353952864508304, 90327652, 90327655, 3, 640x360 
0x1382CA98, 37353952864834368, 90327683, 90327691, 8, 640x360 
0x1382CA98, 37353952865150856, 90327715, 90327722, 7, 640x360 
0x1382CA98, 37353952865631080, 90327762, 90327765, 3, 640x360 
0x1382CA98, 37353952865947456, 90327796, 90327803, 7, 640x360 
0x1382CA98, 37353952866272944, 90327831, 90327836, 5, 640x360 
0x1382CA98, 37353952866593624, 90327862, 90327864, 2, 640x360 
0x1382CA98, 37353952866912528, 90327889, 90327891, 2, 640x360 
0x1382CA98, 37353952867227896, 90327927, 90327930, 3, 640x360 
0x1382CA98, 37353952867548072, 90327967, 90327970, 3, 640x360 
0x1382CA98, 37353952867873512, 90327994, 90327996, 2, 640x360 
0x1382CA98, 37353952868187680, 90328022, 90328025, 3, 640x360 
0x1382CA98, 37353952868513232, 90328062, 90328064, 2, 640x360 
0x1382CA98, 37353952868827048, 90328087, 90328090, 3, 640x360 
0x1382CA98, 37353952869147128, 90328120, 90328126, 6, 640x360 
0x1382CA98, 37353952869467472, 90328150, 90328157, 7, 640x360 
0x1382CA98, 37353952869951288, 90328196, 90328199, 3, 640x360 
0x1382CA98, 37353952870285584, 90328234, 90328237, 3, 640x360 
0x1382CA98, 37353952870589120, 90328268, 90328271, 3, 640x360 
0x1382CA98, 37353952870913208, 90328300, 90328304, 4, 640x360 
0x1382CA98, 37353952871230064, 90328333, 90328336, 3, 640x360 
0x1382CA98, 37353952871556816, 90328355, 90328359, 4, 640x360 
0x1382CA98, 37353952871867504, 90328393, 90328395, 2, 640x360 
0x1382CA98, 37353952872191144, 90328424, 90328426, 2, 640x360 
0x1382CA98, 37353952872517120, 90328455, 90328457, 2, 640x360 
0x1382CA98, 37353952872837856, 90328491, 90328494, 3, 640x360 
0x1382CA98, 37353952873149896, 90328527, 90328529, 2, 640x360 
0x1382CA98, 37353952873467728, 90328555, 90328559, 4, 640x360 
0x1382CA98, 37353952873965968, 90328617, 90328634, 17, 640x360 
0x1382CA98, 37353952874294640, 90328641, 90328645, 4, 640x360 
0x1382CA98, 37353952874593984, 90328685, 90328691, 6, 640x360 
0x1382CA98, 37353952874909032, 90328706, 90328709, 3, 640x360 
0x1382CA98, 37353952875227160, 90328736, 90328746, 10, 640x360 
0x1382CA98, 37353952875550352, 90328773, 90328775, 2, 640x360 
0x1382CA98, 37353952875867072, 90328791, 90328793, 2, 640x360 
0x1382CA98, 37353952876187368, 90328835, 90328837, 2, 640x360 
0x1382CA98, 37353952876515320, 90328861, 90328864, 3, 640x360 
0x1382CA98, 37353952876827184, 90328896, 90328898, 2, 640x360 
0x1382CA98, 37353952877148776, 90328922, 90328925, 3, 640x360 
0x1382CA98, 37353952877472632, 90328947, 90328954, 7, 640x360 
0x1382CA98, 37353952877950136, 90329006, 90329008, 2, 640x360 
0x1382CA98, 37353952878271976, 90329035, 90329043, 8, 640x360 
0x1382CA98, 37353952878587352, 90329064, 90329071, 7, 640x360 
0x1382CA98, 37353952878911856, 90329096, 90329103, 7, 640x360 
0x1382CA98, 37353952879239360, 90329129, 90329132, 3, 640x360 
0x1382CA98, 37353952879550696, 90329162, 90329164, 2, 640x360 
0x1382CA98, 37353952879870296, 90329197, 90329202, 5, 640x360 
0x1382CA98, 37353952880188496, 90329223, 90329225, 2, 640x360 
0x1382CA98, 37353952880511272, 90329267, 90329270, 3, 640x360 
0x1382CA98, 37353952880826648, 90329287, 90329290, 3, 640x360 
0x1382CA98, 37353952881146728, 90329317, 90329320, 3, 640x360 
0x1382CA98, 37353952881466992, 90329358, 90329361, 3, 640x360 
0x1382CA98, 37353952881957888, 90329396, 90329402, 6, 640x360 
0x1382CA98, 37353952882274656, 90329427, 90329431, 4, 640x360 
0x1382CA98, 37353952882587272, 90329463, 90329469, 6, 640x360 
0x1382CA98, 37353952882907136, 90329494, 90329502, 8, 640x360 
0x1382CA98, 37353952883228688, 90329526, 90329529, 3, 640x360 
0x1382CA98, 37353952883546784, 90329554, 90329562, 8, 640x360 
0x1382CA98, 37353952883866832, 90329587, 90329593, 6, 640x360 
0x1382CA98, 37353952884187400, 90329623, 90329625, 2, 640x360 
0x1382CA98, 37353952884507120, 90329659, 90329661, 2, 640x360 
0x1382CA98, 37353952884827792, 90329687, 90329693, 6, 640x360 
0x1382CA98, 37353952885146976, 90329715, 90329724, 9, 640x360 
0x1382CA98, 37353952885467672, 90329750, 90329753, 3, 640x360 
0x1382CA98, 37353952885950424, 90329799, 90329803, 4, 640x360 
0x1382CA98, 37353952886298008, 90329836, 90329843, 7, 640x360 
0x1382CA98, 37353952886586776, 90329894, 90329896, 2, 640x360 
0x1382CA98, 37353952886927456, 90329909, 90329920, 11, 640x360 
0x1382CA98, 37353952887230656, 90329954, 90329960, 6, 640x360 
0x1382CA98, 37353952887546600, 90329974, 90329979, 5, 640x360 
0x1382CA98, 37353952887883952, 90330020, 90330030, 10, 640x360 
0x1382CA98, 37353952888208736, 90330039, 90330046, 7, 640x360 
0x1382CA98, 37353952888510008, 90330060, 90330072, 12, 640x360 
0x1382CA98, 37353952888838456, 90330091, 90330093, 2, 640x360 
0x1382CA98, 37353952889146672, 90330132, 90330137, 5, 640x360 
0x1382CA98, 37353952889487272, 90330165, 90330176, 11, 640x360 
0x1382CA98, 37353952889949656, 90330200, 90330209, 9, 640x360 
0x1382CA98, 37353952890290080, 90330232, 90330246, 14, 640x360 
0x1382CA98, 37353952890587336, 90330273, 90330283, 10, 640x360 
0x1382CA98, 37353952890921856, 90330304, 90330306, 2, 640x360 
0x1382CA98, 37353952891226208, 90330333, 90330336, 3, 640x360 
0x1382CA98, 37353952891558760, 90330361, 90330368, 7, 640x360 
0x1382CA98, 37353952891866312, 90330392, 90330394, 2, 640x360 
0x1382CA98, 37353952892186312, 90330421, 90330428, 7, 640x360 
0x1382CA98, 37353952892507096, 90330455, 90330458, 3, 640x360 
0x1382CA98, 37353952892829336, 90330488, 90330498, 10, 640x360 
0x1382CA98, 37353952893146696, 90330518, 90330522, 4, 640x360 
0x1382CA98, 37353952893472832, 90330547, 90330560, 13, 640x360 
0x1382CA98, 37353952893947784, 90330594, 90330597, 3, 640x360 
0x1382CA98, 37353952894278888, 90330629, 90330632, 3, 640x360 
0x1382CA98, 37353952894641488, 90330670, 90330672, 2, 640x360 
0x1382CA98, 37353952894908064, 90330693, 90330696, 3, 640x360 
0x1382CA98, 37353952895230320, 90330734, 90330744, 10, 640x360 
0x1382CA98, 37353952895547712, 90330767, 90330773, 6, 640x360 
0x1382CA98, 37353952895879272, 90330792, 90330801, 9, 640x360 
0x1382CA98, 37353952896186272, 90330823, 90330829, 6, 640x360 
0x1382CA98, 37353952896513360, 90330856, 90330861, 5, 640x360 
0x1382CA98, 37353952896830760, 90330897, 90330900, 3, 640x360 
0x1382CA98, 37353952897149960, 90330917, 90330922, 5, 640x360 
0x1382CA98, 37353952897466656, 90330946, 90330951, 5, 640x360 
0x1382CA98, 37353952897787264, 90330979, 90330984, 5, 640x360 
0x1382CA98, 37353952898283528, 90331036, 90331043, 7, 640x360 
0x1382CA98, 37353952898586328, 90331070, 90331073, 3, 640x360 
0x1382CA98, 37353952898907120, 90331106, 90331109, 3, 640x360 
0x1382CA98, 37353952899225920, 90331134, 90331140, 6, 640x360 
0x1382CA98, 37353952899550920, 90331160, 90331162, 2, 640x360 
0x1382CA98, 37353952899880232, 90331194, 90331201, 7, 640x360 
0x1382CA98, 37353952900197160, 90331227, 90331230, 3, 640x360 
0x1382CA98, 37353952900530592, 90331264, 90331278, 14, 640x360 
0x1382CA98, 37353952900830984, 90331302, 90331310, 8, 640x360 
0x1382CA98, 37353952901151712, 90331324, 90331337, 13, 640x360 
0x1382CA98, 37353952901473664, 90331350, 90331360, 10, 640x360 
0x1382CA98, 37353952901792424, 90331378, 90331382, 4, 640x360 
0x1382CA98, 37353952902276624, 90331434, 90331442, 8, 640x360 
0x1382CA98, 37353952902586048, 90331470, 90331476, 6, 640x360 
0x1382CA98, 37353952902906248, 90331494, 90331500, 6, 640x360 
0x1382CA98, 37353952903226296, 90331531, 90331536, 5, 640x360 
0x1382CA98, 37353952903548368, 90331568, 90331576, 8, 640x360 
0x1382CA98, 37353952903866280, 90331589, 90331600, 11, 640x360 
0x1382CA98, 37353952904186248, 90331622, 90331630, 8, 640x360 
0x1382CA98, 37353952904512120, 90331654, 90331659, 5, 640x360 
0x1382CA98, 37353952904826400, 90331686, 90331690, 4, 640x360 
0x1382CA98, 37353952905150624, 90331729, 90331736, 7, 640x360 
0x1382CA98, 37353952905476664, 90331749, 90331759, 10, 640x360 
0x1382CA98, 37353952905788288, 90331780, 90331789, 9, 640x360 
0x1382CA98, 37353952906265880, 90331841, 90331855, 14, 640x360 
0x1382CA98, 37353952906588336, 90331864, 90331871, 7, 640x360 
0x1382CA98, 37353952906931680, 90331906, 90331909, 3, 640x360 
0x1382CA98, 37353952907225688, 90331936, 90331943, 7, 640x360 
0x1382CA98, 37353952907546680, 90331958, 90331960, 2, 640x360 
0x1382CA98, 37353952907865944, 90331987, 90331989, 2, 640x360 
0x1382CA98, 37353952908185808, 90332031, 90332036, 5, 640x360 
0x1382CA98, 37353952908506056, 90332056, 90332062, 6, 640x360 
0x1382CA98, 37353952908826912, 90332092, 90332094, 2, 640x360 
0x1382CA98, 37353952909146328, 90332129, 90332132, 3, 640x360 
0x1382CA98, 37353952909473656, 90332152, 90332155, 3, 640x360 
0x1382CA98, 37353952909787216, 90332178, 90332181, 3, 640x360 
0x1382CA98, 37353952910270136, 90332237, 90332240, 3, 640x360 
0x1382CA98, 37353952910614352, 90332259, 90332262, 3, 640x360 
0x1382CA98, 37353952910907952, 90332294, 90332296, 2, 640x360 
0x1382CA98, 37353952911230440, 90332339, 90332342, 3, 640x360 
0x1382CA98, 37353952911545808, 90332366, 90332377, 11, 640x360 
0x1382CA98, 37353952911881360, 90332390, 90332393, 3, 640x360 
0x1382CA98, 37353952912189608, 90332429, 90332431, 2, 640x360 
0x1382CA98, 37353952912514320, 90332462, 90332464, 2, 640x360 
0x1382CA98, 37353952912836448, 90332496, 90332499, 3, 640x360 
0x1382CA98, 37353952913147600, 90332528, 90332531, 3, 640x360 
0x1382CA98, 37353952913477808, 90332565, 90332571, 6, 640x360 
0x1382CA98, 37353952913813392, 90332593, 90332598, 5, 640x360 
0x1382CA98, 37353952914272864, 90332631, 90332639, 8, 640x360 
0x1382CA98, 37353952914585784, 90332669, 90332675, 6, 640x360 
0x1382CA98, 37353952914905832, 90332701, 90332707, 6, 640x360 
0x1382CA98, 37353952915229832, 90332726, 90332727, 1, 640x360 
0x1382CA98, 37353952915545584, 90332753, 90332761, 8, 640x360 
0x1382CA98, 37353952915870592, 90332791, 90332793, 2, 640x360 
0x1382CA98, 37353952916185736, 90332819, 90332822, 3, 640x360 
0x1382CA98, 37353952916506360, 90332855, 90332857, 2, 640x360 
0x1382CA98, 37353952916830056, 90332889, 90332891, 2, 640x360 
0x1382CA98, 37353952917149128, 90332919, 90332923, 4, 640x360 
0x1382CA98, 37353952917467304, 90332951, 90332953, 2, 640x360 
0x1382CA98, 37353952917797840, 90332985, 90332993, 8, 640x360 
0x1382CA98, 37353952918269504, 90333030, 90333043, 13, 640x360 
0x1382CA98, 37353952918586672, 90333063, 90333067, 4, 640x360 
0x1382CA98, 37353952918906016, 90333095, 90333097, 2, 640x360 
0x1382CA98, 37353952919226160, 90333141, 90333144, 3, 640x360 
0x1382CA98, 37353952919546912, 90333171, 90333173, 2, 640x360 
0x1382CA98, 37353952919868856, 90333194, 90333195, 1, 640x360 
0x1382CA98, 37353952920188872, 90333233, 90333237, 4, 640x360 
0x1382CA98, 37353952920509984, 90333261, 90333263, 2, 640x360 
0x1382CA98, 37353952920832744, 90333287, 90333290, 3, 640x360 
0x1382CA98, 37353952921149440, 90333316, 90333321, 5, 640x360 
0x1382CA98, 37353952921488424, 90333347, 90333353, 6, 640x360 
0x1382CA98, 37353952921786736, 90333378, 90333381, 3, 640x360 
0x1382CA98, 37353952922125272, 90333415, 90333418, 3, 640x360 
0x1382CA98, 37353952922586296, 90333470, 90333472, 2, 640x360 
0x1382CA98, 37353952922922336, 90333493, 90333496, 3, 640x360 
0x1382CA98, 37353952923230800, 90333526, 90333530, 4, 640x360 
0x1382CA98, 37353952923546632, 90333570, 90333573, 3, 640x360 
0x1382CA98, 37353952923866184, 90333589, 90333592, 3, 640x360 
0x1382CA98, 37353952924186280, 90333629, 90333632, 3, 640x360 
0x1382CA98, 37353952924506760, 90333654, 90333657, 3, 640x360 
0x1382CA98, 37353952924825544, 90333687, 90333699, 12, 640x360 
0x1382CA98, 37353952925146288, 90333723, 90333726, 3, 640x360 
0x1382CA98, 37353952925469584, 90333747, 90333756, 9, 640x360 
0x1382CA98, 37353952925793472, 90333781, 90333793, 12, 640x360 
0x1382CA98, 37353952926111632, 90333816, 90333824, 8, 640x360 
0x1382CA98, 37353952926585096, 90333860, 90333863, 3, 640x360 
0x1382CA98, 37353952926905224, 90333902, 90333905, 3, 640x360 
0x1382CA98, 37353952927243840, 90333937, 90333944, 7, 640x360 
0x1382CA98, 37353952927551432, 90333970, 90333972, 2, 640x360 
0x1382CA98, 37353952927865344, 90333989, 90333996, 7, 640x360 
0x1382CA98, 37353952928191808, 90334023, 90334031, 8, 640x360 
0x1382CA98, 37353952928510328, 90334054, 90334059, 5, 640x360 
0x1382CA98, 37353952928825688, 90334104, 90334107, 3, 640x360 
0x1382CA98, 37353952929164480, 90334128, 90334149, 21, 640x360 
0x1382CA98, 37353952929556984, 90334172, 90334179, 7, 640x360 
0x1382CA98, 37353952929813656, 90334202, 90334212, 10, 640x360 
0x1382CA98, 37353952930135768, 90334224, 90334232, 8, 640x360 
0x1382CA98, 37353952930593600, 90334261, 90334265, 4, 640x360 
0x1382CA98, 37353952930905912, 90334298, 90334310, 12, 640x360 
0x1382CA98, 37353952931226928, 90334335, 90334343, 8, 640x360 
0x1382CA98, 37353952931545712, 90334363, 90334370, 7, 640x360 
0x1382CA98, 37353952931865128, 90334395, 90334398, 3, 640x360 
0x1382CA98, 37353952932185840, 90334428, 90334430, 2, 640x360 
0x1382CA98, 37353952932509920, 90334456, 90334458, 2, 640x360 
0x1382CA98, 37353952932827248, 90334490, 90334493, 3, 640x360 
0x1382CA98, 37353952933146424, 90334529, 90334533, 4, 640x360 
0x1382CA98, 37353952933466232, 90334558, 90334561, 3, 640x360 
0x1382CA98, 37353952933803352, 90334581, 90334596, 15, 640x360 
0x1382CA98, 37353952934120584, 90334613, 90334622, 9, 640x360 
0x1382CA98, 37353952934591192, 90334661, 90334665, 4, 640x360 
0x1382CA98, 37353952934908032, 90334695, 90334697, 2, 640x360 
0x1382CA98, 37353952935236024, 90334727, 90334730, 3, 640x360 
0x1382CA98, 37353952935549608, 90334767, 90334771, 4, 640x360 
0x1382CA98, 37353952935892456, 90334793, 90334795, 2, 640x360 
0x1382CA98, 37353952936185576, 90334831, 90334843, 12, 640x360 
0x1382CA98, 37353952936517880, 90334869, 90334877, 8, 640x360 
0x1382CA98, 37353952936840720, 90334891, 90334893, 2, 640x360 
0x1382CA98, 37353952937160880, 90334922, 90334924, 2, 640x360 
0x1382CA98, 37353952937471888, 90334950, 90334954, 4, 640x360 
0x1382CA98, 37353952937795640, 90334982, 90334993, 11, 640x360 
0x1382CA98, 37353952938121288, 90335019, 90335021, 2, 640x360 
0x1382CA98, 37353952938594768, 90335069, 90335072, 3, 640x360 
0x1382CA98, 37353952938907056, 90335093, 90335102, 9, 640x360 
0x1382CA98, 37353952939225704, 90335134, 90335137, 3, 640x360 
0x1382CA98, 37353952939555312, 90335162, 90335165, 3, 640x360 
0x1382CA98, 37353952939865032, 90335189, 90335196, 7, 640x360 
0x1382CA98, 37353952940188848, 90335220, 90335228, 8, 640x360 
0x1382CA98, 37353952940536056, 90335256, 90335258, 2, 640x360 
0x1382CA98, 37353952940835464, 90335282, 90335289, 7, 640x360 
0x1382CA98, 37353952941145136, 90335328, 90335332, 4, 640x360 
0x1382CA98, 37353952941480104, 90335356, 90335359, 3, 640x360 
0x1382CA98, 37353952941791624, 90335385, 90335393, 8, 640x360 
0x1382CA98, 37353952942110104, 90335412, 90335416, 4, 640x360 
0x1382CA98, 37353952942585104, 90335462, 90335466, 4, 640x360 
0x1382CA98, 37353952942910128, 90335496, 90335502, 6, 640x360 
0x1382CA98, 37353952943229736, 90335524, 90335526, 2, 640x360 
0x1382CA98, 37353952943548960, 90335566, 90335570, 4, 640x360 
0x1382CA98, 37353952943883784, 90335602, 90335605, 3, 640x360 
0x1382CA98, 37353952944188832, 90335626, 90335627, 1, 640x360 
0x1382CA98, 37353952944509216, 90335661, 90335663, 2, 640x360 
0x1382CA98, 37353952944825088, 90335687, 90335690, 3, 640x360 
0x1382CA98, 37353952945151040, 90335730, 90335735, 5, 640x360 
0x1382CA98, 37353952945466032, 90335755, 90335756, 1, 640x360 
0x1382CA98, 37353952945790328, 90335786, 90335792, 6, 640x360 
0x1382CA98, 37353952946114608, 90335812, 90335815, 3, 640x360 
0x1382CA98, 37353952946584608, 90335866, 90335875, 9, 640x360 
0x1382CA98, 37353952946910120, 90335902, 90335909, 7, 640x360 
0x1382CA98, 37353952947228832, 90335931, 90335936, 5, 640x360 
0x1382CA98, 37353952947545336, 90335960, 90335962, 2, 640x360 
0x1382CA98, 37353952947864672, 90335996, 90335998, 2, 640x360 
0x1382CA98, 37353952948193824, 90336025, 90336032, 7, 640x360 
0x1382CA98, 37353952948510168, 90336064, 90336070, 6, 640x360 
0x1382CA98, 37353952948825432, 90336092, 90336094, 2, 640x360 
0x1382CA98, 37353952949147800, 90336123, 90336129, 6, 640x360 
0x1382CA98, 37353952949465552, 90336162, 90336164, 2, 640x360 
0x1382CA98, 37353952949790976, 90336192, 90336193, 1, 640x360 
0x1382CA98, 37353952950108856, 90336215, 90336228, 13, 640x360 
0x1382CA98, 37353952950430416, 90336256, 90336259, 3, 640x360 
0x1382CA98, 37353952950904256, 90336297, 90336301, 4, 640x360 
0x1382CA98, 37353952951229208, 90336336, 90336338, 2, 640x360 
0x1382CA98, 37353952951548472, 90336365, 90336370, 5, 640x360 
0x1382CA98, 37353952951864432, 90336391, 90336396, 5, 640x360 
0x1382CA98, 37353952952184672, 90336425, 90336432, 7, 640x360 
0x1382CA98, 37353952952508192, 90336457, 90336463, 6, 640x360 
0x1382CA98, 37353952952825280, 90336490, 90336497, 7, 640x360 
0x1382CA98, 37353952953149944, 90336517, 90336522, 5, 640x360 
0x1382CA98, 37353952953470648, 90336548, 90336555, 7, 640x360 
0x1382CA98, 37353952953790384, 90336589, 90336593, 4, 640x360 
0x1382CA98, 37353952954153040, 90336652, 90336655, 3, 640x360 
0x1382CA98, 37353952954451264, 90336662, 90336668, 6, 640x360 
0x1382CA98, 37353952954904696, 90336703, 90336707, 4, 640x360 
0x1382CA98, 37353952955242232, 90336740, 90336747, 7, 640x360 
0x1382CA98, 37353952955580096, 90336780, 90336796, 16, 640x360 
0x1382CA98, 37353952955874376, 90336803, 90336812, 9, 640x360 
0x1382CA98, 37353952956202224, 90336830, 90336834, 4, 640x360 
0x1382CA98, 37353952956551752, 90336858, 90336861, 3, 640x360 
0x1382CA98, 37353952956846208, 90336892, 90336894, 2, 640x360 
0x1382CA98, 37353952957145992, 90336918, 90336931, 13, 640x360 
0x1382CA98, 37353952957469416, 90336951, 90336956, 5, 640x360 
0x1382CA98, 37353952957792904, 90336979, 90336984, 5, 640x360 
0x1382CA98, 37353952958119616, 90337020, 90337028, 8, 640x360 
0x1382CA98, 37353952958426328, 90337058, 90337060, 2, 640x360 
0x1382CA98, 37353952958906584, 90337100, 90337104, 4, 640x360 
0x1382CA98, 37353952959228120, 90337134, 90337137, 3, 640x360 
0x1382CA98, 37353952959557800, 90337160, 90337161, 1, 640x360 
0x1382CA98, 37353952959872448, 90337191, 90337196, 5, 640x360 
0x1382CA98, 37353952960184856, 90337224, 90337226, 2, 640x360 
0x1382CA98, 37353952960505736, 90337255, 90337263, 8, 640x360 
0x1382CA98, 37353952960825272, 90337290, 90337297, 7, 640x360 
0x1382CA98, 37353952961152280, 90337326, 90337333, 7, 640x360 
0x1382CA98, 37353952961464712, 90337345, 90337347, 2, 640x360 
0x1382CA98, 37353952961791128, 90337386, 90337395, 9, 640x360 
0x1382CA98, 37353952962110520, 90337421, 90337427, 6, 640x360 
0x1382CA98, 37353952962425744, 90337444, 90337446, 2, 640x360 
0x1382CA98, 37353952962904528, 90337501, 90337504, 3, 640x360 
0x1382CA98, 37353952963230280, 90337527, 90337529, 2, 640x360 
0x1382CA98, 37353952963556696, 90337567, 90337570, 3, 640x360 
0x1382CA98, 37353952963869552, 90337603, 90337605, 2, 640x360 
0x1382CA98, 37353952964189688, 90337625, 90337631, 6, 640x360 
0x1382CA98, 37353952964505416, 90337653, 90337656, 3, 640x360 
0x1382CA98, 37353952964825624, 90337688, 90337692, 4, 640x360 
0x1382CA98, 37353952965145520, 90337724, 90337733, 9, 640x360 
0x1382CA98, 37353952965467680, 90337764, 90337766, 2, 640x360 
0x1382CA98, 37353952965791888, 90337791, 90337794, 3, 640x360 
0x1382CA98, 37353952966111192, 90337826, 90337828, 2, 640x360 
0x1382CA98, 37353952966433768, 90337848, 90337871, 23, 640x360 
0x1382CA98, 37353952966903992, 90337901, 90337904, 3, 640x360 
0x1382CA98, 37353952967227416, 90337925, 90337927, 2, 640x360 
0x1382CA98, 37353952967543936, 90337958, 90337964, 6, 640x360 
0x1382CA98, 37353952967867408, 90337991, 90337994, 3, 640x360 
0x1382CA98, 37353952968214392, 90338037, 90338040, 3, 640x360 
0x1382CA98, 37353952968508816, 90338064, 90338071, 7, 640x360 
0x1382CA98, 37353952968825184, 90338097, 90338104, 7, 640x360 
0x1382CA98, 37353952969146744, 90338124, 90338126, 2, 640x360 
0x1382CA98, 37353952969464360, 90338149, 90338159, 10, 640x360 
0x1382CA98, 37353952969791520, 90338187, 90338194, 7, 640x360 
0x1382CA98, 37353952970110864, 90338230, 90338233, 3, 640x360 
0x1382CA98, 37353952970434344, 90338258, 90338263, 5, 640x360 
0x1382CA98, 37353952970910952, 90338311, 90338322, 11, 640x360 
0x1382CA98, 37353952971236728, 90338337, 90338341, 4, 640x360 
0x1382CA98, 37353952971548648, 90338373, 90338383, 10, 640x360 
0x1382CA98, 37353952971912704, 90338405, 90338413, 8, 640x360 
0x1382CA98, 37353952972225032, 90338429, 90338432, 3, 640x360 
0x1382CA98, 37353952972509648, 90338462, 90338464, 2, 640x360 
0x1382CA98, 37353952972835800, 90338492, 90338494, 2, 640x360 
0x1382CA98, 37353952973146144, 90338517, 90338529, 12, 640x360 
0x1382CA98, 37353952973466368, 90338547, 90338559, 12, 640x360 
0x1382CA98, 37353952973789824, 90338580, 90338584, 4, 640x360 
0x1382CA98, 37353952974110880, 90338612, 90338618, 6, 640x360 
0x1382CA98, 37353952974430736, 90338646, 90338650, 4, 640x360 
0x1382CA98, 37353952974763480, 90338677, 90338680, 3, 640x360 
0x1382CA98, 37353952975228040, 90338729, 90338732, 3, 640x360 
0x1382CA98, 37353952975546584, 90338757, 90338759, 2, 640x360 
0x1382CA98, 37353952975870760, 90338798, 90338803, 5, 640x360 
0x1382CA98, 37353952976184752, 90338831, 90338836, 5, 640x360 
0x1382CA98, 37353952976506280, 90338856, 90338858, 2, 640x360 
0x1382CA98, 37353952976834136, 90338891, 90338894, 3, 640x360 
0x1382CA98, 37353952977144184, 90338918, 90338928, 10, 640x360 
0x1382CA98, 37353952977467240, 90338946, 90338952, 6, 640x360 
0x1382CA98, 37353952977795664, 90338987, 90338993, 6, 640x360 
0x1382CA98, 37353952978126424, 90339018, 90339027, 9, 640x360 
0x1382CA98, 37353952978457936, 90339047, 90339051, 4, 640x360 
0x1382CA98, 37353952978745400, 90339086, 90339089, 3, 640x360 
0x1382CA98, 37353952979225720, 90339134, 90339137, 3, 640x360 
0x1382CA98, 37353952979556904, 90339160, 90339166, 6, 640x360 
0x1382CA98, 37353952979864808, 90339193, 90339194, 1, 640x360 
0x1382CA98, 37353952980189368, 90339222, 90339226, 4, 640x360 
0x1382CA98, 37353952980513936, 90339264, 90339269, 5, 640x360 
0x1382CA98, 37353952980824296, 90339289, 90339296, 7, 640x360 
0x1382CA98, 37353952981144240, 90339322, 90339328, 6, 640x360 
0x1382CA98, 37353952981468736, 90339345, 90339347, 2, 640x360 
0x1382CA98, 37353952981791600, 90339379, 90339383, 4, 640x360 
0x1382CA98, 37353952982113160, 90339413, 90339419, 6, 640x360 
0x1382CA98, 37353952982425832, 90339445, 90339447, 2, 640x360 
0x1382CA98, 37353952982745248, 90339479, 90339481, 2, 640x360 
0x1382CA98, 37353952983228840, 90339530, 90339534, 4, 640x360 
0x1382CA98, 37353952983548792, 90339559, 90339562, 3, 640x360 
0x1382CA98, 37353952983864504, 90339595, 90339597, 2, 640x360 
0x1382CA98, 37353952984204208, 90339625, 90339627, 2, 640x360 
0x1382CA98, 37353952984516896, 90339658, 90339660, 2, 640x360 
0x1382CA98, 37353952984828936, 90339692, 90339694, 2, 640x360 
0x1382CA98, 37353952985147168, 90339730, 90339732, 2, 640x360 
0x1382CA98, 37353952985466800, 90339751, 90339763, 12, 640x360 
0x1382CA98, 37353952985811120, 90339795, 90339800, 5, 640x360 
0x1382CA98, 37353952986113688, 90339814, 90339821, 7, 640x360 
0x1382CA98, 37353952986438752, 90339856, 90339859, 3, 640x360 
0x1382CA98, 37353952986754016, 90339882, 90339887, 5, 640x360 
0x1382CA98, 37353952987224160, 90339931, 90339934, 3, 640x360 
0x1382CA98, 37353952987543768, 90339968, 90339975, 7, 640x360 
0x1382CA98, 37353952987864192, 90339988, 90339997, 9, 640x360 
0x1382CA98, 37353952988202464, 90340029, 90340031, 2, 640x360 
0x1382CA98, 37353952988506496, 90340053, 90340055, 2, 640x360 
0x1382CA98, 37353952988824576, 90340084, 90340091, 7, 640x360 
0x1382CA98, 37353952989144048, 90340115, 90340128, 13, 640x360 
0x1382CA98, 37353952989465584, 90340148, 90340155, 7, 640x360 
0x1382CA98, 37353952989804856, 90340207, 90340211, 4, 640x360 
0x1382CA98, 37353952990114000, 90340228, 90340243, 15, 640x360 
0x1382CA98, 37353952990467232, 90340262, 90340273, 11, 640x360 
0x1382CA98, 37353952990744656, 90340286, 90340289, 3, 640x360 
0x1382CA98, 37353952991223184, 90340331, 90340336, 5, 640x360 
0x1382CA98, 37353952991551336, 90340364, 90340370, 6, 640x360 
0x1382CA98, 37353952991871232, 90340392, 90340394, 2, 640x360 
0x1382CA98, 37353952992190208, 90340425, 90340428, 3, 640x360 
0x1382CA98, 37353952992508016, 90340458, 90340464, 6, 640x360 
0x1382CA98, 37353952992827864, 90340490, 90340492, 2, 640x360 
0x1382CA98, 37353952993147704, 90340515, 90340533, 18, 640x360 
0x1382CA98, 37353952993494432, 90340560, 90340562, 2, 640x360 
0x1382CA98, 37353952993792896, 90340585, 90340597, 12, 640x360 
0x1382CA98, 37353952994148840, 90340617, 90340624, 7, 640x360 
0x1382CA98, 37353952994425168, 90340653, 90340663, 10, 640x360 
0x1382CA98, 37353952994743824, 90340674, 90340676, 2, 640x360 
0x1382CA98, 37353952995223128, 90340731, 90340736, 5, 640x360 
0x1382CA98, 37353952995547680, 90340768, 90340770, 2, 640x360 
0x1382CA98, 37353952995867480, 90340801, 90340804, 3, 640x360 
0x1382CA98, 37353952996189208, 90340823, 90340830, 7, 640x360 
0x1382CA98, 37353952996508104, 90340856, 90340858, 2, 640x360 
0x1382CA98, 37353952996826280, 90340889, 90340891, 2, 640x360 
0x1382CA98, 37353952997144160, 90340919, 90340923, 4, 640x360 
0x1382CA98, 37353952997478368, 90340955, 90340957, 2, 640x360 
0x1382CA98, 37353952997788736, 90340983, 90340995, 12, 640x360 
0x1382CA98, 37353952998144536, 90341027, 90341029, 2, 640x360 
0x1382CA98, 37353952998429776, 90341045, 90341047, 2, 640x360 
0x1382CA98, 37353952998772080, 90341082, 90341085, 3, 640x360 
0x1382CA98, 37353952999223144, 90341137, 90341141, 4, 640x360 
0x1382CA98, 37353952999548432, 90341154, 90341157, 3, 640x360 
0x1382CA98, 37353952999863016, 90341189, 90341192, 3, 640x360 
0x1382CA98, 37353953000188752, 90341234, 90341243, 9, 640x360 
0x1382CA98, 37353953000514920, 90341255, 90341263, 8, 640x360 
0x1382CA98, 37353953000824304, 90341298, 90341305, 7, 640x360 
0x1382CA98, 37353953001146184, 90341333, 90341337, 4, 640x360 
0x1382CA98, 37353953001467416, 90341355, 90341359, 4, 640x360 
0x1382CA98, 37353953001784384, 90341380, 90341386, 6, 640x360 
0x1382CA98, 37353953002110608, 90341414, 90341420, 6, 640x360 
0x1382CA98, 37353953002433488, 90341444, 90341446, 2, 640x360 
0x1382CA98, 37353953002744280, 90341476, 90341479, 3, 640x360 
0x1382CA98, 37353953003064376, 90341509, 90341513, 4, 640x360 
0x1382CA98, 37353953003543520, 90341569, 90341572, 3, 640x360 
0x1382CA98, 37353953003868792, 90341593, 90341602, 9, 640x360 
0x1382CA98, 37353953004189176, 90341630, 90341632, 2, 640x360 
0x1382CA98, 37353953004551920, 90341659, 90341662, 3, 640x360 
0x1382CA98, 37353953004855240, 90341695, 90341696, 1, 640x360 
0x1382CA98, 37353953005169256, 90341718, 90341732, 14, 640x360 
0x1382CA98, 37353953005499504, 90341756, 90341759, 3, 640x360 
0x1382CA98, 37353953005789632, 90341787, 90341794, 7, 640x360 
0x1382CA98, 37353953006107248, 90341814, 90341823, 9, 640x360 
0x1382CA98, 37353953006468232, 90341849, 90341860, 11, 640x360 
0x1382CA98, 37353953006744096, 90341878, 90341881, 3, 640x360 
0x1382CA98, 37353953007063616, 90341913, 90341916, 3, 640x360 
0x1382CA98, 37353953007543472, 90341963, 90341965, 2, 640x360 
0x1382CA98, 37353953007865064, 90341992, 90341994, 2, 640x360 
0x1382CA98, 37353953008199880, 90342028, 90342033, 5, 640x360 
0x1382CA98, 37353953008654448, 90342101, 90342113, 12, 640x360 
0x1382CA98, 37353953009179552, 90342163, 90342176, 13, 640x360 
0x1382CA98, 37353953009596712, 90342181, 90342190, 9, 640x360 
0x1382CA98, 37353953009790944, 90342203, 90342212, 9, 640x360 
0x1382CA98, 37353953010124840, 90342234, 90342237, 3, 640x360 
0x1382CA98, 37353953010427424, 90342259, 90342261, 2, 640x360 
0x1382CA98, 37353953010743792, 90342289, 90342292, 3, 640x360 
0x1382CA98, 37353953011063408, 90342317, 90342321, 4, 640x360 
0x1382CA98, 37353953011543544, 90342358, 90342365, 7, 640x360 
0x1382CA98, 37353953011864528, 90342390, 90342403, 13, 640x360 
0x1382CA98, 37353953012188248, 90342423, 90342425, 2, 640x360 
0x1382CA98, 37353953012506920, 90342464, 90342470, 6, 640x360 
0x1382CA98, 37353953012826800, 90342495, 90342497, 2, 640x360 
0x1382CA98, 37353953013148152, 90342520, 90342530, 10, 640x360 
0x1382CA98, 37353953013474840, 90342556, 90342564, 8, 640x360 
0x1382CA98, 37353953013800632, 90342589, 90342600, 11, 640x360 
0x1382CA98, 37353953014106720, 90342612, 90342614, 2, 640x360 
0x1382CA98, 37353953014424912, 90342654, 90342656, 2, 640x360 
0x1382CA98, 37353953014749016, 90342685, 90342688, 3, 640x360 
0x1382CA98, 37353953015063416, 90342718, 90342723, 5, 640x360 
0x1382CA98, 37353953015542600, 90342762, 90342763, 1, 640x360 
0x1382CA98, 37353953015862560, 90342801, 90342804, 3, 640x360 
0x1382CA98, 37353953016184776, 90342824, 90342829, 5, 640x360 
0x1382CA98, 37353953016506752, 90342856, 90342858, 2, 640x360 
0x1382CA98, 37353953016827160, 90342889, 90342895, 6, 640x360 
0x1382CA98, 37353953017147520, 90342915, 90342923, 8, 640x360 
0x1382CA98, 37353953017465856, 90342947, 90342952, 5, 640x360 
0x1382CA98, 37353953017783760, 90342986, 90342989, 3, 640x360 
0x1382CA98, 37353953018106080, 90343017, 90343020, 3, 640x360 
0x1382CA98, 37353953018429704, 90343042, 90343045, 3, 640x360 
0x1382CA98, 37353953018768568, 90343080, 90343084, 4, 640x360 
0x1382CA98, 37353953019078488, 90343112, 90343114, 2, 640x360 
0x1382CA98, 37353953019549664, 90343158, 90343167, 9, 640x360 
0x1382CA98, 37353953019866376, 90343190, 90343201, 11, 640x360 
0x1382CA98, 37353953020189152, 90343236, 90343244, 8, 640x360 
0x1382CA98, 37353953020507280, 90343258, 90343261, 3, 640x360 
0x1382CA98, 37353953020827008, 90343284, 90343293, 9, 640x360 
0x1382CA98, 37353953021156288, 90343325, 90343327, 2, 640x360 
0x1382CA98, 37353953021463768, 90343352, 90343359, 7, 640x360 
0x1382CA98, 37353953021785864, 90343376, 90343379, 3, 640x360 
0x1382CA98, 37353953022106416, 90343419, 90343422, 3, 640x360 
0x1382CA98, 37353953022427536, 90343444, 90343447, 3, 640x360 
0x1382CA98, 37353953022743912, 90343481, 90343485, 4, 640x360 
0x1382CA98, 37353953023064144, 90343514, 90343518, 4, 640x360 
0x1382CA98, 37353953023542880, 90343553, 90343560, 7, 640x360 
0x1382CA98, 37353953023863664, 90343590, 90343597, 7, 640x360 
0x1382CA98, 37353953024182776, 90343627, 90343633, 6, 640x360 
0x1382CA98, 37353953024503456, 90343666, 90343672, 6, 640x360 
0x1382CA98, 37353953024834936, 90343689, 90343692, 3, 640x360 
0x1382CA98, 37353953025151056, 90343723, 90343730, 7, 640x360 
0x1382CA98, 37353953025464024, 90343754, 90343757, 3, 640x360 
0x1382CA98, 37353953025787448, 90343782, 90343793, 11, 640x360 
0x1382CA98, 37353953026108984, 90343814, 90343820, 6, 640x360 
0x1382CA98, 37353953026428840, 90343846, 90343848, 2, 640x360 
0x1382CA98, 37353953026742928, 90343878, 90343881, 3, 640x360 
0x1382CA98, 37353953027067792, 90343907, 90343909, 2, 640x360 
0x1382CA98, 37353953027546704, 90343963, 90343965, 2, 640x360 
0x1382CA98, 37353953027864872, 90343990, 90343998, 8, 640x360 
0x1382CA98, 37353953028182928, 90344037, 90344040, 3, 640x360 
0x1382CA98, 37353953028508456, 90344060, 90344068, 8, 640x360 
0x1382CA98, 37353953028822616, 90344086, 90344089, 3, 640x360 
0x1382CA98, 37353953029155264, 90344119, 90344125, 6, 640x360 
0x1382CA98, 37353953029463696, 90344158, 90344161, 3, 640x360 
0x1382CA98, 37353953029795400, 90344181, 90344187, 6, 640x360 
0x1382CA98, 37353953030109632, 90344213, 90344228, 15, 640x360 
0x1382CA98, 37353953030423936, 90344251, 90344255, 4, 640x360 
0x1382CA98, 37353953030743144, 90344278, 90344286, 8, 640x360 
0x1382CA98, 37353953031067960, 90344319, 90344326, 7, 640x360 
0x1382CA98, 37353953031383064, 90344351, 90344354, 3, 640x360 
0x1382CA98, 37353953031862216, 90344396, 90344400, 4, 640x360 
0x1382CA98, 37353953032188256, 90344423, 90344427, 4, 640x360 
0x1382CA98, 37353953032506432, 90344463, 90344466, 3, 640x360 
0x1382CA98, 37353953032824720, 90344485, 90344493, 8, 640x360 
0x1382CA98, 37353953033144832, 90344520, 90344527, 7, 640x360 
0x1382CA98, 37353953033463568, 90344553, 90344560, 7, 640x360 
0x1382CA98, 37353953033785784, 90344586, 90344592, 6, 640x360 
0x1382CA98, 37353953034115512, 90344612, 90344615, 3, 640x360 
0x1382CA98, 37353953034431440, 90344644, 90344646, 2, 640x360 
0x1382CA98, 37353953034742552, 90344676, 90344679, 3, 640x360 
0x1382CA98, 37353953035063616, 90344709, 90344716, 7, 640x360 
0x1382CA98, 37353953035396048, 90344745, 90344747, 2, 640x360 
0x1382CA98, 37353953035863304, 90344795, 90344796, 1, 640x360 
0x1382CA98, 37353953036182504, 90344823, 90344825, 2, 640x360 
0x1382CA98, 37353953036502736, 90344856, 90344858, 2, 640x360 
0x1382CA98, 37353953036822960, 90344893, 90344895, 2, 640x360 
0x1382CA98, 37353953037142704, 90344922, 90344924, 2, 640x360 
0x1382CA98, 37353953037465120, 90344945, 90344954, 9, 640x360 
0x1382CA98, 37353953037783480, 90344985, 90344987, 2, 640x360 
0x1382CA98, 37353953038104808, 90345014, 90345017, 3, 640x360 
0x1382CA98, 37353953038427056, 90345046, 90345049, 3, 640x360 
0x1382CA98, 37353953038753944, 90345080, 90345084, 4, 640x360 
0x1382CA98, 37353953039063312, 90345107, 90345110, 3, 640x360 
0x1382CA98, 37353953039387176, 90345147, 90345150, 3, 640x360 
0x1382CA98, 37353953039871336, 90345190, 90345195, 5, 640x360 
0x1382CA98, 37353953040205624, 90345229, 90345232, 3, 640x360 
0x1382CA98, 37353953040518120, 90345263, 90345265, 2, 640x360 
0x1382CA98, 37353953040827256, 90345288, 90345295, 7, 640x360 
0x1382CA98, 37353953041142464, 90345330, 90345333, 3, 640x360 
0x1382CA98, 37353953041479656, 90345360, 90345362, 2, 640x360 
0x1382CA98, 37353953041785440, 90345390, 90345396, 6, 640x360 
0x1382CA98, 37353953042110096, 90345412, 90345415, 3, 640x360 
0x1382CA98, 37353953042422648, 90345446, 90345459, 13, 640x360 
0x1382CA98, 37353953042742392, 90345482, 90345491, 9, 640x360 
0x1382CA98, 37353953043062560, 90345515, 90345521, 6, 640x360 
0x1382CA98, 37353953043391336, 90345562, 90345564, 2, 640x360 
0x1382CA98, 37353953043862664, 90345592, 90345594, 2, 640x360 
0x1382CA98, 37353953044188280, 90345622, 90345624, 2, 640x360 
0x1382CA98, 37353953044505000, 90345662, 90345664, 2, 640x360 
0x1382CA98, 37353953044834120, 90345692, 90345694, 2, 640x360 
0x1382CA98, 37353953045150360, 90345724, 90345732, 8, 640x360 
0x1382CA98, 37353953045472960, 90345755, 90345765, 10, 640x360 
0x1382CA98, 37353953045805952, 90345793, 90345800, 7, 640x360 
0x1382CA98, 37353953046111864, 90345814, 90345817, 3, 640x360 
0x1382CA98, 37353953046424152, 90345852, 90345854, 2, 640x360 
0x1382CA98, 37353953046745368, 90345886, 90345889, 3, 640x360 
0x1382CA98, 37353953047077640, 90345913, 90345920, 7, 640x360 
0x1382CA98, 37353953047382824, 90345939, 90345946, 7, 640x360 
0x1382CA98, 37353953047867704, 90345998, 90346003, 5, 640x360 
0x1382CA98, 37353953048183464, 90346026, 90346028, 2, 640x360 
0x1382CA98, 37353953048505376, 90346058, 90346060, 2, 640x360 
0x1382CA98, 37353953048822952, 90346088, 90346090, 2, 640x360 
0x1382CA98, 37353953049142808, 90346123, 90346130, 7, 640x360 
0x1382CA98, 37353953049464608, 90346145, 90346148, 3, 640x360 
0x1382CA98, 37353953049785984, 90346185, 90346188, 3, 640x360 
0x1382CA98, 37353953050112480, 90346214, 90346217, 3, 640x360 
0x1382CA98, 37353953050424920, 90346245, 90346247, 2, 640x360 
0x1382CA98, 37353953050767488, 90346288, 90346292, 4, 640x360 
0x1382CA98, 37353953051063712, 90346309, 90346312, 3, 640x360 
0x1382CA98, 37353953051383840, 90346343, 90346345, 2, 640x360 
0x1382CA98, 37353953051865648, 90346396, 90346400, 4, 640x360 
0x1382CA98, 37353953052187400, 90346433, 90346443, 10, 640x360 
0x1382CA98, 37353953052504352, 90346467, 90346470, 3, 640x360 
0x1382CA98, 37353953052821688, 90346488, 90346490, 2, 640x360 
0x1382CA98, 37353953053149392, 90346523, 90346531, 8, 640x360 
0x1382CA98, 37353953053463144, 90346554, 90346556, 2, 640x360 
0x1382CA98, 37353953053790208, 90346587, 90346590, 3, 640x360 
0x1382CA98, 37353953054114944, 90346615, 90346621, 6, 640x360 
0x1382CA98, 37353953054423776, 90346646, 90346650, 4, 640x360 
0x1382CA98, 37353953054742616, 90346685, 90346687, 2, 640x360 
0x1382CA98, 37353953055127048, 90346725, 90346735, 10, 640x360 
0x1382CA98, 37353953055408048, 90346752, 90346763, 11, 640x360 
0x1382CA98, 37353953055866992, 90346807, 90346811, 4, 640x360 
0x1382CA98, 37353953056183728, 90346824, 90346833, 9, 640x360 
0x1382CA98, 37353953056514680, 90346869, 90346873, 4, 640x360 
0x1382CA98, 37353953056840520, 90346924, 90346938, 14, 640x360 
0x1382CA98, 37353953057151312, 90346938, 90346944, 6, 640x360 
0x1382CA98, 37353953057470280, 90346964, 90346976, 12, 640x360 
0x1382CA98, 37353953057839352, 90347023, 90347030, 7, 640x360 
0x1382CA98, 37353953058136816, 90347030, 90347077, 47, 640x360 
0x1382CA98, 37353953058494992, 90347078, 90347082, 4, 640x360 
0x1382CA98, 37353953058833640, 90347111, 90347134, 23, 640x360 
0x1382CA98, 37353953059145952, 90347140, 90347144, 4, 640x360 
0x1382CA98, 37353953059467496, 90347168, 90347191, 23, 640x360 
0x1382CA98, 37353953059707824, 90347197, 90347203, 6, 640x360 
0x1382CA98, 37353953060219272, 90347241, 90347246, 5, 640x360 
0x1382CA98, 37353953060511864, 90347280, 90347309, 29, 640x360 
0x1382CA98, 37353953060846256, 90347313, 90347335, 22, 640x360 
0x1382CA98, 37353953061207584, 90347364, 90347383, 19, 640x360 
0x1382CA98, 37353953061483336, 90347385, 90347393, 8, 640x360 
0x1382CA98, 37353953061813144, 90347401, 90347423, 22, 640x360 
0x1382CA98, 37353953062150552, 90347444, 90347446, 2, 640x360 
0x1382CA98, 37353953062448400, 90347477, 90347489, 12, 640x360 
0x1382CA98, 37353953062755080, 90347520, 90347525, 5, 640x360 
0x1382CA98, 37353953063102800, 90347526, 90347538, 12, 640x360 
0x1382CA98, 37353953063387352, 90347562, 90347569, 7, 640x360 
0x1382CA98, 37353953063735504, 90347595, 90347597, 2, 640x360 
0x1382CA98, 37353953064206512, 90347635, 90347640, 5, 640x360 
0x1382CA98, 37353953064514304, 90347670, 90347675, 5, 640x360 
0x1382CA98, 37353953064824120, 90347702, 90347706, 4, 640x360 
0x1382CA98, 37353953065154936, 90347721, 90347725, 4, 640x360 
0x1382CA98, 37353953065462528, 90347752, 90347760, 8, 640x360 
0x1382CA98, 37353953065789560, 90347790, 90347796, 6, 640x360 
0x1382CA98, 37353953066109472, 90347822, 90347825, 3, 640x360 
0x1382CA98, 37353953066433440, 90347850, 90347861, 11, 640x360 
0x1382CA98, 37353953066743280, 90347881, 90347887, 6, 640x360 
0x1382CA98, 37353953067061888, 90347918, 90347926, 8, 640x360 
0x1382CA98, 37353953067387184, 90347955, 90347957, 2, 640x360 
0x1382CA98, 37353953067703536, 90347975, 90347978, 3, 640x360 
0x1382CA98, 37353953068186032, 90348024, 90348032, 8, 640x360 
0x1382CA98, 37353953068502176, 90348063, 90348068, 5, 640x360 
0x1382CA98, 37353953068834832, 90348089, 90348092, 3, 640x360 
0x1382CA98, 37353953069141880, 90348114, 90348121, 7, 640x360 
0x1382CA98, 37353953069462256, 90348156, 90348158, 2, 640x360 
0x1382CA98, 37353953069785624, 90348182, 90348194, 12, 640x360 
0x1382CA98, 37353953070114568, 90348214, 90348226, 12, 640x360 
0x1382CA98, 37353953070422440, 90348245, 90348248, 3, 640x360 
0x1382CA98, 37353953070741696, 90348278, 90348280, 2, 640x360 
0x1382CA98, 37353953071062432, 90348319, 90348329, 10, 640x360 
0x1382CA98, 37353953071398960, 90348358, 90348360, 2, 640x360 
0x1382CA98, 37353953071703232, 90348374, 90348377, 3, 640x360 
0x1382CA98, 37353953072188040, 90348424, 90348433, 9, 640x360 
0x1382CA98, 37353953072508648, 90348458, 90348464, 6, 640x360 
0x1382CA98, 37353953072822928, 90348489, 90348499, 10, 640x360 
0x1382CA98, 37353953073141760, 90348526, 90348528, 2, 640x360 
0x1382CA98, 37353953073462128, 90348555, 90348558, 3, 640x360 
0x1382CA98, 37353953073781800, 90348587, 90348590, 3, 640x360 
0x1382CA98, 37353953074113856, 90348624, 90348630, 6, 640x360 
0x1382CA98, 37353953074435136, 90348657, 90348660, 3, 640x360 
0x1382CA98, 37353953074741368, 90348693, 90348702, 9, 640x360 
0x1382CA98, 37353953075073584, 90348726, 90348729, 3, 640x360 
0x1382CA98, 37353953075386736, 90348762, 90348768, 6, 640x360 
0x1382CA98, 37353953075728480, 90348792, 90348794, 2, 640x360 
0x1382CA98, 37353953076188560, 90348829, 90348831, 2, 640x360 
0x1382CA98, 37353953076501936, 90348863, 90348869, 6, 640x360 
0x1382CA98, 37353953076823864, 90348887, 90348890, 3, 640x360 
0x1382CA98, 37353953077146680, 90348924, 90348926, 2, 640x360 
0x1382CA98, 37353953077463560, 90348947, 90348954, 7, 640x360 
0x1382CA98, 37353953077786616, 90348979, 90348982, 3, 640x360 
0x1382CA98, 37353953078108192, 90349017, 90349028, 11, 640x360 
0x1382CA98, 37353953124021656, 90353606, 90353608, 2, 640x360 
0x1382CA98, 37353953124350648, 90353641, 90353643, 2, 640x360 
0x1382CA98, 37353953124820816, 90353683, 90353691, 8, 640x360 
0x1382CA98, 37353953125139856, 90353730, 90353732, 2, 640x360 
0x1382CA98, 37353953125460024, 90353747, 90353750, 3, 640x360 
0x1382CA98, 37353953125786496, 90353785, 90353793, 8, 640x360 
0x1382CA98, 37353953126102792, 90353828, 90353833, 5, 640x360 
0x1382CA98, 37353953126421072, 90353854, 90353856, 2, 640x360 
0x1382CA98, 37353953126740624, 90353885, 90353888, 3, 640x360 
0x1382CA98, 37353953127067520, 90353919, 90353921, 2, 640x360 
0x1382CA98, 37353953127379984, 90353943, 90353948, 5, 640x360 
0x1382CA98, 37353953127709408, 90353986, 90353988, 2, 640x360 
0x1382CA98, 37353953128021672, 90354013, 90354021, 8, 640x360 
0x1382CA98, 37353953128363736, 90354048, 90354061, 13, 640x360 
0x1382CA98, 37353953128826512, 90354086, 90354093, 7, 640x360 
0x1382CA98, 37353953129144544, 90354118, 90354134, 16, 640x360 
0x1382CA98, 37353953129465240, 90354159, 90354165, 6, 640x360 
0x1382CA98, 37353953129788368, 90354191, 90354193, 2, 640x360 
0x1382CA98, 37353953130103720, 90354224, 90354227, 3, 640x360 
0x1382CA98, 37353953130420784, 90354254, 90354256, 2, 640x360 
0x1382CA98, 37353953130744024, 90354288, 90354290, 2, 640x360 
0x1382CA98, 37353953131063472, 90354312, 90354314, 2, 640x360 
0x1382CA98, 37353953131379976, 90354350, 90354353, 3, 640x360 
0x1382CA98, 37353953131712416, 90354378, 90354380, 2, 640x360 
0x1382CA98, 37353953132027208, 90354420, 90354422, 2, 640x360 
0x1382CA98, 37353953132344568, 90354447, 90354451, 4, 640x360 
0x1382CA98, 37353953132840984, 90354503, 90354506, 3, 640x360 
0x1382CA98, 37353953133158072, 90354527, 90354535, 8, 640x360 
0x1382CA98, 37353953133461560, 90354573, 90354583, 10, 640x360 
0x1382CA98, 37353953133810752, 90354592, 90354594, 2, 640x360 
0x1382CA98, 37353953134121480, 90354614, 90354617, 3, 640x360 
0x1382CA98, 37353953134443032, 90354652, 90354654, 2, 640x360 
0x1382CA98, 37353953134739864, 90354675, 90354683, 8, 640x360 
0x1382CA98, 37353953135063560, 90354713, 90354716, 3, 640x360 
0x1382CA98, 37353953135381184, 90354749, 90354763, 14, 640x360 
0x1382CA98, 37353953135707744, 90354775, 90354777, 2, 640x360 
0x1382CA98, 37353953136020216, 90354819, 90354822, 3, 640x360 
0x1382CA98, 37353953136344120, 90354846, 90354852, 6, 640x360 
0x1382CA98, 37353953136819720, 90354895, 90354897, 2, 640x360 
0x1382CA98, 37353953137143552, 90354914, 90354920, 6, 640x360 
0x1382CA98, 37353953137465208, 90354948, 90354962, 14, 640x360 
0x1382CA98, 37353953137784424, 90354982, 90354989, 7, 640x360 
0x1382CA98, 37353953138118584, 90355020, 90355022, 2, 640x360 
0x1382CA98, 37353953138423720, 90355057, 90355063, 6, 640x360 
0x1382CA98, 37353953138739864, 90355086, 90355088, 2, 640x360 
0x1382CA98, 37353953139059768, 90355108, 90355110, 2, 640x360 
0x1382CA98, 37353953139383904, 90355143, 90355152, 9, 640x360 
0x1382CA98, 37353953139708336, 90355178, 90355185, 7, 640x360 
0x1382CA98, 37353953140019824, 90355219, 90355222, 3, 640x360 
0x1382CA98, 37353953140340776, 90355244, 90355247, 3, 640x360 
0x1382CA98, 37353953140659936, 90355269, 90355277, 8, 640x360 
0x1382CA98, 37353953141139984, 90355318, 90355323, 5, 640x360 
0x1382CA98, 37353953141464432, 90355345, 90355347, 2, 640x360 
0x1382CA98, 37353953141783824, 90355387, 90355395, 8, 640x360 
0x1382CA98, 37353953142106952, 90355425, 90355430, 5, 640x360 
0x1382CA98, 37353953142424984, 90355447, 90355454, 7, 640x360 
0x1382CA98, 37353953142740016, 90355482, 90355492, 10, 640x360 
0x1382CA98, 37353953143059704, 90355513, 90355515, 2, 640x360 
0x1382CA98, 37353953143379672, 90355543, 90355545, 2, 640x360 
0x1382CA98, 37353953143716856, 90355586, 90355589, 3, 640x360 
0x1382CA98, 37353953144029960, 90355607, 90355610, 3, 640x360 
0x1382CA98, 37353953144344880, 90355641, 90355644, 3, 640x360 
0x1382CA98, 37353953144660112, 90355674, 90355676, 2, 640x360 
0x1382CA98, 37353953145139552, 90355726, 90355735, 9, 640x360 
0x1382CA98, 37353953145462176, 90355748, 90355763, 15, 640x360 
0x1382CA98, 37353953145789864, 90355790, 90355792, 2, 640x360 
0x1382CA98, 37353953146112360, 90355814, 90355818, 4, 640x360 
0x1382CA98, 37353953146419976, 90355846, 90355853, 7, 640x360 
0x1382CA98, 37353953146739480, 90355886, 90355894, 8, 640x360 
0x1382CA98, 37353953147059760, 90355913, 90355916, 3, 640x360 
0x1382CA98, 37353953147379416, 90355942, 90355946, 4, 640x360 
0x1382CA98, 37353953147702728, 90355980, 90355982, 2, 640x360 
0x1382CA98, 37353953148028752, 90356017, 90356020, 3, 640x360 
0x1382CA98, 37353953148341328, 90356041, 90356043, 2, 640x360 
0x1382CA98, 37353953148663528, 90356075, 90356077, 2, 640x360 
0x1382CA98, 37353953149143704, 90356119, 90356121, 2, 640x360 
0x1382CA98, 37353953149459224, 90356145, 90356148, 3, 640x360 
0x1382CA98, 37353953149782424, 90356185, 90356189, 4, 640x360 
0x1382CA98, 37353953150103704, 90356213, 90356216, 3, 640x360 
0x1382CA98, 37353953150420064, 90356245, 90356247, 2, 640x360 
0x1382CA98, 37353953150745280, 90356287, 90356290, 3, 640x360 
0x1382CA98, 37353953151062296, 90356310, 90356312, 2, 640x360 
0x1382CA98, 37353953151379784, 90356346, 90356348, 2, 640x360 
0x1382CA98, 37353953151700848, 90356374, 90356380, 6, 640x360 
0x1382CA98, 37353953152021480, 90356419, 90356422, 3, 640x360 
0x1382CA98, 37353953152340488, 90356440, 90356442, 2, 640x360 
0x1382CA98, 37353953152660808, 90356466, 90356469, 3, 640x360 
0x1382CA98, 37353953153140224, 90356516, 90356520, 4, 640x360 
0x1382CA98, 37353953153460640, 90356544, 90356546, 2, 640x360 
0x1382CA98, 37353953153806800, 90356595, 90356602, 7, 640x360 
0x1382CA98, 37353953154124832, 90356628, 90356631, 3, 640x360 
0x1382CA98, 37353953154423824, 90356658, 90356661, 3, 640x360 
0x1382CA98, 37353953154769800, 90356706, 90356712, 6, 640x360 
0x1382CA98, 37353953155064856, 90356720, 90356724, 4, 640x360 
0x1382CA98, 37353953155380960, 90356756, 90356759, 3, 640x360 
0x1382CA98, 37353953155699752, 90356785, 90356789, 4, 640x360 
0x1382CA98, 37353953156020512, 90356813, 90356815, 2, 640x360 
0x1382CA98, 37353953156340816, 90356844, 90356846, 2, 640x360 
0x1382CA98, 37353953156664384, 90356882, 90356886, 4, 640x360 
0x1382CA98, 37353953157139376, 90356926, 90356936, 10, 640x360 
0x1382CA98, 37353953157468608, 90356954, 90356957, 3, 640x360 
0x1382CA98, 37353953157785080, 90356997, 90357006, 9, 640x360 
0x1382CA98, 37353953158130304, 90357026, 90357030, 4, 640x360 
0x1382CA98, 37353953158421032, 90357060, 90357062, 2, 640x360 
0x1382CA98, 37353953158739016, 90357101, 90357105, 4, 640x360 
0x1382CA98, 37353953159061360, 90357126, 90357128, 2, 640x360 
0x1382CA98, 37353953159379536, 90357149, 90357154, 5, 640x360 
0x1382CA98, 37353953159717048, 90357191, 90357194, 3, 640x360 
0x1382CA98, 37353953160027856, 90357222, 90357230, 8, 640x360 
0x1382CA98, 37353953160340408, 90357257, 90357267, 10, 640x360 
0x1382CA98, 37353953160666824, 90357278, 90357280, 2, 640x360 
0x1382CA98, 37353953161139128, 90357328, 90357331, 3, 640x360 
0x1382CA98, 37353953161460376, 90357360, 90357362, 2, 640x360 
0x1382CA98, 37353953161791896, 90357394, 90357396, 2, 640x360 
0x1382CA98, 37353953162117152, 90357429, 90357431, 2, 640x360 
0x1382CA98, 37353953162420832, 90357450, 90357461, 11, 640x360 
0x1382CA98, 37353953162741136, 90357488, 90357497, 9, 640x360 
0x1382CA98, 37353953163064008, 90357512, 90357520, 8, 640x360 
0x1382CA98, 37353953163379432, 90357547, 90357552, 5, 640x360 
0x1382CA98, 37353953163699648, 90357579, 90357581, 2, 640x360 
0x1382CA98, 37353953164019848, 90357616, 90357621, 5, 640x360 
0x1382CA98, 37353953164339408, 90357638, 90357641, 3, 640x360 
0x1382CA98, 37353953164662000, 90357674, 90357676, 2, 640x360 
0x1382CA98, 37353953164985072, 90357702, 90357707, 5, 640x360 
0x1382CA98, 37353953165463320, 90357751, 90357757, 6, 640x360 
0x1382CA98, 37353953165791136, 90357788, 90357796, 8, 640x360 
0x1382CA98, 37353953166103144, 90357820, 90357824, 4, 640x360 
0x1382CA98, 37353953166427840, 90357857, 90357864, 7, 640x360 
0x1382CA98, 37353953166744480, 90357897, 90357905, 8, 640x360 
0x1382CA98, 37353953167068248, 90357927, 90357930, 3, 640x360 
0x1382CA98, 37353953167385960, 90357948, 90357962, 14, 640x360 
0x1382CA98, 37353953167726968, 90357986, 90357988, 2, 640x360 
0x1382CA98, 37353953168019328, 90358015, 90358020, 5, 640x360 
0x1382CA98, 37353953168342328, 90358055, 90358059, 4, 640x360 
0x1382CA98, 37353953168666440, 90358080, 90358102, 22, 640x360 
0x1382CA98, 37353953168988704, 90358128, 90358137, 9, 640x360 
0x1382CA98, 37353953169490096, 90358159, 90358162, 3, 640x360 
0x1382CA98, 37353953169783464, 90358197, 90358205, 8, 640x360 
0x1382CA98, 37353953170116416, 90358222, 90358230, 8, 640x360 
0x1382CA98, 37353953170420096, 90358264, 90358273, 9, 640x360 
0x1382CA98, 37353953170739264, 90358301, 90358305, 4, 640x360 
0x1382CA98, 37353953171069352, 90358325, 90358327, 2, 640x360 
0x1382CA98, 37353953171380128, 90358347, 90358349, 2, 640x360 
0x1382CA98, 37353953171704808, 90358378, 90358380, 2, 640x360 
0x1382CA98, 37353953172019152, 90358416, 90358423, 7, 640x360 
0x1382CA98, 37353953172345496, 90358446, 90358449, 3, 640x360 
0x1382CA98, 37353953172675664, 90358480, 90358484, 4, 640x360 
0x1382CA98, 37353953172988944, 90358512, 90358516, 4, 640x360 
0x1382CA98, 37353953173529600, 90358571, 90358579, 8, 640x360 
0x1382CA98, 37353953173790264, 90358591, 90358607, 16, 640x360 
0x1382CA98, 37353953174123248, 90358628, 90358630, 2, 640x360 
0x1382CA98, 37353953174419584, 90358648, 90358651, 3, 640x360 
0x1382CA98, 37353953174738928, 90358675, 90358680, 5, 640x360 
0x1382CA98, 37353953175058592, 90358722, 90358725, 3, 640x360 
0x1382CA98, 37353953175386016, 90358756, 90358762, 6, 640x360 
0x1382CA98, 37353953175710912, 90358788, 90358796, 8, 640x360 
0x1382CA98, 37353953176022592, 90358807, 90358822, 15, 640x360 
0x1382CA98, 37353953176341472, 90358845, 90358854, 9, 640x360 
0x1382CA98, 37353953176668432, 90358877, 90358879, 2, 640x360 
0x1382CA98, 37353953176998928, 90358911, 90358915, 4, 640x360 
0x1382CA98, 37353953177459712, 90358966, 90358979, 13, 640x360 
0x1382CA98, 37353953177813248, 90359003, 90359007, 4, 640x360 
0x1382CA98, 37353953178103448, 90359022, 90359025, 3, 640x360 
0x1382CA98, 37353953178435896, 90359043, 90359046, 3, 640x360 
0x1382CA98, 37353953178738496, 90359076, 90359079, 3, 640x360 
0x1382CA98, 37353953179062544, 90359121, 90359124, 3, 640x360 
0x1382CA98, 37353953179382848, 90359146, 90359157, 11, 640x360 
0x1382CA98, 37353953179707360, 90359181, 90359184, 3, 640x360 
0x1382CA98, 37353953180031872, 90359228, 90359230, 2, 640x360 
0x1382CA98, 37353953180350344, 90359243, 90359245, 2, 640x360 
0x1382CA98, 37353953180659288, 90359275, 90359276, 1, 640x360 
0x1382CA98, 37353953180978984, 90359300, 90359310, 10, 640x360 
0x1382CA98, 37353953181462440, 90359349, 90359360, 11, 640x360 
0x1382CA98, 37353953181781384, 90359384, 90359388, 4, 640x360 
0x1382CA98, 37353953182115720, 90359420, 90359426, 6, 640x360 
0x1382CA98, 37353953182449648, 90359454, 90359462, 8, 640x360 
0x1382CA98, 37353953182738920, 90359479, 90359483, 4, 640x360 
0x1382CA98, 37353953183058744, 90359511, 90359513, 2, 640x360 
0x1382CA98, 37353953183378904, 90359544, 90359546, 2, 640x360 
0x1382CA98, 37353953183699248, 90359581, 90359583, 2, 640x360 
0x1382CA98, 37353953184019536, 90359607, 90359609, 2, 640x360 
0x1382CA98, 37353953184339928, 90359638, 90359640, 2, 640x360 
0x1382CA98, 37353953184664264, 90359674, 90359681, 7, 640x360 
0x1382CA98, 37353953184980248, 90359706, 90359708, 2, 640x360 
0x1382CA98, 37353953185462352, 90359747, 90359750, 3, 640x360 
0x1382CA98, 37353953185778592, 90359779, 90359781, 2, 640x360 
0x1382CA98, 37353953186103952, 90359811, 90359813, 2, 640x360 
0x1382CA98, 37353953186424728, 90359855, 90359872, 17, 640x360 
0x1382CA98, 37353953186750048, 90359892, 90359896, 4, 640x360 
0x1382CA98, 37353953187060816, 90359914, 90359918, 4, 640x360 
0x1382CA98, 37353953187384184, 90359955, 90359958, 3, 640x360 
0x1382CA98, 37353953187699072, 90359979, 90359982, 3, 640x360 
0x1382CA98, 37353953188019136, 90360015, 90360020, 5, 640x360 
0x1382CA98, 37353953188350024, 90360057, 90360061, 4, 640x360 
0x1382CA98, 37353953188664696, 90360088, 90360097, 9, 640x360 
0x1382CA98, 37353953188997344, 90360121, 90360125, 4, 640x360 
0x1382CA98, 37353953189471968, 90360157, 90360160, 3, 640x360 
0x1382CA98, 37353953189792696, 90360197, 90360204, 7, 640x360 
0x1382CA98, 37353953190106936, 90360237, 90360240, 3, 640x360 
0x1382CA98, 37353953190419296, 90360266, 90360279, 13, 640x360 
0x1382CA98, 37353953190738560, 90360296, 90360302, 6, 640x360 
0x1382CA98, 37353953191059368, 90360318, 90360323, 5, 640x360 
0x1382CA98, 37353953191388280, 90360349, 90360362, 13, 640x360 
0x1382CA98, 37353953191708424, 90360439, 90360451, 12, 640x360 
0x1382CA98, 37353953192341888, 90360452, 90360458, 6, 640x360 
0x1382CA98, 37353953192674456, 90360484, 90360500, 16, 640x360 
0x1382CA98, 37353953192979416, 90360510, 90360531, 21, 640x360 
0x1382CA98, 37353953193313896, 90360556, 90360558, 2, 640x360 
0x1382CA98, 37353953193785944, 90360593, 90360595, 2, 640x360 
0x1382CA98, 37353953194110032, 90360620, 90360627, 7, 640x360 
0x1382CA98, 37353953194419240, 90360670, 90360672, 2, 640x360 
0x1382CA98, 37353953194742376, 90360685, 90360688, 3, 640x360 
0x1382CA98, 37353953195065216, 90360714, 90360716, 2, 640x360 
0x1382CA98, 37353953195382144, 90360741, 90360744, 3, 640x360 
0x1382CA98, 37353953195707096, 90360783, 90360787, 4, 640x360 
0x1382CA98, 37353953196018448, 90360807, 90360809, 2, 640x360 
0x1382CA98, 37353953196344600, 90360847, 90360850, 3, 640x360 
0x1382CA98, 37353953196658704, 90360874, 90360875, 1, 640x360 
0x1382CA98, 37353953196979208, 90360906, 90360908, 2, 640x360 
0x1382CA98, 37353953197307192, 90360928, 90360933, 5, 640x360 
0x1382CA98, 37353953197781520, 90360979, 90360982, 3, 640x360 
0x1382CA98, 37353953198116160, 90361012, 90361017, 5, 640x360 
0x1382CA98, 37353953198423144, 90361063, 90361066, 3, 640x360 
0x1382CA98, 37353953198741168, 90361080, 90361089, 9, 640x360 
0x1382CA98, 37353953199062640, 90361117, 90361125, 8, 640x360 
0x1382CA98, 37353953199392408, 90361147, 90361161, 14, 640x360 
0x1382CA98, 37353953199710304, 90361184, 90361195, 11, 640x360 
0x1382CA98, 37353953200035528, 90361219, 90361222, 3, 640x360 
0x1382CA98, 37353953200343072, 90361242, 90361249, 7, 640x360 
0x1382CA98, 37353953200663536, 90361275, 90361277, 2, 640x360 
0x1382CA98, 37353953200978224, 90361299, 90361304, 5, 640x360 
0x1382CA98, 37353953201321112, 90361345, 90361347, 2, 640x360 
0x1382CA98, 37353953201788968, 90361385, 90361389, 4, 640x360 
0x1382CA98, 37353953202102896, 90361413, 90361416, 3, 640x360 
0x1382CA98, 37353953202418752, 90361455, 90361462, 7, 640x360 
0x1382CA98, 37353953202737752, 90361486, 90361488, 2, 640x360 
0x1382CA98, 37353953203062080, 90361519, 90361522, 3, 640x360 
0x1382CA98, 37353953203378440, 90361542, 90361544, 2, 640x360 
0x1382CA98, 37353953203698096, 90361579, 90361581, 2, 640x360 
0x1382CA98, 37353953204024536, 90361610, 90361612, 2, 640x360 
0x1382CA98, 37353953204342808, 90361638, 90361642, 4, 640x360 
0x1382CA98, 37353953204662504, 90361666, 90361677, 11, 640x360 
0x1382CA98, 37353953204982000, 90361697, 90361702, 5, 640x360 
0x1382CA98, 37353953205298880, 90361734, 90361740, 6, 640x360 
0x1382CA98, 37353953205789792, 90361780, 90361784, 4, 640x360 
0x1382CA98, 37353953206109080, 90361811, 90361813, 2, 640x360 
0x1382CA98, 37353953206422848, 90361844, 90361846, 2, 640x360 
0x1382CA98, 37353953206738832, 90361876, 90361879, 3, 640x360 
0x1382CA98, 37353953207058448, 90361912, 90361914, 2, 640x360 
0x1382CA98, 37353953207382120, 90361945, 90361947, 2, 640x360 
0x1382CA98, 37353953207698920, 90361973, 90361977, 4, 640x360 
0x1382CA98, 37353953208018624, 90362018, 90362031, 13, 640x360 
0x1382CA98, 37353953208343624, 90362050, 90362062, 12, 640x360 
0x1382CA98, 37353953208666000, 90362080, 90362094, 14, 640x360 
0x1382CA98, 37353953208988552, 90362125, 90362146, 21, 640x360 
0x1382CA98, 37353953209335944, 90362161, 90362169, 8, 640x360 
0x1382CA98, 37353953209790216, 90362203, 90362239, 36, 640x360 
0x1382CA98, 37353953210118800, 90362257, 90362271, 14, 640x360 
0x1382CA98, 37353953210490000, 90362272, 90362280, 8, 640x360 
0x1382CA98, 37353953210813128, 90362299, 90362303, 4, 640x360 
0x1382CA98, 37353953211058200, 90362318, 90362321, 3, 640x360 
0x1382CA98, 37353953211379048, 90362344, 90362346, 2, 640x360 
0x1382CA98, 37353953211714688, 90362380, 90362383, 3, 640x360 
0x1382CA98, 37353953212029760, 90362407, 90362413, 6, 640x360 
0x1382CA98, 37353953212348056, 90362442, 90362444, 2, 640x360 
0x1382CA98, 37353953212679832, 90362480, 90362482, 2, 640x360 
0x1382CA98, 37353953212986672, 90362514, 90362516, 2, 640x360 
0x1382CA98, 37353953213303896, 90362538, 90362544, 6, 640x360 
0x1382CA98, 37353953213803928, 90362584, 90362588, 4, 640x360 
0x1382CA98, 37353953214098840, 90362609, 90362611, 2, 640x360 
0x1382CA98, 37353953214418144, 90362655, 90362658, 3, 640x360 
0x1382CA98, 37353953214743776, 90362687, 90362691, 4, 640x360 
0x1382CA98, 37353953215057920, 90362724, 90362726, 2, 640x360 
0x1382CA98, 37353953215377520, 90362744, 90362756, 12, 640x360 
0x1382CA98, 37353953215702648, 90362775, 90362778, 3, 640x360 
0x1382CA98, 37353953216025176, 90362814, 90362818, 4, 640x360 
0x1382CA98, 37353953216355360, 90362852, 90362858, 6, 640x360 
0x1382CA98, 37353953216659816, 90362881, 90362883, 2, 640x360 
0x1382CA98, 37353953216978096, 90362912, 90362914, 2, 640x360 
0x1382CA98, 37353953217334632, 90362942, 90362944, 2, 640x360 
0x1382CA98, 37353953217785592, 90362986, 90362990, 4, 640x360 
0x1382CA98, 37353953218100184, 90363027, 90363031, 4, 640x360 
0x1382CA98, 37353953218421664, 90363059, 90363062, 3, 640x360 
0x1382CA98, 37353953218737216, 90363090, 90363092, 2, 640x360 
0x1382CA98, 37353953219057608, 90363119, 90363121, 2, 640x360 
0x1382CA98, 37353953219392752, 90363148, 90363162, 14, 640x360 
0x1382CA98, 37353953219708672, 90363188, 90363191, 3, 640x360 
0x1382CA98, 37353953220021960, 90363215, 90363222, 7, 640x360 
0x1382CA98, 37353953220338808, 90363241, 90363250, 9, 640x360 
0x1382CA98, 37353953220660952, 90363275, 90363279, 4, 640x360 
0x1382CA98, 37353953220981512, 90363306, 90363315, 9, 640x360 
0x1382CA98, 37353953221311168, 90363342, 90363350, 8, 640x360 
0x1382CA98, 37353953221626360, 90363373, 90363376, 3, 640x360 
0x1382CA98, 37353953222112168, 90363415, 90363426, 11, 640x360 
0x1382CA98, 37353953222418856, 90363459, 90363462, 3, 640x360 
0x1382CA98, 37353953222743256, 90363476, 90363480, 4, 640x360 
0x1382CA98, 37353953223057312, 90363513, 90363517, 4, 640x360 
0x1382CA98, 37353953223393528, 90363552, 90363554, 2, 640x360 
0x1382CA98, 37353953223698728, 90363574, 90363580, 6, 640x360 
0x1382CA98, 37353953224017736, 90363608, 90363611, 3, 640x360 
0x1382CA98, 37353953224337608, 90363643, 90363645, 2, 640x360 
0x1382CA98, 37353953224658528, 90363678, 90363681, 3, 640x360 
0x1382CA98, 37353953224987752, 90363708, 90363716, 8, 640x360 
0x1382CA98, 37353953225303256, 90363737, 90363740, 3, 640x360 
0x1382CA98, 37353953225629656, 90363763, 90363766, 3, 640x360 
0x1382CA98, 37353953226100704, 90363818, 90363823, 5, 640x360 
0x1382CA98, 37353953226421704, 90363850, 90363860, 10, 640x360 
0x1382CA98, 37353953226738256, 90363881, 90363888, 7, 640x360 
0x1382CA98, 37353953227065208, 90363921, 90363928, 7, 640x360 
0x1382CA98, 37353953227378760, 90363953, 90363960, 7, 640x360 
0x1382CA98, 37353953227702344, 90363973, 90363976, 3, 640x360 
0x1382CA98, 37353953228020000, 90364013, 90364016, 3, 640x360 
0x1382CA98, 37353953228341424, 90364044, 90364050, 6, 640x360 
0x1382CA98, 37353953228657232, 90364070, 90364078, 8, 640x360 
0x1382CA98, 37353953228977976, 90364112, 90364115, 3, 640x360 
0x1382CA98, 37353953229304896, 90364145, 90364147, 2, 640x360 
0x1382CA98, 37353953229626304, 90364180, 90364181, 1, 640x360 
0x1382CA98, 37353953230103344, 90364216, 90364220, 4, 640x360 
0x1382CA98, 37353953230423248, 90364244, 90364246, 2, 640x360 
0x1382CA98, 37353953230813352, 90364285, 90364288, 3, 640x360 
0x1382CA98, 37353953231057904, 90364314, 90364323, 9, 640x360 
0x1382CA98, 37353953231404768, 90364344, 90364346, 2, 640x360 
0x1382CA98, 37353953231708768, 90364375, 90364384, 9, 640x360 
0x1382CA98, 37353953232020656, 90364409, 90364415, 6, 640x360 
0x1382CA98, 37353953232341504, 90364437, 90364440, 3, 640x360 
0x1382CA98, 37353953232657568, 90364469, 90364478, 9, 640x360 
0x1382CA98, 37353953232981776, 90364512, 90364514, 2, 640x360 
0x1382CA98, 37353953233298240, 90364533, 90364538, 5, 640x360 
0x1382CA98, 37353953233623800, 90364573, 90364579, 6, 640x360 
0x1382CA98, 37353953234099400, 90364623, 90364625, 2, 640x360 
0x1382CA98, 37353953234417432, 90364652, 90364656, 4, 640x360 
0x1382CA98, 37353953234737200, 90364689, 90364692, 3, 640x360 
0x1382CA98, 37353953235060320, 90364708, 90364711, 3, 640x360 
0x1382CA98, 37353953235377560, 90364751, 90364755, 4, 640x360 
0x1382CA98, 37353953235701144, 90364785, 90364788, 3, 640x360 
0x1382CA98, 37353953236017248, 90364806, 90364809, 3, 640x360 
0x1382CA98, 37353953236357864, 90364846, 90364849, 3, 640x360 
0x1382CA98, 37353953236657904, 90364877, 90364880, 3, 640x360 
0x1382CA98, 37353953236983072, 90364913, 90364916, 3, 640x360 
0x1382CA98, 37353953237314520, 90364943, 90364945, 2, 640x360 
0x1382CA98, 37353953237639624, 90364978, 90364981, 3, 640x360 
0x1382CA98, 37353953238124368, 90365021, 90365037, 16, 640x360 
0x1382CA98, 37353953238475912, 90365081, 90365087, 6, 640x360 
0x1382CA98, 37353953238820088, 90365118, 90365129, 11, 640x360 
0x1382CA98, 37353953239139144, 90365142, 90365163, 21, 640x360 
0x1382CA98, 37353953239464928, 90365163, 90365174, 11, 640x360 
0x1382CA98, 37353953239708960, 90365208, 90365222, 14, 640x360 
0x1382CA98, 37353953240020296, 90365228, 90365239, 11, 640x360 
0x1382CA98, 37353953240346544, 90365248, 90365293, 45, 640x360 
0x1382CA98, 37353953240675888, 90365293, 90365311, 18, 640x360 
0x1382CA98, 37353953241041744, 90365331, 90365334, 3, 640x360 
0x1382CA98, 37353953241309824, 90365344, 90365354, 10, 640x360 
0x1382CA98, 37353953241628072, 90365381, 90365387, 6, 640x360 
0x1382CA98, 37353953242097672, 90365422, 90365425, 3, 640x360 
0x1382CA98, 37353953242421824, 90365455, 90365467, 12, 640x360 
0x1382CA98, 37353953242744864, 90365490, 90365493, 3, 640x360 
0x1382CA98, 37353953243061976, 90365536, 90365546, 10, 640x360 
0x1382CA98, 37353953243385104, 90365556, 90365569, 13, 640x360 
0x1382CA98, 37353953243697008, 90365576, 90365580, 4, 640x360 
0x1382CA98, 37353953244021688, 90365609, 90365617, 8, 640x360 
0x1382CA98, 37353953244337464, 90365643, 90365646, 3, 640x360 
0x1382CA98, 37353953244657112, 90365683, 90365693, 10, 640x360 
0x1382CA98, 37353953244981320, 90365711, 90365717, 6, 640x360 
0x1382CA98, 37353953245310048, 90365744, 90365745, 1, 640x360 
0x1382CA98, 37353953245629424, 90365773, 90365776, 3, 640x360 
0x1382CA98, 37353953245950264, 90365806, 90365808, 2, 640x360 
0x1382CA98, 37353953246469752, 90365856, 90365859, 3, 640x360 
0x1382CA98, 37353953246737080, 90365881, 90365895, 14, 640x360 
0x1382CA98, 37353953247059096, 90365914, 90365922, 8, 640x360 
0x1382CA98, 37353953247395736, 90365947, 90365961, 14, 640x360 
0x1382CA98, 37353953247702096, 90365980, 90365983, 3, 640x360 
0x1382CA98, 37353953248019576, 90366009, 90366012, 3, 640x360 
0x1382CA98, 37353953248351016, 90366044, 90366046, 2, 640x360 
0x1382CA98, 37353953248677792, 90366079, 90366081, 2, 640x360 
0x1382CA98, 37353953248995816, 90366114, 90366127, 13, 640x360 
0x1382CA98, 37353953249366352, 90366147, 90366175, 28, 640x360 
0x1382CA98, 37353953249657376, 90366193, 90366195, 2, 640x360 
0x1382CA98, 37353953250007680, 90366217, 90366222, 5, 640x360 
0x1382CA98, 37353953250419536, 90366257, 90366260, 3, 640x360 
0x1382CA98, 37353953250736488, 90366297, 90366304, 7, 640x360 
0x1382CA98, 37353953251058560, 90366339, 90366351, 12, 640x360 
0x1382CA98, 37353953251387552, 90366358, 90366361, 3, 640x360 
0x1382CA98, 37353953251698776, 90366379, 90366385, 6, 640x360 
0x1382CA98, 37353953252033128, 90366417, 90366429, 12, 640x360 
0x1382CA98, 37353953252339792, 90366451, 90366457, 6, 640x360 
0x1382CA98, 37353953252681456, 90366479, 90366481, 2, 640x360 
0x1382CA98, 37353953252987160, 90366510, 90366512, 2, 640x360 
0x1382CA98, 37353953253307616, 90366532, 90366539, 7, 640x360 
0x1382CA98, 37353953253623144, 90366573, 90366582, 9, 640x360 
0x1382CA98, 37353953253944488, 90366610, 90366613, 3, 640x360 
0x1382CA98, 37353953254425408, 90366657, 90366662, 5, 640x360 
0x1382CA98, 37353953254751536, 90366684, 90366690, 6, 640x360 
0x1382CA98, 37353953255062176, 90366711, 90366713, 2, 640x360 
0x1382CA98, 37353953255384976, 90366744, 90366746, 2, 640x360 
0x1382CA98, 37353953255701552, 90366773, 90366786, 13, 640x360 
0x1382CA98, 37353953256023248, 90366809, 90366811, 2, 640x360 
0x1382CA98, 37353953256337384, 90366851, 90366854, 3, 640x360 
0x1382CA98, 37353953256660888, 90366875, 90366884, 9, 640x360 
0x1382CA98, 37353953256976840, 90366896, 90366899, 3, 640x360 
0x1382CA98, 37353953257304792, 90366933, 90366937, 4, 640x360 
0x1382CA98, 37353953257624144, 90366968, 90366972, 4, 640x360 
0x1382CA98, 37353953257947632, 90367014, 90367024, 10, 640x360 
0x1382CA98, 37353953258428104, 90367065, 90367073, 8, 640x360 
0x1382CA98, 37353953258748160, 90367102, 90367113, 11, 640x360 
0x1382CA98, 37353953259058032, 90367121, 90367135, 14, 640x360 
0x1382CA98, 37353953259393440, 90367157, 90367160, 3, 640x360 
0x1382CA98, 37353953259703064, 90367178, 90367182, 4, 640x360 
0x1382CA98, 37353953260019384, 90367216, 90367229, 13, 640x360 
0x1382CA98, 37353953260341568, 90367248, 90367262, 14, 640x360 
0x1382CA98, 37353953260661192, 90367284, 90367297, 13, 640x360 
0x1382CA98, 37353953260979880, 90367311, 90367373, 62, 640x360 
0x1382CA98, 37353953261308688, 90367382, 90367396, 14, 640x360 
0x1382CA98, 37353953261738520, 90367428, 90367442, 14, 640x360 
0x1382CA98, 37353953262081000, 90367445, 90367450, 5, 640x360 
0x1382CA98, 37353953262498488, 90367469, 90367475, 6, 640x360 
0x1382CA98, 37353953262766248, 90367502, 90367521, 19, 640x360 
0x1382CA98, 37353953263073016, 90367557, 90367563, 6, 640x360 
0x1382CA98, 37353953263400184, 90367574, 90367602, 28, 640x360 
0x1382CA98, 37353953263722792, 90367602, 90367606, 4, 640x360 
0x1382CA98, 37353953264021888, 90367619, 90367627, 8, 640x360 
0x1382CA98, 37353953264342432, 90367647, 90367662, 15, 640x360 
0x1382CA98, 37353953264657520, 90367684, 90367694, 10, 640x360 
0x1382CA98, 37353953264986632, 90367715, 90367720, 5, 640x360 
0x1382CA98, 37353953265303000, 90367742, 90367744, 2, 640x360 
0x1382CA98, 37353953265622736, 90367777, 90367779, 2, 640x360 
0x1382CA98, 37353953265950504, 90367806, 90367808, 2, 640x360 
0x1382CA98, 37353953266417544, 90367866, 90367879, 13, 640x360 
0x1382CA98, 37353953266736336, 90367892, 90367903, 11, 640x360 
0x1382CA98, 37353953267058144, 90367936, 90367939, 3, 640x360 
0x1382CA98, 37353953267380008, 90367953, 90367956, 3, 640x360 
0x1382CA98, 37353953267704488, 90367976, 90367978, 2, 640x360 
0x1382CA98, 37353953268025480, 90368008, 90368015, 7, 640x360 
0x1382CA98, 37353953268336408, 90368039, 90368042, 3, 640x360 
0x1382CA98, 37353953268656456, 90368067, 90368071, 4, 640x360 
0x1382CA98, 37353953268989088, 90368114, 90368120, 6, 640x360 
0x1382CA98, 37353953269311472, 90368146, 90368149, 3, 640x360 
0x1382CA98, 37353953269624912, 90368181, 90368187, 6, 640x360 
0x1382CA98, 37353953269945744, 90368200, 90368204, 4, 640x360 
0x1382CA98, 37353953270415744, 90368250, 90368258, 8, 640x360 
0x1382CA98, 37353953270736040, 90368280, 90368282, 2, 640x360 
0x1382CA98, 37353953271065496, 90368309, 90368312, 3, 640x360 
0x1382CA98, 37353953271391920, 90368356, 90368359, 3, 640x360 
0x1382CA98, 37353953271699928, 90368373, 90368379, 6, 640x360 
0x1382CA98, 37353953272023176, 90368421, 90368428, 7, 640x360 
0x1382CA98, 37353953272338712, 90368442, 90368444, 2, 640x360 
0x1382CA98, 37353953272665136, 90368480, 90368485, 5, 640x360 
0x1382CA98, 37353953272976472, 90368500, 90368509, 9, 640x360 
0x1382CA98, 37353953273305776, 90368534, 90368537, 3, 640x360 
0x1382CA98, 37353953273630960, 90368566, 90368571, 5, 640x360 
0x1382CA98, 37353953273936960, 90368601, 90368605, 4, 640x360 
0x1382CA98, 37353953274285368, 90368630, 90368634, 4, 640x360 
0x1382CA98, 37353953274741384, 90368687, 90368690, 3, 640x360 
0x1382CA98, 37353953275059672, 90368708, 90368711, 3, 640x360 
0x1382CA98, 37353953275380216, 90368740, 90368746, 6, 640x360 
0x1382CA98, 37353953275696560, 90368786, 90368788, 2, 640x360 
0x1382CA98, 37353953276017560, 90368810, 90368816, 6, 640x360 
0x1382CA98, 37353953276340864, 90368841, 90368846, 5, 640x360 
0x1382CA98, 37353953276658632, 90368873, 90368875, 2, 640x360 
0x1382CA98, 37353953276979696, 90368907, 90368910, 3, 640x360 
0x1382CA98, 37353953277301088, 90368932, 90368938, 6, 640x360 
0x1382CA98, 37353953277623112, 90368964, 90368967, 3, 640x360 
0x1382CA98, 37353953277964176, 90368997, 90369001, 4, 640x360 
0x1382CA98, 37353953278257528, 90369028, 90369030, 2, 640x360 
0x1382CA98, 37353953278735800, 90369083, 90369088, 5, 640x360 
0x1382CA98, 37353953279063360, 90369114, 90369117, 3, 640x360 
0x1382CA98, 37353953279376152, 90369142, 90369144, 2, 640x360 
0x1382CA98, 37353953279705064, 90369182, 90369187, 5, 640x360 
0x1382CA98, 37353953280025320, 90369206, 90369220, 14, 640x360 
0x1382CA98, 37353953280342376, 90369271, 90369278, 7, 640x360 
0x1382CA98, 37353953280658864, 90369286, 90369291, 5, 640x360 
0x1382CA98, 37353953280979904, 90369306, 90369309, 3, 640x360 
0x1382CA98, 37353953281302120, 90369334, 90369339, 5, 640x360 
0x1382CA98, 37353953281624712, 90369366, 90369370, 4, 640x360 
0x1382CA98, 37353953281937640, 90369400, 90369404, 4, 640x360 
0x1382CA98, 37353953282272016, 90369428, 90369431, 3, 640x360 
0x1382CA98, 37353953282740104, 90369486, 90369488, 2, 640x360 
0x1382CA98, 37353953283059016, 90369519, 90369521, 2, 640x360 
0x1382CA98, 37353953283376136, 90369543, 90369545, 2, 640x360 
0x1382CA98, 37353953283696608, 90369576, 90369578, 2, 640x360 
0x1382CA98, 37353953284016176, 90369608, 90369610, 2, 640x360 
0x1382CA98, 37353953284352632, 90369642, 90369646, 4, 640x360 
0x1382CA98, 37353953284658608, 90369672, 90369681, 9, 640x360 
0x1382CA98, 37353953284976592, 90369696, 90369699, 3, 640x360 
0x1382CA98, 37353953285300664, 90369730, 90369734, 4, 640x360 
0x1382CA98, 37353953285622016, 90369776, 90369782, 6, 640x360 
0x1382CA98, 37353953285953264, 90369804, 90369806, 2, 640x360 
0x1382CA98, 37353953286256312, 90369836, 90369843, 7, 640x360 
0x1382CA98, 37353953286735864, 90369879, 90369882, 3, 640x360 
0x1382CA98, 37353953287061416, 90369908, 90369911, 3, 640x360 
0x1382CA98, 37353953287380368, 90369950, 90369956, 6, 640x360 
0x1382CA98, 37353953287699800, 90369980, 90369984, 4, 640x360 
0x1382CA98, 37353953288018544, 90370008, 90370014, 6, 640x360 
0x1382CA98, 37353953288338624, 90370040, 90370042, 2, 640x360 
0x1382CA98, 37353953288659264, 90370075, 90370084, 9, 640x360 
0x1382CA98, 37353953288976880, 90370106, 90370108, 2, 640x360 
0x1382CA98, 37353953289297552, 90370136, 90370141, 5, 640x360 
0x1382CA98, 37353953289616560, 90370165, 90370179, 14, 640x360 
0x1382CA98, 37353953289955456, 90370201, 90370208, 7, 640x360 
0x1382CA98, 37353953290257224, 90370236, 90370240, 4, 640x360 
0x1382CA98, 37353953290738632, 90370289, 90370291, 2, 640x360 
0x1382CA98, 37353953291059624, 90370317, 90370322, 5, 640x360 
0x1382CA98, 37353953291386152, 90370343, 90370346, 3, 640x360 
0x1382CA98, 37353953291698232, 90370375, 90370381, 6, 640x360 
0x1382CA98, 37353953292019512, 90370407, 90370409, 2, 640x360 
0x1382CA98, 37353953292340128, 90370446, 90370448, 2, 640x360 
0x1382CA98, 37353953292656448, 90370471, 90370474, 3, 640x360 
0x1382CA98, 37353953292979656, 90370501, 90370505, 4, 640x360 
0x1382CA98, 37353953293297184, 90370539, 90370542, 3, 640x360 
0x1382CA98, 37353953293617800, 90370564, 90370567, 3, 640x360 
0x1382CA98, 37353953293971736, 90370597, 90370601, 4, 640x360 
0x1382CA98, 37353953294268400, 90370629, 90370632, 3, 640x360 
0x1382CA98, 37353953294739464, 90370682, 90370691, 9, 640x360 
0x1382CA98, 37353953295058952, 90370719, 90370722, 3, 640x360 
0x1382CA98, 37353953295379752, 90370743, 90370745, 2, 640x360 
0x1382CA98, 37353953295696584, 90370773, 90370783, 10, 640x360 
0x1382CA98, 37353953296020984, 90370813, 90370820, 7, 640x360 
0x1382CA98, 37353953296336032, 90370841, 90370844, 3, 640x360 
0x1382CA98, 37353953296665800, 90370865, 90370872, 7, 640x360 
0x1382CA98, 37353953296976032, 90370910, 90370912, 2, 640x360 
0x1382CA98, 37353953297301384, 90370941, 90370946, 5, 640x360 
0x1382CA98, 37353953297622864, 90370973, 90370980, 7, 640x360 
0x1382CA98, 37353953297950528, 90371005, 90371007, 2, 640x360 
0x1382CA98, 37353953298267672, 90371030, 90371033, 3, 640x360 
0x1382CA98, 37353953298740312, 90371086, 90371093, 7, 640x360 
0x1382CA98, 37353953299055288, 90371114, 90371117, 3, 640x360 
0x1382CA98, 37353953299380864, 90371143, 90371146, 3, 640x360 
0x1382CA98, 37353953299695688, 90371180, 90371182, 2, 640x360 
0x1382CA98, 37353953300023032, 90371216, 90371221, 5, 640x360 
0x1382CA98, 37353953300335472, 90371245, 90371251, 6, 640x360 
0x1382CA98, 37353953300659880, 90371266, 90371280, 14, 640x360 
0x1382CA98, 37353953300981712, 90371306, 90371308, 2, 640x360 
0x1382CA98, 37353953301300920, 90371338, 90371342, 4, 640x360 
0x1382CA98, 37353953301619360, 90371374, 90371376, 2, 640x360 
0x1382CA98, 37353953301942136, 90371407, 90371420, 13, 640x360 
0x1382CA98, 37353953302262584, 90371440, 90371443, 3, 640x360 
0x1382CA98, 37353953302579200, 90371468, 90371477, 9, 640x360 
0x1382CA98, 37353953303059008, 90371513, 90371516, 3, 640x360 
0x1382CA98, 37353953303375256, 90371541, 90371543, 2, 640x360 
0x1382CA98, 37353953303704872, 90371574, 90371577, 3, 640x360 
0x1382CA98, 37353953304015312, 90371622, 90371624, 2, 640x360 
0x1382CA98, 37353953304335408, 90371638, 90371643, 5, 640x360 
0x1382CA98, 37353953304655648, 90371676, 90371683, 7, 640x360 
0x1382CA98, 37353953304975528, 90371707, 90371711, 4, 640x360 
0x1382CA98, 37353953305305352, 90371744, 90371752, 8, 640x360 
0x1382CA98, 37353953305616760, 90371764, 90371771, 7, 640x360 
0x1382CA98, 37353953305940928, 90371802, 90371811, 9, 640x360 
0x1382CA98, 37353953306255496, 90371838, 90371841, 3, 640x360 
0x1382CA98, 37353953306576656, 90371870, 90371873, 3, 640x360 
0x1382CA98, 37353953307055192, 90371915, 90371918, 3, 640x360 
0x1382CA98, 37353953307375592, 90371941, 90371944, 3, 640x360 
0x1382CA98, 37353953307711272, 90371975, 90371978, 3, 640x360 
0x1382CA98, 37353953308021504, 90372010, 90372012, 2, 640x360 
0x1382CA98, 37353953308346848, 90372043, 90372044, 1, 640x360 
0x1382CA98, 37353953308659464, 90372074, 90372077, 3, 640x360 
0x1382CA98, 37353953308990016, 90372102, 90372105, 3, 640x360 
0x1382CA98, 37353953309300568, 90372134, 90372143, 9, 640x360 
0x1382CA98, 37353953309616008, 90372165, 90372169, 4, 640x360 
0x1382CA98, 37353953309942848, 90372196, 90372198, 2, 640x360 
0x1382CA98, 37353953310256112, 90372231, 90372236, 5, 640x360 
0x1382CA98, 37353953310582088, 90372264, 90372274, 10, 640x360 
0x1382CA98, 37353953311055360, 90372325, 90372327, 2, 640x360 
0x1382CA98, 37353953311375480, 90372366, 90372372, 6, 640x360 
0x1382CA98, 37353953311723104, 90372389, 90372398, 9, 640x360 
0x1382CA98, 37353953312015016, 90372415, 90372424, 9, 640x360 
0x1382CA98, 37353953312336176, 90372447, 90372455, 8, 640x360 
0x1382CA98, 37353953312656288, 90372473, 90372475, 2, 640x360 
0x1382CA98, 37353953312975096, 90372502, 90372510, 8, 640x360 
0x1382CA98, 37353953313307672, 90372535, 90372539, 4, 640x360 
0x1382CA98, 37353953313624728, 90372563, 90372566, 3, 640x360 
0x1382CA98, 37353953313940960, 90372596, 90372598, 2, 640x360 
0x1382CA98, 37353953314259504, 90372635, 90372637, 2, 640x360 
0x1382CA98, 37353953314576096, 90372670, 90372673, 3, 640x360 
0x1382CA98, 37353953315055288, 90372707, 90372713, 6, 640x360 
0x1382CA98, 37353953315375744, 90372739, 90372745, 6, 640x360 
0x1382CA98, 37353953315695216, 90372770, 90372773, 3, 640x360 
0x1382CA98, 37353953316015664, 90372808, 90372810, 2, 640x360 
0x1382CA98, 37353953316336200, 90372841, 90372847, 6, 640x360 
0x1382CA98, 37353953316656320, 90372868, 90372872, 4, 640x360 
0x1382CA98, 37353953316979176, 90372896, 90372902, 6, 640x360 
0x1382CA98, 37353953317295624, 90372938, 90372942, 4, 640x360 
0x1382CA98, 37353953317616224, 90372966, 90372974, 8, 640x360 
0x1382CA98, 37353953317941472, 90373001, 90373007, 6, 640x360 
0x1382CA98, 37353953318266544, 90373027, 90373029, 2, 640x360 
0x1382CA98, 37353953318579704, 90373066, 90373071, 5, 640x360 
0x1382CA98, 37353953319058888, 90373114, 90373116, 2, 640x360 
0x1382CA98, 37353953319378912, 90373145, 90373148, 3, 640x360 
0x1382CA98, 37353953319699600, 90373185, 90373188, 3, 640x360 
0x1382CA98, 37353953320020136, 90373209, 90373215, 6, 640x360 
0x1382CA98, 37353953320335536, 90373240, 90373243, 3, 640x360 
0x1382CA98, 37353953320655960, 90373269, 90373272, 3, 640x360 
0x1382CA98, 37353953320978976, 90373299, 90373305, 6, 640x360 
0x1382CA98, 37353953321297000, 90373331, 90373341, 10, 640x360 
0x1382CA98, 37353953321616088, 90373368, 90373375, 7, 640x360 
0x1382CA98, 37353953321941792, 90373402, 90373410, 8, 640x360 
0x1382CA98, 37353953322256936, 90373431, 90373446, 15, 640x360 
0x1382CA98, 37353953322578672, 90373470, 90373477, 7, 640x360 
0x1382CA98, 37353953323060512, 90373513, 90373514, 1, 640x360 
0x1382CA98, 37353953323374968, 90373542, 90373544, 2, 640x360 
0x1382CA98, 37353953323694592, 90373576, 90373578, 2, 640x360 
0x1382CA98, 37353953324014712, 90373615, 90373618, 3, 640x360 
0x1382CA98, 37353953324342440, 90373646, 90373648, 2, 640x360 
0x1382CA98, 37353953324657528, 90373686, 90373691, 5, 640x360 
0x1382CA98, 37353953324975888, 90373705, 90373708, 3, 640x360 
0x1382CA98, 37353953325295824, 90373740, 90373751, 11, 640x360 
0x1382CA98, 37353953325620968, 90373775, 90373777, 2, 640x360 
0x1382CA98, 37353953325945392, 90373796, 90373800, 4, 640x360 
0x1382CA98, 37353953326254928, 90373836, 90373839, 3, 640x360 
0x1382CA98, 37353953326575104, 90373870, 90373873, 3, 640x360 
0x1382CA98, 37353953326912024, 90373896, 90373898, 2, 640x360 
0x1382CA98, 37353953327378504, 90373937, 90373944, 7, 640x360 
0x1382CA98, 37353953327694480, 90373977, 90373987, 10, 640x360 
0x1382CA98, 37353953328018432, 90374007, 90374011, 4, 640x360 
0x1382CA98, 37353953328334432, 90374043, 90374045, 2, 640x360 
0x1382CA98, 37353953328662592, 90374074, 90374076, 2, 640x360 
0x1382CA98, 37353953328974600, 90374102, 90374105, 3, 640x360 
0x1382CA98, 37353953329299936, 90374133, 90374138, 5, 640x360 
0x1382CA98, 37353953329615656, 90374166, 90374170, 4, 640x360 
0x1382CA98, 37353953329938528, 90374198, 90374201, 3, 640x360 
0x1382CA98, 37353953330260024, 90374230, 90374232, 2, 640x360 
0x1382CA98, 37353953330589464, 90374262, 90374264, 2, 640x360 
0x1382CA98, 37353953330902072, 90374291, 90374293, 2, 640x360 
0x1382CA98, 37353953331375544, 90374345, 90374347, 2, 640x360 
0x1382CA98, 37353953331695072, 90374374, 90374377, 3, 640x360 
0x1382CA98, 37353953332015376, 90374406, 90374409, 3, 640x360 
0x1382CA98, 37353953332335616, 90374436, 90374442, 6, 640x360 
0x1382CA98, 37353953332655696, 90374466, 90374476, 10, 640x360 
0x1382CA98, 37353953332975408, 90374498, 90374502, 4, 640x360 
0x1382CA98, 37353953333297384, 90374529, 90374532, 3, 640x360 
0x1382CA98, 37353953333620464, 90374563, 90374575, 12, 640x360 
0x1382CA98, 37353953333945704, 90374595, 90374597, 2, 640x360 
0x1382CA98, 37353953334257112, 90374631, 90374643, 12, 640x360 
0x1382CA98, 37353953334578960, 90374669, 90374672, 3, 640x360 
0x1382CA98, 37353953334900512, 90374696, 90374698, 2, 640x360 
0x1382CA98, 37353953335374192, 90374742, 90374756, 14, 640x360 
0x1382CA98, 37353953335709736, 90374776, 90374779, 3, 640x360 
0x1382CA98, 37353953336018624, 90374808, 90374811, 3, 640x360 
0x1382CA98, 37353953336338624, 90374854, 90374857, 3, 640x360 
0x1382CA98, 37353953336654512, 90374875, 90374878, 3, 640x360 
0x1382CA98, 37353953336974968, 90374908, 90374910, 2, 640x360 
0x1382CA98, 37353953337306688, 90374944, 90374946, 2, 640x360 
0x1382CA98, 37353953337633864, 90374977, 90374979, 2, 640x360 
0x1382CA98, 37353953337957776, 90375012, 90375014, 2, 640x360 
0x1382CA98, 37353953338256120, 90375053, 90375068, 15, 640x360 
0x1382CA98, 37353953338584008, 90375077, 90375079, 2, 640x360 
0x1382CA98, 37353953338895056, 90375106, 90375114, 8, 640x360 
0x1382CA98, 37353953339414584, 90375164, 90375172, 8, 640x360 
0x1382CA98, 37353953339700560, 90375182, 90375187, 5, 640x360 
0x1382CA98, 37353953340043712, 90375208, 90375211, 3, 640x360 
0x1382CA98, 37353953340340184, 90375246, 90375249, 3, 640x360 
0x1382CA98, 37353953340658064, 90375276, 90375280, 4, 640x360 
0x1382CA98, 37353953340974840, 90375303, 90375314, 11, 640x360 
0x1382CA98, 37353953341296856, 90375339, 90375347, 8, 640x360 
0x1382CA98, 37353953341622480, 90375364, 90375368, 4, 640x360 
0x1382CA98, 37353953341937032, 90375395, 90375404, 9, 640x360 
0x1382CA98, 37353953342258704, 90375430, 90375434, 4, 640x360 
0x1382CA98, 37353953342574616, 90375463, 90375467, 4, 640x360 
0x1382CA98, 37353953342894600, 90375492, 90375499, 7, 640x360 
0x1382CA98, 37353953343376200, 90375549, 90375561, 12, 640x360 
0x1382CA98, 37353953343696808, 90375581, 90375583, 2, 640x360 
0x1382CA98, 37353953344018768, 90375610, 90375617, 7, 640x360 
0x1382CA98, 37353953344339864, 90375641, 90375643, 2, 640x360 
0x1382CA98, 37353953344657056, 90375684, 90375696, 12, 640x360 
0x1382CA98, 37353953344974384, 90375702, 90375712, 10, 640x360 
0x1382CA98, 37353953345304632, 90375733, 90375745, 12, 640x360 
0x1382CA98, 37353953345625216, 90375774, 90375781, 7, 640x360 
0x1382CA98, 37353953345937328, 90375807, 90375811, 4, 640x360 
0x1382CA98, 37353953346254480, 90375836, 90375841, 5, 640x360 
0x1382CA98, 37353953346574456, 90375871, 90375873, 2, 640x360 
0x1382CA98, 37353953346895112, 90375901, 90375905, 4, 640x360 
0x1382CA98, 37353953347373896, 90375947, 90375950, 3, 640x360 
0x1382CA98, 37353953347696064, 90375975, 90375980, 5, 640x360 
0x1382CA98, 37353953348023576, 90376019, 90376028, 9, 640x360 
0x1382CA98, 37353953348341384, 90376044, 90376046, 2, 640x360 
0x1382CA98, 37353953348664800, 90376084, 90376088, 4, 640x360 
0x1382CA98, 37353953348975360, 90376109, 90376111, 2, 640x360 
0x1382CA98, 37353953349304328, 90376152, 90376155, 3, 640x360 
0x1382CA98, 37353953349634984, 90376175, 90376180, 5, 640x360 
0x1382CA98, 37353953349938000, 90376209, 90376212, 3, 640x360 
0x1382CA98, 37353953350255608, 90376237, 90376241, 4, 640x360 
0x1382CA98, 37353953350574256, 90376269, 90376272, 3, 640x360 
0x1382CA98, 37353953350894128, 90376303, 90376306, 3, 640x360 
0x1382CA98, 37353953351378336, 90376349, 90376353, 4, 640x360 
0x1382CA98, 37353953351699616, 90376385, 90376387, 2, 640x360 
0x1382CA98, 37353953352013840, 90376403, 90376406, 3, 640x360 
0x1382CA98, 37353953352333952, 90376440, 90376442, 2, 640x360 
0x1382CA98, 37353953352658656, 90376470, 90376481, 11, 640x360 
0x1382CA98, 37353953352978016, 90376509, 90376511, 2, 640x360 
0x1382CA98, 37353953353303776, 90376538, 90376545, 7, 640x360 
0x1382CA98, 37353953353619456, 90376565, 90376571, 6, 640x360 
0x1382CA98, 37353953353937360, 90376597, 90376603, 6, 640x360 
0x1382CA98, 37353953354255056, 90376640, 90376642, 2, 640x360 
0x1382CA98, 37353953354576552, 90376660, 90376664, 4, 640x360 
0x1382CA98, 37353953354898992, 90376691, 90376700, 9, 640x360 
0x1382CA98, 37353953355225512, 90376724, 90376727, 3, 640x360 
0x1382CA98, 37353953355698792, 90376781, 90376783, 2, 640x360 
0x1382CA98, 37353953356016656, 90376814, 90376817, 3, 640x360 
0x1382CA98, 37353953356336664, 90376845, 90376847, 2, 640x360 
0x1382CA98, 37353953356654728, 90376870, 90376873, 3, 640x360 
0x1382CA98, 37353953356975752, 90376906, 90376908, 2, 640x360 
0x1382CA98, 37353953357294448, 90376936, 90376939, 3, 640x360 
0x1382CA98, 37353953357634784, 90376968, 90376977, 9, 640x360 
0x1382CA98, 37353953357952064, 90377005, 90377008, 3, 640x360 
0x1382CA98, 37353953358278208, 90377039, 90377047, 8, 640x360 
0x1382CA98, 37353953358575712, 90377068, 90377080, 12, 640x360 
0x1382CA98, 37353953358896976, 90377110, 90377113, 3, 640x360 
0x1382CA98, 37353953359224024, 90377139, 90377148, 9, 640x360 
0x1382CA98, 37353953359698416, 90377205, 90377208, 3, 640x360 
0x1382CA98, 37353953360040616, 90377232, 90377253, 21, 640x360 
0x1382CA98, 37353953360343000, 90377272, 90377276, 4, 640x360 
0x1382CA98, 37353953360671608, 90377281, 90377297, 16, 640x360 
0x1382CA98, 37353953360989400, 90377338, 90377343, 5, 640x360 
0x1382CA98, 37353953361308216, 90377347, 90377350, 3, 640x360 
0x1382CA98, 37353953361635088, 90377378, 90377388, 10, 640x360 
0x1382CA98, 37353953361939088, 90377447, 90377463, 16, 640x360 
0x1382CA98, 37353953362636048, 90377477, 90377481, 4, 640x360 
0x1382CA98, 37353953362897224, 90377507, 90377510, 3, 640x360 
0x1382CA98, 37353953363217720, 90377537, 90377541, 4, 640x360 
0x1382CA98, 37353953363705656, 90377588, 90377592, 4, 640x360 
0x1382CA98, 37353953364017400, 90377605, 90377614, 9, 640x360 
0x1382CA98, 37353953364348144, 90377645, 90377652, 7, 640x360 
0x1382CA98, 37353953364667912, 90377677, 90377679, 2, 640x360 
0x1382CA98, 37353953364985176, 90377719, 90377725, 6, 640x360 
0x1382CA98, 37353953365317368, 90377744, 90377746, 2, 640x360 
0x1382CA98, 37353953365628640, 90377773, 90377776, 3, 640x360 
0x1382CA98, 37353953365950064, 90377814, 90377819, 5, 640x360 
0x1382CA98, 37353953366282320, 90377843, 90377845, 2, 640x360 
0x1382CA98, 37353953366580264, 90377870, 90377873, 3, 640x360 
0x1382CA98, 37353953366901632, 90377901, 90377920, 19, 640x360 
0x1382CA98, 37353953367224080, 90377933, 90377944, 11, 640x360 
0x1382CA98, 37353953367693248, 90377984, 90377989, 5, 640x360 
0x1382CA98, 37353953368014344, 90378009, 90378011, 2, 640x360 
0x1382CA98, 37353953368342496, 90378055, 90378073, 18, 640x360 
0x1382CA98, 37353953368682512, 90378078, 90378084, 6, 640x360 
0x1382CA98, 37353953368983144, 90378108, 90378119, 11, 640x360 
0x1382CA98, 37353953369320168, 90378142, 90378153, 11, 640x360 
0x1382CA98, 37353953369634640, 90378187, 90378191, 4, 640x360 
0x1382CA98, 37353953369945888, 90378211, 90378213, 2, 640x360 
0x1382CA98, 37353953370303952, 90378240, 90378251, 11, 640x360 
0x1382CA98, 37353953370608648, 90378275, 90378277, 2, 640x360 
0x1382CA98, 37353953370898656, 90378299, 90378315, 16, 640x360 
0x1382CA98, 37353953371258320, 90378343, 90378345, 2, 640x360 
0x1382CA98, 37353953371700352, 90378388, 90378391, 3, 640x360 
0x1382CA98, 37353953372018304, 90378408, 90378411, 3, 640x360 
0x1382CA98, 37353953372333936, 90378440, 90378442, 2, 640x360 
0x1382CA98, 37353953372654240, 90378477, 90378479, 2, 640x360 
0x1382CA98, 37353953372983344, 90378507, 90378511, 4, 640x360 
0x1382CA98, 37353953373294816, 90378542, 90378544, 2, 640x360 
0x1382CA98, 37353953373626872, 90378580, 90378583, 3, 640x360 
0x1382CA98, 37353953373936320, 90378607, 90378618, 11, 640x360 
0x1382CA98, 37353953374265096, 90378642, 90378648, 6, 640x360 
0x1382CA98, 37353953374575504, 90378675, 90378677, 2, 640x360 
0x1382CA98, 37353953374908824, 90378708, 90378712, 4, 640x360 
0x1382CA98, 37353953375215440, 90378729, 90378733, 4, 640x360 
0x1382CA98, 37353953375702112, 90378785, 90378789, 4, 640x360 
0x1382CA98, 37353953376027064, 90378813, 90378816, 3, 640x360 
0x1382CA98, 37353953376344856, 90378847, 90378853, 6, 640x360 
0x1382CA98, 37353953376655368, 90378880, 90378882, 2, 640x360 
0x1382CA98, 37353953376974528, 90378918, 90378922, 4, 640x360 
0x1382CA98, 37353953377303504, 90378943, 90378945, 2, 640x360 
0x1382CA98, 37353953377649216, 90378981, 90378995, 14, 640x360 
0x1382CA98, 37353953377971648, 90379024, 90379035, 11, 640x360 
0x1382CA98, 37353953378279504, 90379044, 90379046, 2, 640x360 
0x1382CA98, 37353953378585640, 90379075, 90379077, 2, 640x360 
0x1382CA98, 37353953378909632, 90379109, 90379112, 3, 640x360 
0x1382CA98, 37353953379214400, 90379137, 90379147, 10, 640x360 
0x1382CA98, 37353953379712896, 90379177, 90379179, 2, 640x360 
0x1382CA98, 37353953380041024, 90379214, 90379218, 4, 640x360 
0x1382CA98, 37353953380341456, 90379267, 90379276, 9, 640x360 
0x1382CA98, 37353953380669288, 90379286, 90379299, 13, 640x360 
0x1382CA98, 37353953381011512, 90379318, 90379327, 9, 640x360 
0x1382CA98, 37353953381316336, 90379347, 90379354, 7, 640x360 
0x1382CA98, 37353953381624008, 90379383, 90379391, 8, 640x360 
0x1382CA98, 37353953381959472, 90379412, 90379414, 2, 640x360 
0x1382CA98, 37353953382253600, 90379444, 90379446, 2, 640x360 
0x1382CA98, 37353953382573608, 90379473, 90379481, 8, 640x360 
0x1382CA98, 37353953382898368, 90379506, 90379514, 8, 640x360 
0x1382CA98, 37353953383221888, 90379540, 90379543, 3, 640x360 
0x1382CA98, 37353953383533552, 90379570, 90379580, 10, 640x360 
0x1382CA98, 37353953384016792, 90379613, 90379615, 2, 640x360 
0x1382CA98, 37353953384344728, 90379652, 90379656, 4, 640x360 
0x1382CA98, 37353953384653632, 90379675, 90379676, 1, 640x360 
0x1382CA98, 37353953384978208, 90379707, 90379717, 10, 640x360 
0x1382CA98, 37353953385301888, 90379740, 90379741, 1, 640x360 
0x1382CA98, 37353953385624360, 90379773, 90379775, 2, 640x360 
0x1382CA98, 37353953385936288, 90379804, 90379812, 8, 640x360 
0x1382CA98, 37353953386284880, 90379838, 90379841, 3, 640x360 
0x1382CA98, 37353953386580920, 90379864, 90379866, 2, 640x360 
0x1382CA98, 37353953386893760, 90379902, 90379905, 3, 640x360 
0x1382CA98, 37353953387213696, 90379925, 90379933, 8, 640x360 
0x1382CA98, 37353953387533616, 90379962, 90379969, 7, 640x360 
0x1382CA98, 37353953388018256, 90380013, 90380015, 2, 640x360 
0x1382CA98, 37353953388336120, 90380047, 90380049, 2, 640x360 
0x1382CA98, 37353953388653416, 90380064, 90380067, 3, 640x360 
0x1382CA98, 37353953388972808, 90380100, 90380106, 6, 640x360 
0x1382CA98, 37353953389305504, 90380146, 90380148, 2, 640x360 
0x1382CA98, 37353953389629112, 90380186, 90380190, 4, 640x360 
0x1382CA98, 37353953389939336, 90380216, 90380224, 8, 640x360 
0x1382CA98, 37353953390257976, 90380236, 90380254, 18, 640x360 
0x1382CA98, 37353953390644424, 90380281, 90380295, 14, 640x360 
0x1382CA98, 37353953390919688, 90380314, 90380329, 15, 640x360 
0x1382CA98, 37353953391216872, 90380344, 90380352, 8, 640x360 
0x1382CA98, 37353953391538824, 90380364, 90380368, 4, 640x360 
0x1382CA98, 37353953392019048, 90380413, 90380418, 5, 640x360 
0x1382CA98, 37353953392341008, 90380453, 90380456, 3, 640x360 
0x1382CA98, 37353953392659888, 90380474, 90380480, 6, 640x360 
0x1382CA98, 37353953392991728, 90380508, 90380511, 3, 640x360 
0x1382CA98, 37353953393303560, 90380539, 90380546, 7, 640x360 
0x1382CA98, 37353953393627616, 90380566, 90380579, 13, 640x360 
0x1382CA98, 37353953393956512, 90380602, 90380606, 4, 640x360 
0x1382CA98, 37353953394258512, 90380641, 90380644, 3, 640x360 
0x1382CA98, 37353953394576960, 90380667, 90380678, 11, 640x360 
0x1382CA98, 37353953394893168, 90380700, 90380711, 11, 640x360 
0x1382CA98, 37353953395213552, 90380733, 90380738, 5, 640x360 
0x1382CA98, 37353953395537152, 90380764, 90380767, 3, 640x360 
0x1382CA98, 37353953396012408, 90380811, 90380813, 2, 640x360 
0x1382CA98, 37353953396336336, 90380841, 90380849, 8, 640x360 
0x1382CA98, 37353953396654136, 90380877, 90380879, 2, 640x360 
0x1382CA98, 37353953396973288, 90380906, 90380913, 7, 640x360 
0x1382CA98, 37353953397296520, 90380939, 90380946, 7, 640x360 
0x1382CA98, 37353953397629008, 90380966, 90380971, 5, 640x360 
0x1382CA98, 37353953397941744, 90380997, 90381002, 5, 640x360 
0x1382CA98, 37353953398300688, 90381038, 90381047, 9, 640x360 
0x1382CA98, 37353953398573896, 90381061, 90381062, 1, 640x360 
0x1382CA98, 37353953398893136, 90381094, 90381096, 2, 640x360 
0x1382CA98, 37353953399212992, 90381130, 90381132, 2, 640x360 
0x1382CA98, 37353953399533176, 90381164, 90381166, 2, 640x360 
0x1382CA98, 37353953400016352, 90381208, 90381216, 8, 640x360 
0x1382CA98, 37353953400337168, 90381238, 90381242, 4, 640x360 
0x1382CA98, 37353953400652504, 90381267, 90381270, 3, 640x360 
0x1382CA98, 37353953400973016, 90381304, 90381306, 2, 640x360 
0x1382CA98, 37353953401292912, 90381334, 90381337, 3, 640x360 
0x1382CA98, 37353953401613560, 90381364, 90381368, 4, 640x360 
0x1382CA98, 37353953401933304, 90381398, 90381401, 3, 640x360 
0x1382CA98, 37353953402253648, 90381427, 90381429, 2, 640x360 
0x1382CA98, 37353953402577512, 90381461, 90381464, 3, 640x360 
0x1382CA98, 37353953402893488, 90381496, 90381498, 2, 640x360 
0x1382CA98, 37353953403217752, 90381527, 90381529, 2, 640x360 
0x1382CA98, 37353953403539728, 90381569, 90381572, 3, 640x360 
0x1382CA98, 37353953404013152, 90381608, 90381617, 9, 640x360 
0x1382CA98, 37353953404335384, 90381641, 90381645, 4, 640x360 
0x1382CA98, 37353953404653192, 90381675, 90381677, 2, 640x360 
0x1382CA98, 37353953404973144, 90381704, 90381707, 3, 640x360 
0x1382CA98, 37353953405300304, 90381741, 90381743, 2, 640x360 
0x1382CA98, 37353953405620248, 90381778, 90381780, 2, 640x360 
0x1382CA98, 37353953405934088, 90381807, 90381809, 2, 640x360 
0x1382CA98, 37353953406254744, 90381840, 90381843, 3, 640x360 
0x1382CA98, 37353953406573280, 90381870, 90381874, 4, 640x360 
0x1382CA98, 37353953406898248, 90381906, 90381910, 4, 640x360 
0x1382CA98, 37353953407213192, 90381943, 90381946, 3, 640x360 
0x1382CA98, 37353953407540552, 90381971, 90381986, 15, 640x360 
0x1382CA98, 37353953407895720, 90382006, 90382010, 4, 640x360 
0x1382CA98, 37353953408336856, 90382047, 90382051, 4, 640x360 
0x1382CA98, 37353953408653192, 90382087, 90382091, 4, 640x360 
0x1382CA98, 37353953408976776, 90382110, 90382113, 3, 640x360 
0x1382CA98, 37353953409371240, 90382145, 90382148, 3, 640x360 
0x1382CA98, 37353953409629320, 90382188, 90382197, 9, 640x360 
0x1382CA98, 37353953409944040, 90382210, 90382212, 2, 640x360 
0x1382CA98, 37353953410253664, 90382231, 90382235, 4, 640x360 
0x1382CA98, 37353953410575840, 90382272, 90382274, 2, 640x360 
0x1382CA98, 37353953410897480, 90382301, 90382318, 17, 640x360 
0x1382CA98, 37353953411224048, 90382358, 90382368, 10, 640x360 
0x1382CA98, 37353953411544376, 90382382, 90382393, 11, 640x360 
0x1382CA98, 37353953411872368, 90382409, 90382412, 3, 640x360 
0x1382CA98, 37353953412350168, 90382459, 90382461, 2, 640x360 
0x1382CA98, 37353953412656296, 90382487, 90382497, 10, 640x360 
0x1382CA98, 37353953412979888, 90382509, 90382513, 4, 640x360 
0x1382CA98, 37353953413293496, 90382539, 90382545, 6, 640x360 
0x1382CA98, 37353953413658312, 90382581, 90382588, 7, 640x360 
0x1382CA98, 37353953413935584, 90382599, 90382614, 15, 640x360 
0x1382CA98, 37353953414294072, 90382661, 90382664, 3, 640x360 
0x1382CA98, 37353953414620144, 90382681, 90382689, 8, 640x360 
0x1382CA98, 37353953414907944, 90382708, 90382711, 3, 640x360 
0x1382CA98, 37353953415218416, 90382740, 90382753, 13, 640x360 
0x1382CA98, 37353953415544248, 90382771, 90382779, 8, 640x360 
0x1382CA98, 37353953415868528, 90382809, 90382811, 2, 640x360 
0x1382CA98, 37353953416341328, 90382873, 90382880, 7, 640x360 
0x1382CA98, 37353953416653536, 90382889, 90382892, 3, 640x360 
0x1382CA98, 37353953416995400, 90382910, 90382912, 2, 640x360 
0x1382CA98, 37353953417302792, 90382941, 90382943, 2, 640x360 
0x1382CA98, 37353953417619368, 90382990, 90382997, 7, 640x360 
0x1382CA98, 37353953417977784, 90383009, 90383013, 4, 640x360 
0x1382CA98, 37353953418255056, 90383044, 90383046, 2, 640x360 
0x1382CA98, 37353953418574248, 90383065, 90383079, 14, 640x360 
0x1382CA98, 37353953418899304, 90383097, 90383103, 6, 640x360 
0x1382CA98, 37353953419219104, 90383132, 90383144, 12, 640x360 
0x1382CA98, 37353953419535656, 90383163, 90383168, 5, 640x360 
0x1382CA98, 37353953419862472, 90383207, 90383215, 8, 640x360 
0x1382CA98, 37353953420339864, 90383244, 90383246, 2, 640x360 
0x1382CA98, 37353953420652072, 90383274, 90383280, 6, 640x360 
0x1382CA98, 37353953420977200, 90383319, 90383329, 10, 640x360 
0x1382CA98, 37353953421309688, 90383337, 90383342, 5, 640x360 
0x1382CA98, 37353953421619768, 90383373, 90383380, 7, 640x360 
0x1382CA98, 37353953421939512, 90383406, 90383409, 3, 640x360 
0x1382CA98, 37353953422253512, 90383443, 90383445, 2, 640x360 
0x1382CA98, 37353953422573224, 90383475, 90383478, 3, 640x360 
0x1382CA98, 37353953422893128, 90383504, 90383507, 3, 640x360 
0x1382CA98, 37353953423266456, 90383541, 90383545, 4, 640x360 
0x1382CA98, 37353953423535240, 90383562, 90383565, 3, 640x360 
0x1382CA98, 37353953423863928, 90383601, 90383605, 4, 640x360 
0x1382CA98, 37353953424334288, 90383640, 90383644, 4, 640x360 
0x1382CA98, 37353953424652936, 90383674, 90383676, 2, 640x360 
0x1382CA98, 37353953424977960, 90383719, 90383723, 4, 640x360 
0x1382CA98, 37353953425315416, 90383743, 90383745, 2, 640x360 
0x1382CA98, 37353953425616024, 90383787, 90383791, 4, 640x360 
0x1382CA98, 37353953425939904, 90383812, 90383815, 3, 640x360 
0x1382CA98, 37353953426255120, 90383843, 90383855, 12, 640x360 
0x1382CA98, 37353953426583464, 90383876, 90383879, 3, 640x360 
0x1382CA98, 37353953426892752, 90383904, 90383907, 3, 640x360 
0x1382CA98, 37353953427212136, 90383924, 90383928, 4, 640x360 
0x1382CA98, 37353953427533128, 90383971, 90383974, 3, 640x360 
0x1382CA98, 37353953427853312, 90383991, 90384001, 10, 640x360 
0x1382CA98, 37353953428334808, 90384043, 90384052, 9, 640x360 
0x1382CA98, 37353953428654216, 90384074, 90384076, 2, 640x360 
0x1382CA98, 37353953428971688, 90384098, 90384104, 6, 640x360 
0x1382CA98, 37353953429301520, 90384137, 90384147, 10, 640x360 
0x1382CA98, 37353953429623400, 90384164, 90384171, 7, 640x360 
0x1382CA98, 37353953429936296, 90384196, 90384198, 2, 640x360 
0x1382CA98, 37353953430256144, 90384227, 90384229, 2, 640x360 
0x1382CA98, 37353953430572128, 90384259, 90384261, 2, 640x360 
0x1382CA98, 37353953430892152, 90384296, 90384302, 6, 640x360 
0x1382CA98, 37353953431217920, 90384338, 90384340, 2, 640x360 
0x1382CA98, 37353953431532584, 90384364, 90384371, 7, 640x360 
0x1382CA98, 37353953431852608, 90384401, 90384405, 4, 640x360 
0x1382CA98, 37353953432334992, 90384441, 90384442, 1, 640x360 
0x1382CA98, 37353953432652672, 90384472, 90384480, 8, 640x360 
0x1382CA98, 37353953432975072, 90384505, 90384507, 2, 640x360 
0x1382CA98, 37353953433296288, 90384537, 90384539, 2, 640x360 
0x1382CA98, 37353953433612736, 90384567, 90384571, 4, 640x360 
0x1382CA98, 37353953433939416, 90384598, 90384602, 4, 640x360 
0x1382CA98, 37353953434253200, 90384631, 90384642, 11, 640x360 
0x1382CA98, 37353953434572656, 90384658, 90384661, 3, 640x360 
0x1382CA98, 37353953434896312, 90384690, 90384697, 7, 640x360 
0x1382CA98, 37353953435215488, 90384727, 90384730, 3, 640x360 
0x1382CA98, 37353953435534976, 90384757, 90384764, 7, 640x360 
0x1382CA98, 37353953435855512, 90384789, 90384793, 4, 640x360 
0x1382CA98, 37353953436172320, 90384825, 90384827, 2, 640x360 
0x1382CA98, 37353953436651744, 90384883, 90384885, 2, 640x360 
0x1382CA98, 37353953436977184, 90384897, 90384902, 5, 640x360 
0x1382CA98, 37353953437296856, 90384928, 90384930, 2, 640x360 
0x1382CA98, 37353953437617096, 90384969, 90384972, 3, 640x360 
0x1382CA98, 37353953437936984, 90385009, 90385012, 3, 640x360 
0x1382CA98, 37353953438269952, 90385035, 90385044, 9, 640x360 
0x1382CA98, 37353953438578032, 90385071, 90385081, 10, 640x360 
0x1382CA98, 37353953438912256, 90385101, 90385107, 6, 640x360 
0x1382CA98, 37353953439225160, 90385137, 90385140, 3, 640x360 
0x1382CA98, 37353953439535192, 90385158, 90385161, 3, 640x360 
0x1382CA98, 37353953439853496, 90385197, 90385200, 3, 640x360 
0x1382CA98, 37353953440187416, 90385243, 90385246, 3, 640x360 
0x1382CA98, 37353953440653048, 90385279, 90385281, 2, 640x360 
0x1382CA98, 37353953440974672, 90385308, 90385311, 3, 640x360 
0x1382CA98, 37353953441299256, 90385346, 90385349, 3, 640x360 
0x1382CA98, 37353953441618528, 90385368, 90385373, 5, 640x360 
0x1382CA98, 37353953441933736, 90385400, 90385413, 13, 640x360 
0x1382CA98, 37353953442253056, 90385444, 90385447, 3, 640x360 
0x1382CA98, 37353953442576456, 90385475, 90385477, 2, 640x360 
0x1382CA98, 37353953442891672, 90385497, 90385502, 5, 640x360 
0x1382CA98, 37353953443211816, 90385525, 90385527, 2, 640x360 
0x1382CA98, 37353953443536112, 90385569, 90385574, 5, 640x360 
0x1382CA98, 37353953443852744, 90385597, 90385599, 2, 640x360 
0x1382CA98, 37353953444177816, 90385627, 90385629, 2, 640x360 
0x1382CA98, 37353953444651160, 90385670, 90385677, 7, 640x360 
0x1382CA98, 37353953444975488, 90385706, 90385720, 14, 640x360 
0x1382CA98, 37353953445304824, 90385746, 90385748, 2, 640x360 
0x1382CA98, 37353953445626048, 90385764, 90385768, 4, 640x360 
0x1382CA98, 37353953445954704, 90385796, 90385802, 6, 640x360 
0x1382CA98, 37353953446279720, 90385836, 90385846, 10, 640x360 
0x1382CA98, 37353953446575696, 90385862, 90385872, 10, 640x360 
0x1382CA98, 37353953446894112, 90385896, 90385902, 6, 640x360 
0x1382CA98, 37353953447212360, 90385935, 90385944, 9, 640x360 
0x1382CA98, 37353953447540880, 90385959, 90385961, 2, 640x360 
0x1382CA98, 37353953447855464, 90385991, 90385994, 3, 640x360 
0x1382CA98, 37353953448172944, 90386036, 90386040, 4, 640x360 
0x1382CA98, 37353953448654600, 90386069, 90386078, 9, 640x360 
0x1382CA98, 37353953448974456, 90386109, 90386117, 8, 640x360 
0x1382CA98, 37353953449292152, 90386132, 90386141, 9, 640x360 
0x1382CA98, 37353953449631360, 90386176, 90386194, 18, 640x360 
0x1382CA98, 37353953449937976, 90386209, 90386212, 3, 640x360 
0x1382CA98, 37353953450252200, 90386259, 90386271, 12, 640x360 
0x1382CA98, 37353953450647336, 90386280, 90386296, 16, 640x360 
0x1382CA98, 37353953450904768, 90386307, 90386309, 2, 640x360 
0x1382CA98, 37353953451212520, 90386338, 90386350, 12, 640x360 
0x1382CA98, 37353953451538288, 90386369, 90386403, 34, 640x360 
0x1382CA98, 37353953451859112, 90386404, 90386412, 8, 640x360 
0x1382CA98, 37353953452206896, 90386431, 90386446, 15, 640x360 
0x1382CA98, 37353953452700608, 90386479, 90386483, 4, 640x360 
0x1382CA98, 37353953452975952, 90386508, 90386512, 4, 640x360 
0x1382CA98, 37353953453299912, 90386549, 90386554, 5, 640x360 
0x1382CA98, 37353953453616312, 90386567, 90386576, 9, 640x360 
0x1382CA98, 37353953453946064, 90386607, 90386608, 1, 640x360 
0x1382CA98, 37353953454251544, 90386639, 90386641, 2, 640x360 
0x1382CA98, 37353953454571368, 90386670, 90386672, 2, 640x360 
0x1382CA98, 37353953454894768, 90386696, 90386698, 2, 640x360 
0x1382CA98, 37353953455215520, 90386728, 90386730, 2, 640x360 
0x1382CA98, 37353953455536928, 90386757, 90386765, 8, 640x360 
0x1382CA98, 37353953455856552, 90386789, 90386795, 6, 640x360 
0x1382CA98, 37353953456173912, 90386824, 90386826, 2, 640x360 
0x1382CA98, 37353953456656160, 90386873, 90386875, 2, 640x360 
0x1382CA98, 37353953456971680, 90386901, 90386905, 4, 640x360 
0x1382CA98, 37353953457291728, 90386932, 90386937, 5, 640x360 
0x1382CA98, 37353953457617040, 90386965, 90386970, 5, 640x360 
0x1382CA98, 37353953457936624, 90386994, 90386997, 3, 640x360 
0x1382CA98, 37353953458257560, 90387031, 90387043, 12, 640x360 
0x1382CA98, 37353953458575608, 90387062, 90387064, 2, 640x360 
0x1382CA98, 37353953458892200, 90387090, 90387093, 3, 640x360 
0x1382CA98, 37353953459212144, 90387135, 90387138, 3, 640x360 
0x1382CA98, 37353953459532776, 90387168, 90387171, 3, 640x360 
0x1382CA98, 37353953459855896, 90387193, 90387197, 4, 640x360 
0x1382CA98, 37353953460172592, 90387226, 90387229, 3, 640x360 
0x1382CA98, 37353953460650912, 90387279, 90387283, 4, 640x360 
0x1382CA98, 37353953460971592, 90387320, 90387334, 14, 640x360 
0x1382CA98, 37353953461380632, 90387372, 90387380, 8, 640x360 
0x1382CA98, 37353953461638088, 90387393, 90387402, 9, 640x360 
0x1382CA98, 37353953461977312, 90387411, 90387440, 29, 640x360 
0x1382CA98, 37353953462288816, 90387446, 90387451, 5, 640x360 
0x1382CA98, 37353953462571464, 90387466, 90387485, 19, 640x360 
0x1382CA98, 37353953462900736, 90387508, 90387514, 6, 640x360 
0x1382CA98, 37353953463244392, 90387560, 90387563, 3, 640x360 
0x1382CA98, 37353953463551496, 90387591, 90387601, 10, 640x360 
0x1382CA98, 37353953463865464, 90387602, 90387614, 12, 640x360 
0x1382CA98, 37353953464184968, 90387637, 90387673, 36, 640x360 
0x1382CA98, 37353953464978168, 90387725, 90387729, 4, 640x360 
0x1382CA98, 37353953465314280, 90387744, 90387748, 4, 640x360 
0x1382CA98, 37353953465641528, 90387807, 90387814, 7, 640x360 
0x1382CA98, 37353953465957832, 90387838, 90387861, 23, 640x360 
0x1382CA98, 37353953466326840, 90387874, 90387888, 14, 640x360 
0x1382CA98, 37353953466912032, 90387928, 90387944, 16, 640x360 
0x1382CA98, 37353953467243888, 90387966, 90388075, 109, 640x360 
0x1382CA98, 37353953467551352, 90388076, 90388081, 5, 640x360 
0x1382CA98, 37353953468976864, 90388115, 90388135, 20, 640x360 
0x1382CA98, 37353953469314192, 90388154, 90388163, 9, 640x360 
0x1382CA98, 37353953469617952, 90388174, 90388177, 3, 640x360 
0x1382CA98, 37353953469956792, 90388211, 90388219, 8, 640x360 
0x1382CA98, 37353953470276608, 90388247, 90388255, 8, 640x360 
0x1382CA98, 37353953470572008, 90388284, 90388295, 11, 640x360 
0x1382CA98, 37353953470899160, 90388305, 90388313, 8, 640x360 
0x1382CA98, 37353953471224320, 90388360, 90388362, 2, 640x360 
0x1382CA98, 37353953471545872, 90388387, 90388400, 13, 640x360 
0x1382CA98, 37353953471855784, 90388400, 90388406, 6, 640x360 
0x1382CA98, 37353953472171784, 90388423, 90388426, 3, 640x360 
0x1382CA98, 37353953472491016, 90388448, 90388455, 7, 640x360 
0x1382CA98, 37353953472975224, 90388513, 90388514, 1, 640x360 
0x1382CA98, 37353953473296584, 90388534, 90388541, 7, 640x360 
0x1382CA98, 37353953473611424, 90388567, 90388574, 7, 640x360 
0x1382CA98, 37353953473957944, 90388603, 90388605, 2, 640x360 
0x1382CA98, 37353953474256584, 90388630, 90388635, 5, 640x360 
0x1382CA98, 37353953474571744, 90388659, 90388662, 3, 640x360 
0x1382CA98, 37353953474895592, 90388700, 90388710, 10, 640x360 
0x1382CA98, 37353953475215072, 90388729, 90388731, 2, 640x360 
0x1382CA98, 37353953475531968, 90388756, 90388759, 3, 640x360 
0x1382CA98, 37353953475851752, 90388793, 90388799, 6, 640x360 
0x1382CA98, 37353953476171456, 90388825, 90388831, 6, 640x360 
0x1382CA98, 37353953476491816, 90388853, 90388860, 7, 640x360 
0x1382CA98, 37353953476986712, 90388899, 90388908, 9, 640x360 
0x1382CA98, 37353953477291352, 90388933, 90388944, 11, 640x360 
0x1382CA98, 37353953477628880, 90388979, 90388989, 10, 640x360 
0x1382CA98, 37353953477956416, 90389000, 90389011, 11, 640x360 
0x1382CA98, 37353953478251112, 90389037, 90389045, 8, 640x360 
0x1382CA98, 37353953478570992, 90389068, 90389072, 4, 640x360 
0x1382CA98, 37353953478890688, 90389097, 90389103, 6, 640x360 
0x1382CA98, 37353953479210744, 90389132, 90389135, 3, 640x360 
0x1382CA98, 37353953479532080, 90389164, 90389167, 3, 640x360 
0x1382CA98, 37353953479854608, 90389194, 90389201, 7, 640x360 
0x1382CA98, 37353953480173416, 90389226, 90389228, 2, 640x360 
0x1382CA98, 37353953480497304, 90389259, 90389261, 2, 640x360 
0x1382CA98, 37353953480971016, 90389306, 90389308, 2, 640x360 
0x1382CA98, 37353953481294408, 90389334, 90389337, 3, 640x360 
0x1382CA98, 37353953481614344, 90389363, 90389365, 2, 640x360 
0x1382CA98, 37353953481948784, 90389395, 90389397, 2, 640x360 
0x1382CA98, 37353953482251856, 90389432, 90389435, 3, 640x360 
0x1382CA98, 37353953482571576, 90389459, 90389461, 2, 640x360 
0x1382CA98, 37353953482895408, 90389490, 90389498, 8, 640x360 
0x1382CA98, 37353953483211416, 90389524, 90389527, 3, 640x360 
0x1382CA98, 37353953483531400, 90389557, 90389559, 2, 640x360 
0x1382CA98, 37353953483855176, 90389593, 90389595, 2, 640x360 
0x1382CA98, 37353953484180560, 90389627, 90389637, 10, 640x360 
0x1382CA98, 37353953484492808, 90389657, 90389666, 9, 640x360 
0x1382CA98, 37353953484970224, 90389705, 90389711, 6, 640x360 
0x1382CA98, 37353953485303616, 90389747, 90389749, 2, 640x360 
0x1382CA98, 37353953485618056, 90389771, 90389780, 9, 640x360 
0x1382CA98, 37353953485933256, 90389803, 90389807, 4, 640x360 
0x1382CA98, 37353953486262160, 90389838, 90389841, 3, 640x360 
0x1382CA98, 37353953486570800, 90389866, 90389876, 10, 640x360 
0x1382CA98, 37353953486890776, 90389894, 90389896, 2, 640x360 
0x1382CA98, 37353953487210424, 90389936, 90389946, 10, 640x360 
0x1382CA98, 37353953487538832, 90389960, 90389963, 3, 640x360 
0x1382CA98, 37353953487856216, 90390002, 90390012, 10, 640x360 
0x1382CA98, 37353953488207992, 90390029, 90390031, 2, 640x360 
0x1382CA98, 37353953488516600, 90390063, 90390065, 2, 640x360 
0x1382CA98, 37353953488972832, 90390098, 90390102, 4, 640x360 
0x1382CA98, 37353953489295752, 90390143, 90390151, 8, 640x360 
0x1382CA98, 37353953489615864, 90390165, 90390170, 5, 640x360 
0x1382CA98, 37353953489930648, 90390197, 90390199, 2, 640x360 
0x1382CA98, 37353953490254432, 90390231, 90390235, 4, 640x360 
0x1382CA98, 37353953490570336, 90390265, 90390268, 3, 640x360 
0x1382CA98, 37353953490890776, 90390295, 90390297, 2, 640x360 
0x1382CA98, 37353953491210352, 90390324, 90390330, 6, 640x360 
0x1382CA98, 37353953491530728, 90390356, 90390361, 5, 640x360 
0x1382CA98, 37353953491854376, 90390398, 90390402, 4, 640x360 
0x1382CA98, 37353953492172448, 90390426, 90390430, 4, 640x360 
0x1382CA98, 37353953492495496, 90390449, 90390454, 5, 640x360 
0x1382CA98, 37353953492815608, 90390488, 90390491, 3, 640x360 
0x1382CA98, 37353953493296544, 90390533, 90390538, 5, 640x360 
0x1382CA98, 37353953493616096, 90390568, 90390573, 5, 640x360 
0x1382CA98, 37353953493944776, 90390600, 90390604, 4, 640x360 
0x1382CA98, 37353953494258080, 90390628, 90390631, 3, 640x360 
0x1382CA98, 37353953494575376, 90390663, 90390665, 2, 640x360 
0x1382CA98, 37353953494890160, 90390691, 90390697, 6, 640x360 
0x1382CA98, 37353953495211848, 90390726, 90390728, 2, 640x360 
0x1382CA98, 37353953495532056, 90390771, 90390779, 8, 640x360 
0x1382CA98, 37353953495866568, 90390792, 90390794, 2, 640x360 
0x1382CA98, 37353953496199072, 90390825, 90390827, 2, 640x360 
0x1382CA98, 37353953496504144, 90390859, 90390861, 2, 640x360 
0x1382CA98, 37353953496810984, 90390890, 90390896, 6, 640x360 
0x1382CA98, 37353953497290320, 90390938, 90390941, 3, 640x360 
0x1382CA98, 37353953497611472, 90390961, 90390963, 2, 640x360 
0x1382CA98, 37353953497952760, 90391006, 90391008, 2, 640x360 
0x1382CA98, 37353953498256600, 90391032, 90391034, 2, 640x360 
0x1382CA98, 37353953498574816, 90391061, 90391064, 3, 640x360 
0x1382CA98, 37353953498890728, 90391096, 90391098, 2, 640x360 
0x1382CA98, 37353953499215360, 90391125, 90391128, 3, 640x360 
0x1382CA98, 37353953499532704, 90391162, 90391164, 2, 640x360 
0x1382CA98, 37353953499861368, 90391192, 90391194, 2, 640x360 
0x1382CA98, 37353953500194136, 90391230, 90391232, 2, 640x360 
0x1382CA98, 37353953500506456, 90391264, 90391266, 2, 640x360 
0x1382CA98, 37353953500811248, 90391295, 90391302, 7, 640x360 
0x1382CA98, 37353953501292752, 90391355, 90391359, 4, 640x360 
0x1382CA98, 37353953501641160, 90391378, 90391381, 3, 640x360 
0x1382CA98, 37353953501976016, 90391426, 90391431, 5, 640x360 
0x1382CA98, 37353953502253472, 90391442, 90391445, 3, 640x360 
0x1382CA98, 37353953502571848, 90391473, 90391475, 2, 640x360 
0x1382CA98, 37353953502893320, 90391497, 90391514, 17, 640x360 
0x1382CA98, 37353953503213384, 90391531, 90391534, 3, 640x360 
0x1382CA98, 37353953503537336, 90391566, 90391580, 14, 640x360 
0x1382CA98, 37353953503862208, 90391592, 90391601, 9, 640x360 
0x1382CA98, 37353953504175400, 90391626, 90391628, 2, 640x360 
0x1382CA98, 37353953504501384, 90391659, 90391661, 2, 640x360 
0x1382CA98, 37353953504821912, 90391691, 90391693, 2, 640x360 
0x1382CA98, 37353953505308792, 90391730, 90391732, 2, 640x360 
0x1382CA98, 37353953505635696, 90391771, 90391773, 2, 640x360 
0x1382CA98, 37353953505936592, 90391795, 90391798, 3, 640x360 
0x1382CA98, 37353953506250144, 90391832, 90391836, 4, 640x360 
0x1382CA98, 37353953506570896, 90391864, 90391868, 4, 640x360 
0x1382CA98, 37353953506893696, 90391891, 90391894, 3, 640x360 
0x1382CA98, 37353953507209992, 90391937, 90391940, 3, 640x360 
0x1382CA98, 37353953507536232, 90391960, 90391964, 4, 640x360 
0x1382CA98, 37353953507849960, 90391992, 90392004, 12, 640x360 
0x1382CA98, 37353953508170704, 90392026, 90392036, 10, 640x360 
0x1382CA98, 37353953508493816, 90392064, 90392067, 3, 640x360 
0x1382CA98, 37353953508818952, 90392093, 90392095, 2, 640x360 
0x1382CA98, 37353953509306104, 90392141, 90392143, 2, 640x360 
0x1382CA98, 37353953509612552, 90392176, 90392178, 2, 640x360 
0x1382CA98, 37353953509939344, 90392215, 90392241, 26, 640x360 
0x1382CA98, 37353953510280848, 90392246, 90392259, 13, 640x360 
0x1382CA98, 37353953510665872, 90392289, 90392304, 15, 640x360 
0x1382CA98, 37353953510893064, 90392312, 90392317, 5, 640x360 
0x1382CA98, 37353953511217304, 90392328, 90392337, 9, 640x360 
0x1382CA98, 37353953511538536, 90392368, 90392376, 8, 640x360 
0x1382CA98, 37353953511851152, 90392403, 90392408, 5, 640x360 
0x1382CA98, 37353953512173600, 90392441, 90392447, 6, 640x360 
0x1382CA98, 37353953512505152, 90392459, 90392462, 3, 640x360 
0x1382CA98, 37353953512815984, 90392487, 90392490, 3, 640x360 
0x1382CA98, 37353953513294896, 90392534, 90392540, 6, 640x360 
0x1382CA98, 37353953513632520, 90392567, 90392573, 6, 640x360 
0x1382CA98, 37353953513944880, 90392603, 90392606, 3, 640x360 
0x1382CA98, 37353953514271544, 90392631, 90392638, 7, 640x360 
0x1382CA98, 37353953514573072, 90392664, 90392666, 2, 640x360 
0x1382CA98, 37353953514890816, 90392716, 90392722, 6, 640x360 
0x1382CA98, 37353953515221992, 90392727, 90392731, 4, 640x360 
0x1382CA98, 37353953515531280, 90392757, 90392768, 11, 640x360 
0x1382CA98, 37353953515849848, 90392791, 90392795, 4, 640x360 
0x1382CA98, 37353953516188112, 90392833, 90392847, 14, 640x360 
0x1382CA98, 37353953516499208, 90392859, 90392862, 3, 640x360 
0x1382CA98, 37353953516832408, 90392890, 90392893, 3, 640x360 
0x1382CA98, 37353953517142600, 90392920, 90392924, 4, 640x360 
0x1382CA98, 37353953517619592, 90392969, 90392978, 9, 640x360 
0x1382CA98, 37353953517945152, 90393003, 90393008, 5, 640x360 
0x1382CA98, 37353953518266704, 90393031, 90393033, 2, 640x360 
0x1382CA98, 37353953518578144, 90393075, 90393077, 2, 640x360 
0x1382CA98, 37353953518889424, 90393098, 90393101, 3, 640x360 
0x1382CA98, 37353953519236704, 90393129, 90393133, 4, 640x360 
0x1382CA98, 37353953519530296, 90393160, 90393161, 1, 640x360 
0x1382CA98, 37353953519861672, 90393201, 90393204, 3, 640x360 
0x1382CA98, 37353953520169816, 90393226, 90393229, 3, 640x360 
0x1382CA98, 37353953520490504, 90393258, 90393260, 2, 640x360 
0x1382CA98, 37353953521130608, 90393323, 90393325, 2, 640x360 
0x1382CA98, 37353953521621008, 90393380, 90393382, 2, 640x360 
0x1382CA98, 37353953521933752, 90393405, 90393412, 7, 640x360 
0x1382CA98, 37353953522249480, 90393430, 90393434, 4, 640x360 
0x1382CA98, 37353953522569632, 90393467, 90393478, 11, 640x360 
0x1382CA98, 37353953522892656, 90393504, 90393507, 3, 640x360 
0x1382CA98, 37353953523216224, 90393525, 90393528, 3, 640x360 
0x1382CA98, 37353953523533448, 90393562, 90393564, 2, 640x360 
0x1382CA98, 37353953523861008, 90393591, 90393598, 7, 640x360 
0x1382CA98, 37353953524171568, 90393625, 90393626, 1, 640x360 
0x1382CA98, 37353953524504896, 90393658, 90393661, 3, 640x360 
0x1382CA98, 37353953524820528, 90393704, 90393712, 8, 640x360 
0x1382CA98, 37353953525138488, 90393730, 90393735, 5, 640x360 
0x1382CA98, 37353953525615792, 90393774, 90393782, 8, 640x360 
0x1382CA98, 37353953525930480, 90393822, 90393835, 13, 640x360 
0x1382CA98, 37353953526250968, 90393855, 90393863, 8, 640x360 
0x1382CA98, 37353953526611824, 90393867, 90393879, 12, 640x360 
0x1382CA98, 37353953526890408, 90393906, 90393909, 3, 640x360 
0x1382CA98, 37353953527213288, 90393926, 90393928, 2, 640x360 
0x1382CA98, 37353953527542128, 90393959, 90393965, 6, 640x360 
0x1382CA98, 37353953527856192, 90393991, 90393994, 3, 640x360 
0x1382CA98, 37353953528208488, 90394024, 90394029, 5, 640x360 
0x1382CA98, 37353953528508392, 90394060, 90394062, 2, 640x360 
0x1382CA98, 37353953528820520, 90394083, 90394096, 13, 640x360 
0x1382CA98, 37353953529137000, 90394116, 90394131, 15, 640x360 
0x1382CA98, 37353953529615424, 90394175, 90394180, 5, 640x360 
0x1382CA98, 37353953529929592, 90394210, 90394220, 10, 640x360 
0x1382CA98, 37353953530252344, 90394237, 90394241, 4, 640x360 
0x1382CA98, 37353953530569280, 90394262, 90394264, 2, 640x360 
0x1382CA98, 37353953530893008, 90394301, 90394305, 4, 640x360 
0x1382CA98, 37353953531216912, 90394340, 90394342, 2, 640x360 
0x1382CA98, 37353953531529272, 90394360, 90394363, 3, 640x360 
0x1382CA98, 37353953531862072, 90394392, 90394397, 5, 640x360 
0x1382CA98, 37353953532189480, 90394433, 90394445, 12, 640x360 
0x1382CA98, 37353953532498744, 90394459, 90394461, 2, 640x360 
0x1382CA98, 37353953532814600, 90394485, 90394490, 5, 640x360 
0x1382CA98, 37353953533134096, 90394514, 90394519, 5, 640x360 
0x1382CA98, 37353953533623152, 90394563, 90394565, 2, 640x360 
0x1382CA98, 37353953533940472, 90394601, 90394615, 14, 640x360 
0x1382CA98, 37353953534249704, 90394629, 90394631, 2, 640x360 
0x1382CA98, 37353953534569824, 90394664, 90394668, 4, 640x360 
0x1382CA98, 37353953534894440, 90394698, 90394703, 5, 640x360 
0x1382CA98, 37353953535213080, 90394726, 90394729, 3, 640x360 
0x1382CA98, 37353953535533296, 90394763, 90394765, 2, 640x360 
0x1382CA98, 37353953535849584, 90394793, 90394795, 2, 640x360 
0x1382CA98, 37353953536170120, 90394835, 90394839, 4, 640x360 
0x1382CA98, 37353953536499200, 90394859, 90394861, 2, 640x360 
0x1382CA98, 37353953536810288, 90394886, 90394888, 2, 640x360 
0x1382CA98, 37353953537129768, 90394917, 90394929, 12, 640x360 
0x1382CA98, 37353953537619216, 90394969, 90394972, 3, 640x360 
0x1382CA98, 37353953537929720, 90394994, 90394997, 3, 640x360 
0x1382CA98, 37353953538261624, 90395028, 90395031, 3, 640x360 
0x1382CA98, 37353953538581912, 90395065, 90395067, 2, 640x360 
0x1382CA98, 37353953538899216, 90395098, 90395100, 2, 640x360 
0x1382CA98, 37353953539243752, 90395138, 90395143, 5, 640x360 
0x1382CA98, 37353953539532168, 90395163, 90395166, 3, 640x360 
0x1382CA98, 37353953539855184, 90395196, 90395198, 2, 640x360 
0x1382CA98, 37353953540173136, 90395245, 90395257, 12, 640x360 
0x1382CA98, 37353953540497776, 90395262, 90395264, 2, 640x360 
0x1382CA98, 37353953540810472, 90395294, 90395296, 2, 640x360 
0x1382CA98, 37353953541137080, 90395337, 90395340, 3, 640x360 
0x1382CA98, 37353953541614648, 90395371, 90395377, 6, 640x360 
0x1382CA98, 37353953541932408, 90395399, 90395402, 3, 640x360 
0x1382CA98, 37353953542248536, 90395438, 90395440, 2, 640x360 
0x1382CA98, 37353953542568808, 90395459, 90395468, 9, 640x360 
0x1382CA98, 37353953542892712, 90395506, 90395513, 7, 640x360 
0x1382CA98, 37353953543213632, 90395533, 90395540, 7, 640x360 
0x1382CA98, 37353953543528832, 90395558, 90395567, 9, 640x360 
0x1382CA98, 37353953543871416, 90395596, 90395602, 6, 640x360 
0x1382CA98, 37353953544172952, 90395626, 90395628, 2, 640x360 
0x1382CA98, 37353953544502792, 90395665, 90395667, 2, 640x360 
0x1382CA98, 37353953544813744, 90395697, 90395698, 1, 640x360 
0x1382CA98, 37353953545129704, 90395716, 90395724, 8, 640x360 
0x1382CA98, 37353953545453104, 90395755, 90395762, 7, 640x360 
0x1382CA98, 37353953545936976, 90395802, 90395813, 11, 640x360 
0x1382CA98, 37353953546303528, 90395830, 90395834, 4, 640x360 
0x1382CA98, 37353953546572712, 90395871, 90395873, 2, 640x360 
0x1382CA98, 37353953546889240, 90395894, 90395896, 2, 640x360 
0x1382CA98, 37353953547212480, 90395925, 90395926, 1, 640x360 
0x1382CA98, 37353953547528792, 90395957, 90395959, 2, 640x360 
0x1382CA98, 37353953547850048, 90395988, 90395990, 2, 640x360 
0x1382CA98, 37353953548169224, 90396019, 90396023, 4, 640x360 
0x1382CA98, 37353953548490240, 90396050, 90396056, 6, 640x360 
0x1382CA98, 37353953548809240, 90396081, 90396084, 3, 640x360 
0x1382CA98, 37353953549130352, 90396112, 90396116, 4, 640x360 
0x1382CA98, 37353953549453808, 90396149, 90396161, 12, 640x360 
0x1382CA98, 37353953549928664, 90396195, 90396198, 3, 640x360 
0x1382CA98, 37353953550252384, 90396231, 90396233, 2, 640x360 
0x1382CA98, 37353953550572992, 90396265, 90396269, 4, 640x360 
0x1382CA98, 37353953550900368, 90396291, 90396294, 3, 640x360 
0x1382CA98, 37353953551209440, 90396324, 90396326, 2, 640x360 
0x1382CA98, 37353953551534584, 90396361, 90396363, 2, 640x360 
0x1382CA98, 37353953551853392, 90396393, 90396403, 10, 640x360 
0x1382CA98, 37353953552170296, 90396421, 90396424, 3, 640x360 
0x1382CA98, 37353953552489744, 90396454, 90396456, 2, 640x360 
0x1382CA98, 37353953552813440, 90396487, 90396490, 3, 640x360 
0x1382CA98, 37353953553133760, 90396516, 90396521, 5, 640x360 
0x1382CA98, 37353953553458960, 90396549, 90396560, 11, 640x360 
0x1382CA98, 37353953553932440, 90396601, 90396612, 11, 640x360 
0x1382CA98, 37353953554249712, 90396631, 90396633, 2, 640x360 
0x1382CA98, 37353953554573848, 90396667, 90396678, 11, 640x360 
0x1382CA98, 37353953554896856, 90396699, 90396704, 5, 640x360 
0x1382CA98, 37353953555224352, 90396729, 90396731, 2, 640x360 
0x1382CA98, 37353953555534896, 90396757, 90396760, 3, 640x360 
0x1382CA98, 37353953555851984, 90396793, 90396795, 2, 640x360 
0x1382CA98, 37353953556187576, 90396826, 90396828, 2, 640x360 
0x1382CA98, 37353953556503128, 90396859, 90396861, 2, 640x360 
0x1382CA98, 37353953556822128, 90396894, 90396902, 8, 640x360 
0x1382CA98, 37353953557133920, 90396940, 90396952, 12, 640x360 
0x1382CA98, 37353953557459784, 90396961, 90396970, 9, 640x360 
0x1382CA98, 37353953557928736, 90397008, 90397011, 3, 640x360 
0x1382CA98, 37353953558261384, 90397041, 90397053, 12, 640x360 
0x1382CA98, 37353953558636384, 90397079, 90397085, 6, 640x360 
0x1382CA98, 37353953558889184, 90397107, 90397110, 3, 640x360 
0x1382CA98, 37353953559209920, 90397141, 90397144, 3, 640x360 
0x1382CA98, 37353953559537664, 90397164, 90397166, 2, 640x360 
0x1382CA98, 37353953559852288, 90397194, 90397196, 2, 640x360 
0x1382CA98, 37353953560178816, 90397225, 90397228, 3, 640x360 
0x1382CA98, 37353953560488912, 90397259, 90397260, 1, 640x360 
0x1382CA98, 37353953560809680, 90397289, 90397291, 2, 640x360 
0x1382CA98, 37353953561129152, 90397313, 90397317, 4, 640x360 
0x1382CA98, 37353953561458176, 90397355, 90397363, 8, 640x360 
0x1382CA98, 37353953561928552, 90397405, 90397408, 3, 640x360 
0x1382CA98, 37353953562249096, 90397430, 90397432, 2, 640x360 
0x1382CA98, 37353953562568376, 90397468, 90397471, 3, 640x360 
0x1382CA98, 37353953562900248, 90397504, 90397507, 3, 640x360 
0x1382CA98, 37353953563208144, 90397530, 90397533, 3, 640x360 
0x1382CA98, 37353953563532240, 90397564, 90397566, 2, 640x360 
0x1382CA98, 37353953563852568, 90397590, 90397593, 3, 640x360 
0x1382CA98, 37353953564169760, 90397625, 90397628, 3, 640x360 
0x1382CA98, 37353953564489528, 90397648, 90397657, 9, 640x360 
0x1382CA98, 37353953564812064, 90397684, 90397691, 7, 640x360 
0x1382CA98, 37353953565132968, 90397724, 90397726, 2, 640x360 
0x1382CA98, 37353953565453368, 90397748, 90397751, 3, 640x360 
0x1382CA98, 37353953565930232, 90397804, 90397806, 2, 640x360 
0x1382CA98, 37353953566254704, 90397830, 90397832, 2, 640x360 
0x1382CA98, 37353953566573280, 90397862, 90397864, 2, 640x360 
0x1382CA98, 37353953566891152, 90397896, 90397898, 2, 640x360 
0x1382CA98, 37353953567208824, 90397925, 90397931, 6, 640x360 
0x1382CA98, 37353953567529120, 90397958, 90397960, 2, 640x360 
0x1382CA98, 37353953567848968, 90397989, 90397992, 3, 640x360 
0x1382CA98, 37353953568170312, 90398022, 90398025, 3, 640x360 
0x1382CA98, 37353953568489320, 90398052, 90398055, 3, 640x360 
0x1382CA98, 37353953568808592, 90398081, 90398091, 10, 640x360 
0x1382CA98, 37353953569129400, 90398114, 90398117, 3, 640x360 
0x1382CA98, 37353953569453656, 90398148, 90398160, 12, 640x360 
0x1382CA98, 37353953569774968, 90398182, 90398192, 10, 640x360 
0x1382CA98, 37353953570251872, 90398234, 90398237, 3, 640x360 
0x1382CA98, 37353953570570896, 90398264, 90398266, 2, 640x360 
0x1382CA98, 37353953570891616, 90398295, 90398297, 2, 640x360 
0x1382CA98, 37353953571209088, 90398327, 90398331, 4, 640x360 
0x1382CA98, 37353953571529024, 90398359, 90398362, 3, 640x360 
0x1382CA98, 37353953571849048, 90398390, 90398393, 3, 640x360 
0x1382CA98, 37353953572171872, 90398430, 90398456, 26, 640x360 
0x1382CA98, 37353953572491096, 90398458, 90398462, 4, 640x360 
0x1382CA98, 37353953572809160, 90398491, 90398493, 2, 640x360 
0x1382CA98, 37353953573128672, 90398516, 90398526, 10, 640x360 
0x1382CA98, 37353953573461840, 90398554, 90398562, 8, 640x360 
0x1382CA98, 37353953573782664, 90398580, 90398587, 7, 640x360 
0x1382CA98, 37353953574251768, 90398634, 90398644, 10, 640x360 
0x1382CA98, 37353953574567872, 90398670, 90398673, 3, 640x360 
0x1382CA98, 37353953574891176, 90398695, 90398702, 7, 640x360 
0x1382CA98, 37353953575213728, 90398725, 90398727, 2, 640x360 
0x1382CA98, 37353953575527928, 90398757, 90398760, 3, 640x360 
0x1382CA98, 37353953575847968, 90398791, 90398793, 2, 640x360 
0x1382CA98, 37353953576168440, 90398833, 90398838, 5, 640x360 
0x1382CA98, 37353953576488184, 90398855, 90398857, 2, 640x360 
0x1382CA98, 37353953576810024, 90398889, 90398891, 2, 640x360 
0x1382CA98, 37353953577128416, 90398914, 90398917, 3, 640x360 
0x1382CA98, 37353953577448280, 90398949, 90398951, 2, 640x360 
0x1382CA98, 37353953577774848, 90398987, 90398992, 5, 640x360 
0x1382CA98, 37353953578247880, 90399026, 90399029, 3, 640x360 
0x1382CA98, 37353953578605600, 90399063, 90399071, 8, 640x360 
0x1382CA98, 37353953578888456, 90399090, 90399096, 6, 640x360 
0x1382CA98, 37353953579211912, 90399120, 90399124, 4, 640x360 
0x1382CA98, 37353953579528408, 90399155, 90399158, 3, 640x360 
0x1382CA98, 37353953579848224, 90399187, 90399190, 3, 640x360 
0x1382CA98, 37353953580168600, 90399224, 90399226, 2, 640x360 
0x1382CA98, 37353953580491632, 90399255, 90399257, 2, 640x360 
0x1382CA98, 37353953580812992, 90399287, 90399290, 3, 640x360 
0x1382CA98, 37353953581133400, 90399324, 90399327, 3, 640x360 
0x1382CA98, 37353953581451728, 90399360, 90399362, 2, 640x360 
0x1382CA98, 37353953581769920, 90399382, 90399387, 5, 640x360 
0x1382CA98, 37353953582248552, 90399428, 90399430, 2, 640x360 
0x1382CA98, 37353953582572712, 90399464, 90399466, 2, 640x360 
0x1382CA98, 37353953582894512, 90399506, 90399509, 3, 640x360 
0x1382CA98, 37353953583209576, 90399525, 90399528, 3, 640x360 
0x1382CA98, 37353953583528280, 90399564, 90399566, 2, 640x360 
0x1382CA98, 37353953583852248, 90399597, 90399599, 2, 640x360 
0x1382CA98, 37353953584204024, 90399628, 90399631, 3, 640x360 
0x1382CA98, 37353953584494072, 90399659, 90399662, 3, 640x360 
0x1382CA98, 37353953584817088, 90399695, 90399699, 4, 640x360 
0x1382CA98, 37353953585142160, 90399725, 90399728, 3, 640x360 
0x1382CA98, 37353953585454232, 90399769, 90399774, 5, 640x360 
0x1382CA98, 37353953585781408, 90399792, 90399795, 3, 640x360 
0x1382CA98, 37353953586305184, 90399843, 90399852, 9, 640x360 
0x1382CA98, 37353953586606800, 90399875, 90399878, 3, 640x360 
0x1382CA98, 37353953586892696, 90399904, 90399913, 9, 640x360 
0x1382CA98, 37353953587221608, 90399929, 90399931, 2, 640x360 
0x1382CA98, 37353953587529208, 90399958, 90399961, 3, 640x360 
0x1382CA98, 37353953587848016, 90399991, 90399993, 2, 640x360 
0x1382CA98, 37353953588172784, 90400030, 90400032, 2, 640x360 
0x1382CA98, 37353953588487816, 90400052, 90400059, 7, 640x360 
0x1382CA98, 37353953588811840, 90400084, 90400087, 3, 640x360 
0x1382CA98, 37353953589128960, 90400115, 90400123, 8, 640x360 
0x1382CA98, 37353953589449432, 90400145, 90400147, 2, 640x360 
0x1382CA98, 37353953589770296, 90400176, 90400179, 3, 640x360 
0x1382CA98, 37353953590247496, 90400229, 90400233, 4, 640x360 
0x1382CA98, 37353953590582608, 90400262, 90400264, 2, 640x360 
0x1382CA98, 37353953590890400, 90400293, 90400296, 3, 640x360 
0x1382CA98, 37353953591214016, 90400325, 90400328, 3, 640x360 
0x1382CA98, 37353953591536000, 90400364, 90400366, 2, 640x360 
0x1382CA98, 37353953591848376, 90400389, 90400391, 2, 640x360 
0x1382CA98, 37353953592168504, 90400426, 90400437, 11, 640x360 
0x1382CA98, 37353953592492520, 90400459, 90400461, 2, 640x360 
0x1382CA98, 37353953592812944, 90400483, 90400489, 6, 640x360 
0x1382CA98, 37353953593129152, 90400514, 90400517, 3, 640x360 
0x1382CA98, 37353953593448664, 90400550, 90400556, 6, 640x360 
0x1382CA98, 37353953593768784, 90400582, 90400586, 4, 640x360 
0x1382CA98, 37353953594248280, 90400631, 90400642, 11, 640x360 
0x1382CA98, 37353953594567632, 90400666, 90400671, 5, 640x360 
0x1382CA98, 37353953594888080, 90400694, 90400696, 2, 640x360 
0x1382CA98, 37353953595208496, 90400724, 90400726, 2, 640x360 
0x1382CA98, 37353953595528488, 90400761, 90400763, 2, 640x360 
0x1382CA98, 37353953595849352, 90400792, 90400794, 2, 640x360 
0x1382CA98, 37353953596168656, 90400824, 90400826, 2, 640x360 
0x1382CA98, 37353953596489256, 90400857, 90400860, 3, 640x360 
0x1382CA98, 37353953596813008, 90400886, 90400893, 7, 640x360 
0x1382CA98, 37353953597129480, 90400922, 90400924, 2, 640x360 
0x1382CA98, 37353953597448368, 90400947, 90400958, 11, 640x360 
0x1382CA98, 37353953597768568, 90400987, 90400992, 5, 640x360 
0x1382CA98, 37353953598088920, 90401014, 90401024, 10, 640x360 
0x1382CA98, 37353953598572416, 90401066, 90401071, 5, 640x360 
0x1382CA98, 37353953598887200, 90401096, 90401098, 2, 640x360 
0x1382CA98, 37353953599207688, 90401129, 90401142, 13, 640x360 
0x1382CA98, 37353953599534840, 90401159, 90401161, 2, 640x360 
0x1382CA98, 37353953599851672, 90401192, 90401194, 2, 640x360 
0x1382CA98, 37353953600173864, 90401230, 90401232, 2, 640x360 
0x1382CA98, 37353953600488720, 90401258, 90401267, 9, 640x360 
0x1382CA98, 37353953600808288, 90401293, 90401295, 2, 640x360 
0x1382CA98, 37353953601133424, 90401319, 90401331, 12, 640x360 
0x1382CA98, 37353953601456984, 90401355, 90401364, 9, 640x360 
0x1382CA98, 37353953601768736, 90401386, 90401392, 6, 640x360 
0x1382CA98, 37353953602121016, 90401427, 90401436, 9, 640x360 
0x1382CA98, 37353953602567416, 90401465, 90401481, 16, 640x360 
0x1382CA98, 37353953602893616, 90401505, 90401514, 9, 640x360 
0x1382CA98, 37353953603214176, 90401530, 90401540, 10, 640x360 
0x1382CA98, 37353953603531648, 90401576, 90401579, 3, 640x360 
0x1382CA98, 37353953603854336, 90401597, 90401603, 6, 640x360 
0x1382CA98, 37353953604169752, 90401634, 90401638, 4, 640x360 
0x1382CA98, 37353953604489768, 90401659, 90401662, 3, 640x360 
0x1382CA98, 37353953604808552, 90401681, 90401684, 3, 640x360 
0x1382CA98, 37353953605132248, 90401714, 90401719, 5, 640x360 
0x1382CA98, 37353953605448000, 90401746, 90401748, 2, 640x360 
0x1382CA98, 37353953605789512, 90401781, 90401785, 4, 640x360 
0x1382CA98, 37353953606090664, 90401814, 90401822, 8, 640x360 
0x1382CA98, 37353953606571264, 90401871, 90401880, 9, 640x360 
0x1382CA98, 37353953606893808, 90401903, 90401913, 10, 640x360 
0x1382CA98, 37353953607212320, 90401935, 90401939, 4, 640x360 
0x1382CA98, 37353953607537896, 90401965, 90401971, 6, 640x360 
0x1382CA98, 37353953607848048, 90401997, 90402001, 4, 640x360 
0x1382CA98, 37353953608171008, 90402031, 90402033, 2, 640x360 
0x1382CA98, 37353953608499048, 90402063, 90402064, 1, 640x360 
0x1382CA98, 37353953608821128, 90402093, 90402094, 1, 640x360 
0x1382CA98, 37353953609132584, 90402119, 90402129, 10, 640x360 
0x1382CA98, 37353953609472456, 90402157, 90402160, 3, 640x360 
0x1382CA98, 37353953609772328, 90402193, 90402203, 10, 640x360 
0x1382CA98, 37353953610114200, 90402216, 90402228, 12, 640x360 
0x1382CA98, 37353953610567112, 90402262, 90402265, 3, 640x360 
0x1382CA98, 37353953610887960, 90402304, 90402312, 8, 640x360 
0x1382CA98, 37353953611209968, 90402328, 90402335, 7, 640x360 
0x1382CA98, 37353953611526992, 90402360, 90402362, 2, 640x360 
0x1382CA98, 37353953611847104, 90402400, 90402410, 10, 640x360 
0x1382CA98, 37353953612169960, 90402430, 90402432, 2, 640x360 
0x1382CA98, 37353953612490336, 90402462, 90402464, 2, 640x360 
0x1382CA98, 37353953612857216, 90402496, 90402501, 5, 640x360 
0x1382CA98, 37353953613129528, 90402541, 90402550, 9, 640x360 
0x1382CA98, 37353953613456320, 90402563, 90402597, 34, 640x360 
0x1382CA98, 37353953613785248, 90402617, 90402625, 8, 640x360 
0x1382CA98, 37353953614122016, 90402637, 90402641, 4, 640x360 
0x1382CA98, 37353953614649808, 90402704, 90402707, 3, 640x360 
0x1382CA98, 37353953614900592, 90402720, 90402738, 18, 640x360 
0x1382CA98, 37353953615228768, 90402763, 90402782, 19, 640x360 
0x1382CA98, 37353953615595120, 90402782, 90402793, 11, 640x360 
0x1382CA98, 37353953615874672, 90402804, 90402821, 17, 640x360 
0x1382CA98, 37353953616179272, 90402840, 90402843, 3, 640x360 
0x1382CA98, 37353953616496552, 90402874, 90402877, 3, 640x360 
0x1382CA98, 37353953616820272, 90402898, 90402913, 15, 640x360 
0x1382CA98, 37353953617148176, 90402950, 90402963, 13, 640x360 
0x1382CA98, 37353953617472736, 90402963, 90402987, 24, 640x360 
0x1382CA98, 37353953617778848, 90403007, 90403020, 13, 640x360 
0x1382CA98, 37353953618100984, 90403027, 90403030, 3, 640x360 
0x1382CA98, 37353953618571048, 90403072, 90403081, 9, 640x360 
0x1382CA98, 37353953618893120, 90403093, 90403101, 8, 640x360 
0x1382CA98, 37353953619206576, 90403124, 90403136, 12, 640x360 
0x1382CA98, 37353953619529248, 90403160, 90403165, 5, 640x360 
0x1382CA98, 37353953619846864, 90403191, 90403197, 6, 640x360 
0x1382CA98, 37353953620171200, 90403226, 90403229, 3, 640x360 
0x1382CA98, 37353953620488128, 90403251, 90403265, 14, 640x360 
0x1382CA98, 37353953620811616, 90403287, 90403289, 2, 640x360 
0x1382CA98, 37353953621127760, 90403311, 90403314, 3, 640x360 
0x1382CA98, 37353953621468344, 90403353, 90403362, 9, 640x360 
0x1382CA98, 37353953621788032, 90403381, 90403385, 4, 640x360 
0x1382CA98, 37353953622087912, 90403413, 90403418, 5, 640x360 
0x1382CA98, 37353953622566680, 90403466, 90403471, 5, 640x360 
0x1382CA98, 37353953622900784, 90403496, 90403498, 2, 640x360 
0x1382CA98, 37353953623209496, 90403529, 90403531, 2, 640x360 
0x1382CA98, 37353953623526912, 90403557, 90403560, 3, 640x360 
0x1382CA98, 37353953623855752, 90403592, 90403594, 2, 640x360 
0x1382CA98, 37353953624175176, 90403624, 90403626, 2, 640x360 
0x1382CA98, 37353953624499336, 90403664, 90403666, 2, 640x360 
0x1382CA98, 37353953624809944, 90403688, 90403691, 3, 640x360 
0x1382CA98, 37353953625127968, 90403715, 90403723, 8, 640x360 
0x1382CA98, 37353953625452496, 90403748, 90403756, 8, 640x360 
0x1382CA98, 37353953625783528, 90403780, 90403784, 4, 640x360 
0x1382CA98, 37353953626087608, 90403817, 90403823, 6, 640x360 
0x1382CA98, 37353953626433680, 90403855, 90403857, 2, 640x360 
0x1382CA98, 37353953626887432, 90403896, 90403901, 5, 640x360 
0x1382CA98, 37353953627213760, 90403939, 90403951, 12, 640x360 
0x1382CA98, 37353953627528240, 90403969, 90403972, 3, 640x360 
0x1382CA98, 37353953627853008, 90403990, 90404002, 12, 640x360 
0x1382CA98, 37353953628167144, 90404022, 90404028, 6, 640x360 
0x1382CA98, 37353953628497360, 90404055, 90404065, 10, 640x360 
0x1382CA98, 37353953628814032, 90404082, 90404085, 3, 640x360 
0x1382CA98, 37353953629126912, 90404111, 90404113, 2, 640x360 
0x1382CA98, 37353953629461648, 90404147, 90404151, 4, 640x360 
0x1382CA98, 37353953629773080, 90404189, 90404199, 10, 640x360 
0x1382CA98, 37353953630090688, 90404217, 90404219, 2, 640x360 
0x1382CA98, 37353953630406960, 90404243, 90404254, 11, 640x360 
0x1382CA98, 37353953630886392, 90404300, 90404302, 2, 640x360 
0x1382CA98, 37353953631207056, 90404326, 90404329, 3, 640x360 
0x1382CA98, 37353953631527032, 90404363, 90404365, 2, 640x360 
0x1382CA98, 37353953631851816, 90404403, 90404406, 3, 640x360 
0x1382CA98, 37353953632168112, 90404435, 90404446, 11, 640x360 
0x1382CA98, 37353953632489320, 90404459, 90404461, 2, 640x360 
0x1382CA98, 37353953632811440, 90404489, 90404500, 11, 640x360 
0x1382CA98, 37353953633136640, 90404525, 90404528, 3, 640x360 
0x1382CA98, 37353953633451488, 90404549, 90404561, 12, 640x360 
0x1382CA98, 37353953633771464, 90404584, 90404593, 9, 640x360 
0x1382CA98, 37353953634092048, 90404614, 90404617, 3, 640x360 
0x1382CA98, 37353953634406720, 90404646, 90404648, 2, 640x360 
0x1382CA98, 37353953634890640, 90404696, 90404698, 2, 640x360 
0x1382CA98, 37353953635206864, 90404725, 90404728, 3, 640x360 
0x1382CA98, 37353953635531288, 90404758, 90404764, 6, 640x360 
0x1382CA98, 37353953635855512, 90404792, 90404797, 5, 640x360 
0x1382CA98, 37353953636175392, 90404831, 90404833, 2, 640x360 
0x1382CA98, 37353953636541456, 90404858, 90404860, 2, 640x360 
0x1382CA98, 37353953636810312, 90404899, 90404904, 5, 640x360 
0x1382CA98, 37353953637132352, 90404925, 90404933, 8, 640x360 
0x1382CA98, 37353953637453064, 90404954, 90404956, 2, 640x360 
0x1382CA98, 37353953637776424, 90404987, 90404989, 2, 640x360 
0x1382CA98, 37353953638088056, 90405020, 90405022, 2, 640x360 
0x1382CA98, 37353953638411240, 90405053, 90405056, 3, 640x360 
0x1382CA98, 37353953638887240, 90405098, 90405102, 4, 640x360 
0x1382CA98, 37353953639214800, 90405126, 90405132, 6, 640x360 
0x1382CA98, 37353953639536376, 90405167, 90405172, 5, 640x360 
0x1382CA98, 37353953639848624, 90405192, 90405204, 12, 640x360 
0x1382CA98, 37353953640170448, 90405231, 90405233, 2, 640x360 
0x1382CA98, 37353953640493304, 90405250, 90405261, 11, 640x360 
0x1382CA98, 37353953640806880, 90405292, 90405297, 5, 640x360 
0x1382CA98, 37353953641132672, 90405321, 90405330, 9, 640x360 
0x1382CA98, 37353953641466344, 90405355, 90405360, 5, 640x360 
0x1382CA98, 37353953641771920, 90405384, 90405389, 5, 640x360 
0x1382CA98, 37353953642092552, 90405423, 90405426, 3, 640x360 
0x1382CA98, 37353953642413240, 90405448, 90405451, 3, 640x360 
0x1382CA98, 37353953642885872, 90405507, 90405509, 2, 640x360 
0x1382CA98, 37353953643214960, 90405535, 90405546, 11, 640x360 
0x1382CA98, 37353953643530976, 90405561, 90405567, 6, 640x360 
0x1382CA98, 37353953643848344, 90405590, 90405593, 3, 640x360 
0x1382CA98, 37353953644166048, 90405619, 90405634, 15, 640x360 
0x1382CA98, 37353953644489016, 90405654, 90405656, 2, 640x360 
0x1382CA98, 37353953644806776, 90405680, 90405683, 3, 640x360 
0x1382CA98, 37353953645128472, 90405716, 90405728, 12, 640x360 
0x1382CA98, 37353953645456416, 90405748, 90405756, 8, 640x360 
0x1382CA98, 37353953645785528, 90405784, 90405786, 2, 640x360 
0x1382CA98, 37353953646090864, 90405815, 90405820, 5, 640x360 
0x1382CA98, 37353953646409784, 90405849, 90405853, 4, 640x360 
0x1382CA98, 37353953646885904, 90405893, 90405896, 3, 640x360 
0x1382CA98, 37353953647218072, 90405934, 90405938, 4, 640x360 
0x1382CA98, 37353953647532048, 90405959, 90405964, 5, 640x360 
0x1382CA98, 37353953647846984, 90405992, 90405998, 6, 640x360 
0x1382CA98, 37353953648176304, 90406028, 90406030, 2, 640x360 
0x1382CA98, 37353953648501120, 90406067, 90406080, 13, 640x360 
0x1382CA98, 37353953648812608, 90406094, 90406096, 2, 640x360 
0x1382CA98, 37353953649132144, 90406120, 90406123, 3, 640x360 
0x1382CA98, 37353953649453160, 90406148, 90406151, 3, 640x360 
0x1382CA98, 37353953649768512, 90406187, 90406196, 9, 640x360 
0x1382CA98, 37353953650087632, 90406224, 90406231, 7, 640x360 
0x1382CA98, 37353953650407968, 90406254, 90406258, 4, 640x360 
0x1382CA98, 37353953650892056, 90406295, 90406297, 2, 640x360 
0x1382CA98, 37353953651210104, 90406327, 90406330, 3, 640x360 
0x1382CA98, 37353953651532656, 90406357, 90406367, 10, 640x360 
0x1382CA98, 37353953651848024, 90406391, 90406394, 3, 640x360 
0x1382CA98, 37353953652169776, 90406424, 90406426, 2, 640x360 
0x1382CA98, 37353953652494704, 90406455, 90406463, 8, 640x360 
0x1382CA98, 37353953652807208, 90406487, 90406494, 7, 640x360 
0x1382CA98, 37353953653128520, 90406519, 90406529, 10, 640x360 
0x1382CA98, 37353953653461120, 90406547, 90406550, 3, 640x360 
0x1382CA98, 37353953653783000, 90406586, 90406593, 7, 640x360 
0x1382CA98, 37353953654089464, 90406622, 90406628, 6, 640x360 
0x1382CA98, 37353953654406864, 90406650, 90406655, 5, 640x360 
0x1382CA98, 37353953654730992, 90406686, 90406695, 9, 640x360 
0x1382CA98, 37353953655206368, 90406732, 90406734, 2, 640x360 
0x1382CA98, 37353953655526200, 90406757, 90406763, 6, 640x360 
0x1382CA98, 37353953655852328, 90406799, 90406802, 3, 640x360 
0x1382CA98, 37353953656170744, 90406833, 90406836, 3, 640x360 
0x1382CA98, 37353953656491216, 90406851, 90406863, 12, 640x360 
0x1382CA98, 37353953656806856, 90406892, 90406898, 6, 640x360 
0x1382CA98, 37353953657129664, 90406928, 90406931, 3, 640x360 
0x1382CA98, 37353953657451888, 90406949, 90406953, 4, 640x360 
0x1382CA98, 37353953657771728, 90406981, 90406985, 4, 640x360 
0x1382CA98, 37353953658086856, 90407015, 90407022, 7, 640x360 
0x1382CA98, 37353953658406664, 90407049, 90407052, 3, 640x360 
0x1382CA98, 37353953658726200, 90407087, 90407090, 3, 640x360 
0x1382CA98, 37353953659221040, 90407135, 90407145, 10, 640x360 
0x1382CA98, 37353953659534968, 90407166, 90407170, 4, 640x360 
0x1382CA98, 37353953659847288, 90407189, 90407195, 6, 640x360 
0x1382CA98, 37353953660171928, 90407232, 90407235, 3, 640x360 
0x1382CA98, 37353953660486496, 90407257, 90407263, 6, 640x360 
0x1382CA98, 37353953660805736, 90407298, 90407300, 2, 640x360 
0x1382CA98, 37353953661127304, 90407315, 90407320, 5, 640x360 
0x1382CA98, 37353953661460400, 90407351, 90407362, 11, 640x360 
0x1382CA98, 37353953661772504, 90407381, 90407385, 4, 640x360 
0x1382CA98, 37353953662086496, 90407416, 90407421, 5, 640x360 
0x1382CA98, 37353953662406032, 90407456, 90407459, 3, 640x360 
0x1382CA98, 37353953662729864, 90407489, 90407492, 3, 640x360 
0x1382CA98, 37353953663218456, 90407532, 90407536, 4, 640x360 
0x1382CA98, 37353953663530464, 90407563, 90407564, 1, 640x360 
0x1382CA98, 37353953663847016, 90407597, 90407599, 2, 640x360 
0x1382CA98, 37353953664180696, 90407626, 90407629, 3, 640x360 
0x1382CA98, 37353953664505168, 90407662, 90407664, 2, 640x360 
0x1382CA98, 37353953664822424, 90407693, 90407695, 2, 640x360 
0x1382CA98, 37353953665130960, 90407736, 90407749, 13, 640x360 
0x1382CA98, 37353953665459504, 90407764, 90407766, 2, 640x360 
0x1382CA98, 37353953665781080, 90407791, 90407793, 2, 640x360 
0x1382CA98, 37353953666086760, 90407838, 90407845, 7, 640x360 
0x1382CA98, 37353953666406880, 90407872, 90407880, 8, 640x360 
0x1382CA98, 37353953666732544, 90407891, 90407903, 12, 640x360 
0x1382CA98, 37353953667210760, 90407930, 90407934, 4, 640x360 
0x1382CA98, 37353953667532496, 90407971, 90407981, 10, 640x360 
0x1382CA98, 37353953667849416, 90408011, 90408014, 3, 640x360 
0x1382CA98, 37353953668169312, 90408038, 90408060, 22, 640x360 
0x1382CA98, 37353953668509696, 90408072, 90408091, 19, 640x360 
0x1382CA98, 37353953668814272, 90408095, 90408099, 4, 640x360 
0x1382CA98, 37353953669140608, 90408143, 90408164, 21, 640x360 
0x1382CA98, 37353953669473424, 90408178, 90408187, 9, 640x360 
0x1382CA98, 37353953669841280, 90408197, 90408202, 5, 640x360 
0x1382CA98, 37353953670112456, 90408242, 90408247, 5, 640x360 
0x1382CA98, 37353953670451384, 90408278, 90408290, 12, 640x360 
0x1382CA98, 37353953670746008, 90408297, 90408304, 7, 640x360 
0x1382CA98, 37353953671222144, 90408355, 90408373, 18, 640x360 
0x1382CA98, 37353953671535456, 90408383, 90408398, 15, 640x360 
0x1382CA98, 37353953671869352, 90408415, 90408458, 43, 640x360 
0x1382CA98, 37353953672237608, 90408460, 90408471, 11, 640x360 
0x1382CA98, 37353953672524136, 90408471, 90408549, 78, 640x360 
0x1382CA98, 37353953672882864, 90408550, 90408565, 15, 640x360 
0x1382CA98, 37353953673459904, 90408568, 90408607, 39, 640x360 
0x1382CA98, 37353953673782584, 90408650, 90408681, 31, 640x360 
0x1382CA98, 37353953674576648, 90408691, 90408701, 10, 640x360 
0x1382CA98, 37353953674904872, 90408733, 90408739, 6, 640x360 
0x1382CA98, 37353953675211392, 90408775, 90408781, 6, 640x360 
0x1382CA98, 37353953675862912, 90408799, 90408821, 22, 640x360 
0x1382CA98, 37353953676170456, 90408842, 90408846, 4, 640x360 
0x1382CA98, 37353953676508592, 90408870, 90408881, 11, 640x360 
0x1382CA98, 37353953676836976, 90408907, 90408913, 6, 640x360 
0x1382CA98, 37353953677144344, 90408929, 90408939, 10, 640x360 
0x1382CA98, 37353953677473000, 90408964, 90408966, 2, 640x360 
0x1382CA98, 37353953677777344, 90408989, 90408997, 8, 640x360 
0x1382CA98, 37353953678087088, 90409016, 90409023, 7, 640x360 
0x1382CA98, 37353953678405440, 90409055, 90409057, 2, 640x360 
0x1382CA98, 37353953678731240, 90409089, 90409091, 2, 640x360 
0x1382CA98, 37353953679050296, 90409119, 90409122, 3, 640x360 
0x1382CA98, 37353953679526984, 90409168, 90409192, 24, 640x360 
0x1382CA98, 37353953679850104, 90409193, 90409203, 10, 640x360 
0x1382CA98, 37353953680167688, 90409240, 90409244, 4, 640x360 
0x1382CA98, 37353953680492552, 90409259, 90409262, 3, 640x360 
0x1382CA98, 37353953680815656, 90409290, 90409294, 4, 640x360 
0x1382CA98, 37353953681125336, 90409334, 90409356, 22, 640x360 
0x1382CA98, 37353953681487432, 90409360, 90409366, 6, 640x360 
0x1382CA98, 37353953681767024, 90409393, 90409396, 3, 640x360 
0x1382CA98, 37353953682086088, 90409424, 90409433, 9, 640x360 
0x1382CA98, 37353953682408200, 90409445, 90409448, 3, 640x360 
0x1382CA98, 37353953682725520, 90409487, 90409489, 2, 640x360 
0x1382CA98, 37353953683055176, 90409520, 90409523, 3, 640x360 
0x1382CA98, 37353953683544008, 90409560, 90409566, 6, 640x360 
0x1382CA98, 37353953683850304, 90409587, 90409590, 3, 640x360 
0x1382CA98, 37353953684168704, 90409623, 90409625, 2, 640x360 
0x1382CA98, 37353953684485552, 90409654, 90409664, 10, 640x360 
0x1382CA98, 37353953684805608, 90409687, 90409690, 3, 640x360 
0x1382CA98, 37353953685125912, 90409714, 90409716, 2, 640x360 
0x1382CA98, 37353953685445488, 90409746, 90409749, 3, 640x360 
0x1382CA98, 37353953685770368, 90409791, 90409794, 3, 640x360 
0x1382CA98, 37353953686086888, 90409817, 90409823, 6, 640x360 
0x1382CA98, 37353953686405592, 90409852, 90409856, 4, 640x360 
0x1382CA98, 37353953686726552, 90409886, 90409890, 4, 640x360 
0x1382CA98, 37353953687046160, 90409909, 90409912, 3, 640x360 
0x1382CA98, 37353953687538520, 90409966, 90409968, 2, 640x360 
0x1382CA98, 37353953687857704, 90409992, 90410004, 12, 640x360 
0x1382CA98, 37353953688166384, 90410034, 90410046, 12, 640x360 
0x1382CA98, 37353953688496752, 90410058, 90410061, 3, 640x360 
0x1382CA98, 37353953688814224, 90410089, 90410092, 3, 640x360 
0x1382CA98, 37353953689125256, 90410114, 90410117, 3, 640x360 
0x1382CA98, 37353953689445736, 90410158, 90410164, 6, 640x360 
0x1382CA98, 37353953689772080, 90410193, 90410196, 3, 640x360 
0x1382CA98, 37353953690090656, 90410226, 90410231, 5, 640x360 
0x1382CA98, 37353953690405248, 90410259, 90410264, 5, 640x360 
0x1382CA98, 37353953690726768, 90410289, 90410297, 8, 640x360 
0x1382CA98, 37353953691049648, 90410309, 90410319, 10, 640x360 
0x1382CA98, 37353953691524760, 90410359, 90410362, 3, 640x360 
0x1382CA98, 37353953691849224, 90410391, 90410401, 10, 640x360 
0x1382CA98, 37353953692177600, 90410426, 90410428, 2, 640x360 
0x1382CA98, 37353953692489856, 90410454, 90410465, 11, 640x360 
0x1382CA98, 37353953692836456, 90410491, 90410495, 4, 640x360 
0x1382CA98, 37353953693169944, 90410530, 90410532, 2, 640x360 
0x1382CA98, 37353953693493840, 90410567, 90410572, 5, 640x360 
0x1382CA98, 37353953693798520, 90410627, 90410639, 12, 640x360 
0x1382CA98, 37353953694110800, 90410656, 90410665, 9, 640x360 
0x1382CA98, 37353953694732280, 90410727, 90410737, 10, 640x360 
0x1382CA98, 37353953695104616, 90410750, 90410756, 6, 640x360 
0x1382CA98, 37353953695576480, 90410778, 90410781, 3, 640x360 
0x1382CA98, 37353953695851616, 90410799, 90410801, 2, 640x360 
0x1382CA98, 37353953696164744, 90410826, 90410832, 6, 640x360 
0x1382CA98, 37353953696485464, 90410859, 90410861, 2, 640x360 
0x1382CA98, 37353953696804848, 90410897, 90410900, 3, 640x360 
0x1382CA98, 37353953697133312, 90410926, 90410928, 2, 640x360 
0x1382CA98, 37353953697451736, 90410953, 90410956, 3, 640x360 
0x1382CA98, 37353953697776440, 90410984, 90410996, 12, 640x360 
0x1382CA98, 37353953698088680, 90411021, 90411024, 3, 640x360 
0x1382CA98, 37353953698411984, 90411057, 90411062, 5, 640x360 
0x1382CA98, 37353953698728688, 90411079, 90411082, 3, 640x360 
0x1382CA98, 37353953699049104, 90411109, 90411116, 7, 640x360 
0x1382CA98, 37353953699524528, 90411158, 90411160, 2, 640x360 
0x1382CA98, 37353953699846808, 90411198, 90411201, 3, 640x360 
0x1382CA98, 37353953700208472, 90411226, 90411228, 2, 640x360 
0x1382CA98, 37353953700500408, 90411262, 90411263, 1, 640x360 
0x1382CA98, 37353953700811656, 90411301, 90411305, 4, 640x360 
0x1382CA98, 37353953701128320, 90411328, 90411334, 6, 640x360 
0x1382CA98, 37353953701450208, 90411351, 90411354, 3, 640x360 
0x1382CA98, 37353953701771728, 90411380, 90411384, 4, 640x360 
0x1382CA98, 37353953702093000, 90411416, 90411419, 3, 640x360 
0x1382CA98, 37353953702404792, 90411445, 90411448, 3, 640x360 
0x1382CA98, 37353953702729904, 90411486, 90411497, 11, 640x360 
0x1382CA98, 37353953703051144, 90411522, 90411533, 11, 640x360 
0x1382CA98, 37353953703530872, 90411567, 90411580, 13, 640x360 
0x1382CA98, 37353953703847840, 90411599, 90411614, 15, 640x360 
0x1382CA98, 37353953704185712, 90411641, 90411651, 10, 640x360 
0x1382CA98, 37353953704490720, 90411660, 90411663, 3, 640x360 
0x1382CA98, 37353953704805344, 90411697, 90411701, 4, 640x360 
0x1382CA98, 37353953705146880, 90411735, 90411747, 12, 640x360 
0x1382CA98, 37353953705472336, 90411766, 90411772, 6, 640x360 
0x1382CA98, 37353953705806912, 90411804, 90411807, 3, 640x360 
0x1382CA98, 37353953706095152, 90411817, 90411826, 9, 640x360 
0x1382CA98, 37353953706412904, 90411874, 90411888, 14, 640x360 
0x1382CA98, 37353953706730016, 90411894, 90411904, 10, 640x360 
0x1382CA98, 37353953707065120, 90411939, 90411947, 8, 640x360 
0x1382CA98, 37353953707470616, 90411961, 90411965, 4, 640x360 
0x1382CA98, 37353953707870920, 90412000, 90412008, 8, 640x360 
0x1382CA98, 37353953708171640, 90412033, 90412040, 7, 640x360 
0x1382CA98, 37353953708490464, 90412066, 90412072, 6, 640x360 
0x1382CA98, 37353953708817384, 90412098, 90412100, 2, 640x360 
0x1382CA98, 37353953709134616, 90412126, 90412129, 3, 640x360 
0x1382CA98, 37353953709487464, 90412159, 90412163, 4, 640x360 
0x1382CA98, 37353953709840360, 90412199, 90412214, 15, 640x360 
0x1382CA98, 37353953710087888, 90412240, 90412245, 5, 640x360 
0x1382CA98, 37353953710406056, 90412249, 90412254, 5, 640x360 
0x1382CA98, 37353953710738312, 90412294, 90412297, 3, 640x360 
0x1382CA98, 37353953711045440, 90412310, 90412313, 3, 640x360 
0x1382CA98, 37353953711370576, 90412350, 90412361, 11, 640x360 
0x1382CA98, 37353953711856208, 90412398, 90412404, 6, 640x360 
0x1382CA98, 37353953712173608, 90412428, 90412431, 3, 640x360 
0x1382CA98, 37353953712505928, 90412459, 90412462, 3, 640x360 
0x1382CA98, 37353953712820800, 90412504, 90412512, 8, 640x360 
0x1382CA98, 37353953713136424, 90412527, 90412541, 14, 640x360 
0x1382CA98, 37353953713450776, 90412558, 90412562, 4, 640x360 
0x1382CA98, 37353953713777984, 90412584, 90412590, 6, 640x360 
0x1382CA98, 37353953714088520, 90412617, 90412623, 6, 640x360 
0x1382CA98, 37353953714405024, 90412650, 90412662, 12, 640x360 
0x1382CA98, 37353953714728176, 90412689, 90412697, 8, 640x360 
0x1382CA98, 37353953715049080, 90412715, 90412722, 7, 640x360 
0x1382CA98, 37353953715368800, 90412752, 90412763, 11, 640x360 
0x1382CA98, 37353953715847608, 90412802, 90412811, 9, 640x360 
0x1382CA98, 37353953716172072, 90412826, 90412829, 3, 640x360 
0x1382CA98, 37353953716484288, 90412857, 90412861, 4, 640x360 
0x1382CA98, 37353953716804728, 90412887, 90412892, 5, 640x360 
0x1382CA98, 37353953717125192, 90412917, 90412930, 13, 640x360 
0x1382CA98, 37353953717451888, 90412948, 90412952, 4, 640x360 
0x1382CA98, 37353953717768144, 90412985, 90412994, 9, 640x360 
0x1382CA98, 37353953718099808, 90413024, 90413030, 6, 640x360 
0x1382CA98, 37353953718409776, 90413047, 90413056, 9, 640x360 
0x1382CA98, 37353953718724272, 90413088, 90413095, 7, 640x360 
0x1382CA98, 37353953719046040, 90413121, 90413133, 12, 640x360 
0x1382CA98, 37353953719381368, 90413151, 90413161, 10, 640x360 
0x1382CA98, 37353953719854968, 90413199, 90413204, 5, 640x360 
0x1382CA98, 37353953720172168, 90413245, 90413255, 10, 640x360 
0x1382CA98, 37353953720507584, 90413261, 90413263, 2, 640x360 
0x1382CA98, 37353953720805176, 90413286, 90413296, 10, 640x360 
0x1382CA98, 37353953721131232, 90413322, 90413330, 8, 640x360 
0x1382CA98, 37353953721452976, 90413360, 90413362, 2, 640x360 
0x1382CA98, 37353953721767744, 90413395, 90413399, 4, 640x360 
0x1382CA98, 37353953722084312, 90413410, 90413413, 3, 640x360 
0x1382CA98, 37353953722405192, 90413448, 90413452, 4, 640x360 
0x1382CA98, 37353953722725016, 90413490, 90413497, 7, 640x360 
0x1382CA98, 37353953723062848, 90413524, 90413526, 2, 640x360 
0x1382CA98, 37353953723364872, 90413557, 90413560, 3, 640x360 
0x1382CA98, 37353953723847976, 90413599, 90413605, 6, 640x360 
0x1382CA98, 37353953724164472, 90413626, 90413630, 4, 640x360 
0x1382CA98, 37353953724491032, 90413670, 90413673, 3, 640x360 
0x1382CA98, 37353953724818488, 90413696, 90413699, 3, 640x360 
0x1382CA98, 37353953725125800, 90413730, 90413732, 2, 640x360 
0x1382CA98, 37353953725450056, 90413765, 90413768, 3, 640x360 
0x1382CA98, 37353953725773456, 90413793, 90413807, 14, 640x360 
0x1382CA98, 37353953726106016, 90413825, 90413828, 3, 640x360 
0x1382CA98, 37353953726405024, 90413856, 90413865, 9, 640x360 
0x1382CA98, 37353953726735456, 90413891, 90413893, 2, 640x360 
0x1382CA98, 37353953727044144, 90413914, 90413919, 5, 640x360 
0x1382CA98, 37353953727376080, 90413949, 90413953, 4, 640x360 
0x1382CA98, 37353953727843648, 90413996, 90413998, 2, 640x360 
0x1382CA98, 37353953728163608, 90414030, 90414032, 2, 640x360 
0x1382CA98, 37353953728488928, 90414053, 90414062, 9, 640x360 
0x1382CA98, 37353953728805024, 90414098, 90414101, 3, 640x360 
0x1382CA98, 37353953729133136, 90414143, 90414151, 8, 640x360 
0x1382CA98, 37353953729467424, 90414158, 90414160, 2, 640x360 
0x1382CA98, 37353953729764192, 90414184, 90414194, 10, 640x360 
0x1382CA98, 37353953730086776, 90414232, 90414238, 6, 640x360 
0x1382CA98, 37353953730404592, 90414260, 90414262, 2, 640x360 
0x1382CA98, 37353953730724160, 90414281, 90414286, 5, 640x360 
0x1382CA98, 37353953731045504, 90414310, 90414312, 2, 640x360 
0x1382CA98, 37353953731367064, 90414355, 90414359, 4, 640x360 
0x1382CA98, 37353953731848360, 90414397, 90414398, 1, 640x360 
0x1382CA98, 37353953732167768, 90414439, 90414442, 3, 640x360 
0x1382CA98, 37353953732498944, 90414458, 90414463, 5, 640x360 
0x1382CA98, 37353953732804448, 90414493, 90414498, 5, 640x360 
0x1382CA98, 37353953733124696, 90414522, 90414525, 3, 640x360 
0x1382CA98, 37353953733450784, 90414552, 90414557, 5, 640x360 
0x1382CA98, 37353953733774072, 90414585, 90414596, 11, 640x360 
0x1382CA98, 37353953734085200, 90414615, 90414618, 3, 640x360 
0x1382CA98, 37353953734403896, 90414643, 90414645, 2, 640x360 
0x1382CA98, 37353953734728136, 90414681, 90414690, 9, 640x360 
0x1382CA98, 37353953735048824, 90414714, 90414724, 10, 640x360 
0x1382CA98, 37353953735365248, 90414754, 90414757, 3, 640x360 
0x1382CA98, 37353953735698584, 90414780, 90414786, 6, 640x360 
0x1382CA98, 37353953736166520, 90414832, 90414836, 4, 640x360 
0x1382CA98, 37353953736484632, 90414859, 90414860, 1, 640x360 
0x1382CA98, 37353953736809648, 90414890, 90414893, 3, 640x360 
0x1382CA98, 37353953737133616, 90414932, 90414934, 2, 640x360 
0x1382CA98, 37353953737479968, 90414971, 90414976, 5, 640x360 
0x1382CA98, 37353953737768624, 90414994, 90414998, 4, 640x360 
0x1382CA98, 37353953738084840, 90415028, 90415043, 15, 640x360 
0x1382CA98, 37353953738423072, 90415059, 90415063, 4, 640x360 
0x1382CA98, 37353953738724880, 90415101, 90415124, 23, 640x360 
0x1382CA98, 37353953739064192, 90415131, 90415135, 4, 640x360 
0x1382CA98, 37353953739366840, 90415160, 90415163, 3, 640x360 
0x1382CA98, 37353953739688760, 90415188, 90415195, 7, 640x360 
0x1382CA98, 37353953740190528, 90415237, 90415248, 11, 640x360 
0x1382CA98, 37353953740487928, 90415264, 90415275, 11, 640x360 
0x1382CA98, 37353953740824640, 90415291, 90415297, 6, 640x360 
0x1382CA98, 37353953741135952, 90415322, 90415334, 12, 640x360 
0x1382CA98, 37353953741451224, 90415356, 90415358, 2, 640x360 
0x1382CA98, 37353953741766416, 90415382, 90415389, 7, 640x360 
0x1382CA98, 37353953742144808, 90415426, 90415433, 7, 640x360 
0x1382CA98, 37353953742476608, 90415456, 90415464, 8, 640x360 
0x1382CA98, 37353953742729424, 90415488, 90415491, 3, 640x360 
0x1382CA98, 37353953743049864, 90415513, 90415521, 8, 640x360 
0x1382CA98, 37353953743365968, 90415541, 90415547, 6, 640x360 
0x1382CA98, 37353953743691760, 90415581, 90415592, 11, 640x360 
0x1382CA98, 37353953744163184, 90415630, 90415632, 2, 640x360 
0x1382CA98, 37353953744496224, 90415658, 90415660, 2, 640x360 
0x1382CA98, 37353953744815504, 90415691, 90415694, 3, 640x360 
0x1382CA98, 37353953745124048, 90415715, 90415723, 8, 640x360 
0x1382CA98, 37353953745466512, 90415765, 90415777, 12, 640x360 
0x1382CA98, 37353953745775544, 90415794, 90415805, 11, 640x360 
0x1382CA98, 37353953746158008, 90415829, 90415839, 10, 640x360 
0x1382CA98, 37353953746438880, 90415848, 90415852, 4, 640x360 
0x1382CA98, 37353953746724336, 90415881, 90415883, 2, 640x360 
0x1382CA98, 37353953747051128, 90415913, 90415916, 3, 640x360 
0x1382CA98, 37353953747396248, 90415948, 90415950, 2, 640x360 
0x1382CA98, 37353953747697184, 90415976, 90415980, 4, 640x360 
0x1382CA98, 37353953748168352, 90416031, 90416033, 2, 640x360 
0x1382CA98, 37353953748490000, 90416050, 90416054, 4, 640x360 
0x1382CA98, 37353953748803832, 90416093, 90416107, 14, 640x360 
0x1382CA98, 37353953749148328, 90416131, 90416135, 4, 640x360 
0x1382CA98, 37353953749464328, 90416164, 90416167, 3, 640x360 
0x1382CA98, 37353953749766048, 90416192, 90416195, 3, 640x360 
0x1382CA98, 37353953750085152, 90416228, 90416240, 12, 640x360 
0x1382CA98, 37353953750413736, 90416271, 90416280, 9, 640x360 
0x1382CA98, 37353953750728784, 90416302, 90416313, 11, 640x360 
0x1382CA98, 37353953751065968, 90416335, 90416338, 3, 640x360 
0x1382CA98, 37353953751387160, 90416346, 90416354, 8, 640x360 
0x1382CA98, 37353953751684184, 90416376, 90416378, 2, 640x360 
0x1382CA98, 37353953752169912, 90416435, 90416455, 20, 640x360 
0x1382CA98, 37353953752533824, 90416467, 90416477, 10, 640x360 
0x1382CA98, 37353953752803800, 90416491, 90416504, 13, 640x360 
0x1382CA98, 37353953753138896, 90416529, 90416531, 2, 640x360 
0x1382CA98, 37353953753468264, 90416561, 90416563, 2, 640x360 
0x1382CA98, 37353953753786688, 90416589, 90416592, 3, 640x360 
0x1382CA98, 37353953754087376, 90416616, 90416621, 5, 640x360 
0x1382CA98, 37353953754405088, 90416648, 90416652, 4, 640x360 
0x1382CA98, 37353953754723880, 90416682, 90416687, 5, 640x360 
0x1382CA98, 37353953755046760, 90416715, 90416721, 6, 640x360 
0x1382CA98, 37353953755369144, 90416759, 90416771, 12, 640x360 
0x1382CA98, 37353953755689192, 90416788, 90416798, 10, 640x360 
0x1382CA98, 37353953756173488, 90416837, 90416861, 24, 640x360 
0x1382CA98, 37353953756508912, 90416869, 90416893, 24, 640x360 
0x1382CA98, 37353953756856552, 90416927, 90416931, 4, 640x360 
0x1382CA98, 37353953757152184, 90416940, 90416944, 4, 640x360 
0x1382CA98, 37353953757469312, 90416967, 90416979, 12, 640x360 
0x1382CA98, 37353953757777808, 90416993, 90417006, 13, 640x360 
0x1382CA98, 37353953758114224, 90417024, 90417027, 3, 640x360 
0x1382CA98, 37353953758459272, 90417053, 90417056, 3, 640x360 
0x1382CA98, 37353953758730512, 90417080, 90417083, 3, 640x360 
0x1382CA98, 37353953759053360, 90417113, 90417121, 8, 640x360 
0x1382CA98, 37353953759389192, 90417151, 90417156, 5, 640x360 
0x1382CA98, 37353953759688272, 90417179, 90417190, 11, 640x360 
0x1382CA98, 37353953760004384, 90417210, 90417212, 2, 640x360 
0x1382CA98, 37353953760483240, 90417267, 90417273, 6, 640x360 
0x1382CA98, 37353953760811216, 90417310, 90417312, 2, 640x360 
0x1382CA98, 37353953761136120, 90417327, 90417331, 4, 640x360 
0x1382CA98, 37353953761470160, 90417371, 90417385, 14, 640x360 
0x1382CA98, 37353953761779080, 90417402, 90417414, 12, 640x360 
0x1382CA98, 37353953762111848, 90417428, 90417440, 12, 640x360 
0x1382CA98, 37353953762437584, 90417456, 90417462, 6, 640x360 
0x1382CA98, 37353953762730440, 90417488, 90417497, 9, 640x360 
0x1382CA98, 37353953763058840, 90417523, 90417528, 5, 640x360 
0x1382CA98, 37353953763367624, 90417547, 90417555, 8, 640x360 
0x1382CA98, 37353953763695688, 90417589, 90417591, 2, 640x360 
0x1382CA98, 37353953764005864, 90417621, 90417625, 4, 640x360 
0x1382CA98, 37353953764485904, 90417663, 90417665, 2, 640x360 
0x1382CA98, 37353953764802960, 90417683, 90417687, 4, 640x360 
0x1382CA98, 37353953765123424, 90417712, 90417715, 3, 640x360 
0x1382CA98, 37353953765458696, 90417749, 90417753, 4, 640x360 
0x1382CA98, 37353953765765872, 90417788, 90417792, 4, 640x360 
0x1382CA98, 37353953766083368, 90417818, 90417824, 6, 640x360 
0x1382CA98, 37353953766472920, 90417874, 90417876, 2, 640x360 
0x1382CA98, 37353953766729000, 90417883, 90417887, 4, 640x360 
0x1382CA98, 37353953767043912, 90417925, 90417934, 9, 640x360 
0x1382CA98, 37353953767386304, 90417958, 90417963, 5, 640x360 
0x1382CA98, 37353953767686256, 90417982, 90417992, 10, 640x360 
0x1382CA98, 37353953768019040, 90418011, 90418023, 12, 640x360 
0x1382CA98, 37353953768486920, 90418063, 90418071, 8, 640x360 
0x1382CA98, 37353953768803456, 90418084, 90418096, 12, 640x360 
0x1382CA98, 37353953769122848, 90418128, 90418131, 3, 640x360 
0x1382CA98, 37353953769470448, 90418155, 90418163, 8, 640x360 
0x1382CA98, 37353953769770720, 90418192, 90418202, 10, 640x360 
0x1382CA98, 37353953770114208, 90418218, 90418222, 4, 640x360 
0x1382CA98, 37353953770410016, 90418245, 90418247, 2, 640x360 
0x1382CA98, 37353953770725760, 90418277, 90418280, 3, 640x360 
0x1382CA98, 37353953771043192, 90418316, 90418328, 12, 640x360 
0x1382CA98, 37353953771367608, 90418353, 90418363, 10, 640x360 
0x1382CA98, 37353953771712424, 90418387, 90418392, 5, 640x360 
0x1382CA98, 37353953772008264, 90418420, 90418423, 3, 640x360 
0x1382CA98, 37353953772482728, 90418455, 90418465, 10, 640x360 
0x1382CA98, 37353953772807976, 90418489, 90418499, 10, 640x360 
0x1382CA98, 37353953773124304, 90418525, 90418527, 2, 640x360 
0x1382CA98, 37353953773442728, 90418555, 90418557, 2, 640x360 
0x1382CA98, 37353953773768904, 90418586, 90418590, 4, 640x360 
0x1382CA98, 37353953774085672, 90418613, 90418616, 3, 640x360 
0x1382CA98, 37353953774413696, 90418646, 90418651, 5, 640x360 
0x1382CA98, 37353953774723616, 90418677, 90418679, 2, 640x360 
0x1382CA98, 37353953775044360, 90418709, 90418711, 2, 640x360 
0x1382CA98, 37353953775367640, 90418744, 90418746, 2, 640x360 
0x1382CA98, 37353953775687632, 90418782, 90418785, 3, 640x360 
0x1382CA98, 37353953776003744, 90418809, 90418811, 2, 640x360 
0x1382CA98, 37353953776483792, 90418852, 90418857, 5, 640x360 
0x1382CA98, 37353953776809728, 90418899, 90418902, 3, 640x360 
0x1382CA98, 37353953777129552, 90418916, 90418921, 5, 640x360 
0x1382CA98, 37353953777448096, 90418948, 90418953, 5, 640x360 
0x1382CA98, 37353953777769248, 90418981, 90418984, 3, 640x360 
0x1382CA98, 37353953778083312, 90419021, 90419029, 8, 640x360 
0x1382CA98, 37353953778403512, 90419048, 90419051, 3, 640x360 
0x1382CA98, 37353953778722848, 90419088, 90419091, 3, 640x360 
0x1382CA98, 37353953779045584, 90419108, 90419113, 5, 640x360 
0x1382CA98, 37353953779363408, 90419142, 90419149, 7, 640x360 
0x1382CA98, 37353953779687896, 90419182, 90419194, 12, 640x360 
0x1382CA98, 37353953780017088, 90419215, 90419222, 7, 640x360 
0x1382CA98, 37353953780494816, 90419261, 90419268, 7, 640x360 
0x1382CA98, 37353953780811152, 90419294, 90419296, 2, 640x360 
0x1382CA98, 37353953781125072, 90419325, 90419328, 3, 640x360 
0x1382CA98, 37353953781447024, 90419347, 90419350, 3, 640x360 
0x1382CA98, 37353953781783488, 90419400, 90419405, 5, 640x360 
0x1382CA98, 37353953782106624, 90419425, 90419428, 3, 640x360 
0x1382CA98, 37353953782406904, 90419454, 90419456, 2, 640x360 
0x1382CA98, 37353953782726608, 90419486, 90419498, 12, 640x360 
0x1382CA98, 37353953783048480, 90419515, 90419519, 4, 640x360 
0x1382CA98, 37353953783366304, 90419558, 90419563, 5, 640x360 
0x1382CA98, 37353953783688632, 90419581, 90419598, 17, 640x360 
0x1382CA98, 37353953784078400, 90419629, 90419631, 2, 640x360 
0x1382CA98, 37353953784488208, 90419664, 90419679, 15, 640x360 
0x1382CA98, 37353953784848912, 90419698, 90419702, 4, 640x360 
0x1382CA98, 37353953785145992, 90419731, 90419733, 2, 640x360 
0x1382CA98, 37353953785465480, 90419764, 90419766, 2, 640x360 
0x1382CA98, 37353953785762496, 90419794, 90419796, 2, 640x360 
0x1382CA98, 37353953786082592, 90419818, 90419828, 10, 640x360 
0x1382CA98, 37353953786404488, 90419850, 90419865, 15, 640x360 
0x1382CA98, 37353953786731568, 90419900, 90419905, 5, 640x360 
0x1382CA98, 37353953787047584, 90419913, 90419915, 2, 640x360 
0x1382CA98, 37353953787363048, 90419944, 90419946, 2, 640x360 
0x1382CA98, 37353953787682664, 90419975, 90419980, 5, 640x360 
0x1382CA98, 37353953788005216, 90420021, 90420025, 4, 640x360 
0x1382CA98, 37353953788324800, 90420048, 90420050, 2, 640x360 
0x1382CA98, 37353953788815184, 90420094, 90420096, 2, 640x360 
0x1382CA98, 37353953789128536, 90420127, 90420131, 4, 640x360 
0x1382CA98, 37353953789466160, 90420149, 90420154, 5, 640x360 
0x1382CA98, 37353953789784432, 90420198, 90420203, 5, 640x360 
0x1382CA98, 37353953790083256, 90420218, 90420230, 12, 640x360 
0x1382CA98, 37353953790403016, 90420248, 90420257, 9, 640x360 
0x1382CA98, 37353953790728648, 90420293, 90420296, 3, 640x360 
0x1382CA98, 37353953791043408, 90420316, 90420332, 16, 640x360 
0x1382CA98, 37353953791391688, 90420356, 90420379, 23, 640x360 
0x1382CA98, 37353953791687744, 90420392, 90420397, 5, 640x360 
0x1382CA98, 37353953792005984, 90420415, 90420417, 2, 640x360 
0x1382CA98, 37353953792323240, 90420453, 90420457, 4, 640x360 
0x1382CA98, 37353953792802560, 90420493, 90420495, 2, 640x360 
0x1382CA98, 37353953793125520, 90420519, 90420523, 4, 640x360 
0x1382CA98, 37353953793449288, 90420553, 90420559, 6, 640x360 
0x1382CA98, 37353953793790696, 90420584, 90420599, 15, 640x360 
0x1382CA98, 37353953794133120, 90420627, 90420634, 7, 640x360 
0x1382CA98, 37353953794411328, 90420653, 90420655, 2, 640x360 
0x1382CA98, 37353953794734640, 90420680, 90420688, 8, 640x360 
0x1382CA98, 37353953795047360, 90420712, 90420714, 2, 640x360 
0x1382CA98, 37353953795364024, 90420743, 90420745, 2, 640x360 
0x1382CA98, 37353953795683176, 90420786, 90420791, 5, 640x360 
0x1382CA98, 37353953796004544, 90420811, 90420814, 3, 640x360 
0x1382CA98, 37353953796323312, 90420842, 90420844, 2, 640x360 
0x1382CA98, 37353953796804496, 90420891, 90420893, 2, 640x360 
0x1382CA98, 37353953797128880, 90420916, 90420939, 23, 640x360 
0x1382CA98, 37353953797476792, 90420953, 90420963, 10, 640x360 
0x1382CA98, 37353953797877176, 90421026, 90421038, 12, 640x360 
0x1382CA98, 37353953798238456, 90421093, 90421124, 31, 640x360 
0x1382CA98, 37353953798891936, 90421125, 90421160, 35, 640x360 
0x1382CA98, 37353953799071112, 90421163, 90421176, 13, 640x360 
0x1382CA98, 37353953799618104, 90421189, 90421194, 5, 640x360 
0x1382CA98, 37353953799884608, 90421215, 90421226, 11, 640x360 
0x1382CA98, 37353953800056336, 90421227, 90421231, 4, 640x360 
0x1382CA98, 37353953800805776, 90421284, 90421295, 11, 640x360 
0x1382CA98, 37353953801125920, 90421314, 90421318, 4, 640x360 
0x1382CA98, 37353953801447736, 90421357, 90421366, 9, 640x360 
0x1382CA98, 37353953801765312, 90421379, 90421382, 3, 640x360 
0x1382CA98, 37353953802082200, 90421419, 90421422, 3, 640x360 
0x1382CA98, 37353953802402216, 90421453, 90421457, 4, 640x360 
0x1382CA98, 37353953802722200, 90421487, 90421490, 3, 640x360 
0x1382CA98, 37353953803042224, 90421508, 90421513, 5, 640x360 
0x1382CA98, 37353953803362144, 90421546, 90421548, 2, 640x360 
0x1382CA98, 37353953803682824, 90421578, 90421581, 3, 640x360 
0x1382CA98, 37353953804019192, 90421615, 90421621, 6, 640x360 
0x1382CA98, 37353953804322952, 90421645, 90421655, 10, 640x360 
0x1382CA98, 37353953804811824, 90421695, 90421697, 2, 640x360 
0x1382CA98, 37353953805129464, 90421725, 90421730, 5, 640x360 
0x1382CA98, 37353953805453688, 90421760, 90421762, 2, 640x360 
0x1382CA98, 37353953805767896, 90421790, 90421796, 6, 640x360 
0x1382CA98, 37353953806081856, 90421820, 90421822, 2, 640x360 
0x1382CA98, 37353953806404688, 90421844, 90421847, 3, 640x360 
0x1382CA98, 37353953806722152, 90421876, 90421878, 2, 640x360 
0x1382CA98, 37353953807055080, 90421918, 90421938, 20, 640x360 
0x1382CA98, 37353953807370560, 90421956, 90421960, 4, 640x360 
0x1382CA98, 37353953807697688, 90421991, 90421997, 6, 640x360 
0x1382CA98, 37353953808002360, 90422027, 90422030, 3, 640x360 
0x1382CA98, 37353953808337200, 90422048, 90422050, 2, 640x360 
0x1382CA98, 37353953808845520, 90422107, 90422113, 6, 640x360 
0x1382CA98, 37353953809145368, 90422144, 90422160, 16, 640x360 
0x1382CA98, 37353953809451368, 90422161, 90422182, 21, 640x360 
0x1382CA98, 37353953809832112, 90422197, 90422206, 9, 640x360 
0x1382CA98, 37353953810122936, 90422229, 90422239, 10, 640x360 
0x1382CA98, 37353953810406168, 90422273, 90422281, 8, 640x360 
0x1382CA98, 37353953810756264, 90422294, 90422298, 4, 640x360 
0x1382CA98, 37353953811056240, 90422317, 90422323, 6, 640x360 
0x1382CA98, 37353953811368704, 90422371, 90422379, 8, 640x360 
0x1382CA98, 37353953811716688, 90422390, 90422412, 22, 640x360 
0x1382CA98, 37353953812016872, 90422428, 90422431, 3, 640x360 
0x1382CA98, 37353953812327120, 90422449, 90422460, 11, 640x360 
0x1382CA98, 37353953812802440, 90422494, 90422517, 23, 640x360 
0x1382CA98, 37353953813142560, 90422527, 90422541, 14, 640x360 
0x1382CA98, 37353953813455256, 90422564, 90422578, 14, 640x360 
0x1382CA98, 37353953813796552, 90422589, 90422595, 6, 640x360 
0x1382CA98, 37353953814086520, 90422638, 90422644, 6, 640x360 
0x1382CA98, 37353953814405728, 90422657, 90422660, 3, 640x360 
0x1382CA98, 37353953814727192, 90422677, 90422680, 3, 640x360 
0x1382CA98, 37353953815041928, 90422709, 90422711, 2, 640x360 
0x1382CA98, 37353953815361872, 90422742, 90422746, 4, 640x360 
0x1382CA98, 37353953815690552, 90422782, 90422802, 20, 640x360 
0x1382CA98, 37353953816011616, 90422822, 90422835, 13, 640x360 
0x1382CA98, 37353953816337304, 90422849, 90422861, 12, 640x360 
0x1382CA98, 37353953816660200, 90422882, 90422893, 11, 640x360 
0x1382CA98, 37353953817128720, 90422931, 90422934, 3, 640x360 
0x1382CA98, 37353953817459704, 90422971, 90422987, 16, 640x360 
0x1382CA98, 37353953817774912, 90422997, 90423013, 16, 640x360 
0x1382CA98, 37353953818143424, 90423034, 90423043, 9, 640x360 
0x1382CA98, 37353953818421432, 90423068, 90423078, 10, 640x360 
0x1382CA98, 37353953818730872, 90423093, 90423108, 15, 640x360 
0x1382CA98, 37353953819124200, 90423141, 90423146, 5, 640x360 
0x1382CA98, 37353953819367288, 90423160, 90423163, 3, 640x360 
0x1382CA98, 37353953819691128, 90423193, 90423199, 6, 640x360 
0x1382CA98, 37353953820004464, 90423210, 90423212, 2, 640x360 
0x1382CA98, 37353953820333112, 90423255, 90423262, 7, 640x360 
0x1382CA98, 37353953820660672, 90423274, 90423278, 4, 640x360 
0x1382CA98, 37353953821144632, 90423324, 90423326, 2, 640x360 
0x1382CA98, 37353953821447176, 90423348, 90423354, 6, 640x360 
0x1382CA98, 37353953821776440, 90423411, 90423414, 3, 640x360 
0x1382CA98, 37353953822115928, 90423428, 90423430, 2, 640x360 
0x1382CA98, 37353953822404608, 90423464, 90423471, 7, 640x360 
0x1382CA98, 37353953822729736, 90423493, 90423504, 11, 640x360 
0x1382CA98, 37353953823078288, 90423523, 90423529, 6, 640x360 
0x1382CA98, 37353953823376440, 90423580, 90423585, 5, 640x360 
0x1382CA98, 37353953823724184, 90423603, 90423637, 34, 640x360 
0x1382CA98, 37353953824035304, 90423642, 90423649, 7, 640x360 
0x1382CA98, 37353953824368056, 90423672, 90423705, 33, 640x360 
0x1382CA98, 37353953824677776, 90423706, 90423714, 8, 640x360 
0x1382CA98, 37353953825134272, 90423729, 90423735, 6, 640x360 
0x1382CA98, 37353953825448640, 90423781, 90423789, 8, 640x360 
0x1382CA98, 37353953825814712, 90423818, 90423824, 6, 640x360 
0x1382CA98, 37353953826106808, 90423838, 90423848, 10, 640x360 
0x1382CA98, 37353953826408184, 90423874, 90423880, 6, 640x360 
0x1382CA98, 37353953826729896, 90423891, 90423893, 2, 640x360 
0x1382CA98, 37353953827046120, 90423919, 90423922, 3, 640x360 
0x1382CA98, 37353953827366144, 90423948, 90423951, 3, 640x360 
0x1382CA98, 37353953827681520, 90423982, 90423985, 3, 640x360 
0x1382CA98, 37353953828001736, 90424008, 90424011, 3, 640x360 
0x1382CA98, 37353953828326400, 90424043, 90424082, 39, 640x360 
0x1382CA98, 37353953828651232, 90424083, 90424115, 32, 640x360 
0x1382CA98, 37353953829141704, 90424135, 90424147, 12, 640x360 
0x1382CA98, 37353953829476816, 90424180, 90424188, 8, 640x360 
0x1382CA98, 37353953829815824, 90424196, 90424199, 3, 640x360 
0x1382CA98, 37353953830084280, 90424224, 90424227, 3, 640x360 
0x1382CA98, 37353953830407848, 90424247, 90424255, 8, 640x360 
0x1382CA98, 37353953830728952, 90424288, 90424298, 10, 640x360 
0x1382CA98, 37353953831045896, 90424321, 90424328, 7, 640x360 
0x1382CA98, 37353953831362768, 90424344, 90424346, 2, 640x360 
0x1382CA98, 37353953831690264, 90424386, 90424392, 6, 640x360 
0x1382CA98, 37353953832006352, 90424413, 90424415, 2, 640x360 
0x1382CA98, 37353953832321656, 90424448, 90424450, 2, 640x360 
0x1382CA98, 37353953832641896, 90424482, 90424484, 2, 640x360 
0x1382CA98, 37353953833130512, 90424531, 90424532, 1, 640x360 
0x1382CA98, 37353953833470480, 90424560, 90424563, 3, 640x360 
0x1382CA98, 37353953833767128, 90424588, 90424599, 11, 640x360 
0x1382CA98, 37353953834116360, 90424634, 90424648, 14, 640x360 
0x1382CA98, 37353953834408576, 90424661, 90424669, 8, 640x360 
0x1382CA98, 37353953834725008, 90424693, 90424697, 4, 640x360 
0x1382CA98, 37353953835043704, 90424741, 90424750, 9, 640x360 
0x1382CA98, 37353953835388712, 90424751, 90424766, 15, 640x360 
0x1382CA98, 37353953835706464, 90424782, 90424796, 14, 640x360 
0x1382CA98, 37353953836009672, 90424816, 90424821, 5, 640x360 
0x1382CA98, 37353953836337056, 90424843, 90424845, 2, 640x360 
0x1382CA98, 37353953836641712, 90424867, 90424873, 6, 640x360 
0x1382CA98, 37353953837150616, 90424951, 90424969, 18, 640x360 
0x1382CA98, 37353953837464760, 90424970, 90424976, 6, 640x360 
0x1382CA98, 37353953837767928, 90424992, 90425002, 10, 640x360 
